date,geography,geography code,All,EcAct,EcInact,Retired,Students,In-Ret-Stu
2011,Darlington 001B,E01012334,1742,1351,391,249,44,98
2011,Darlington 001C,E01012335,1009,651,358,250,34,74
2011,Darlington 001D,E01012366,1554,1103,451,277,69,105
2011,Darlington 001E,E01033481,1020,856,164,69,23,72
2011,Darlington 001F,E01033482,1196,967,229,122,41,66
2011,Darlington 002C,E01012323,1149,876,273,138,47,88
2011,Darlington 002D,E01012324,1045,771,274,198,25,51
2011,Darlington 002E,E01032545,939,700,239,136,24,79
2011,Darlington 002F,E01032546,1329,976,353,229,45,79
2011,Darlington 003A,E01012328,1160,820,340,171,39,130
2011,Darlington 003B,E01012329,1377,955,422,310,38,74
2011,Darlington 003C,E01012330,869,629,240,169,30,41
2011,Darlington 003D,E01012331,936,689,247,146,36,65
2011,Darlington 004A,E01012349,1097,729,368,145,30,193
2011,Darlington 004B,E01012350,1140,820,320,170,35,115
2011,Darlington 004C,E01012351,1094,828,266,135,39,92
2011,Darlington 004D,E01012352,1142,762,380,173,34,173
2011,Darlington 005A,E01012325,1104,769,335,197,32,106
2011,Darlington 005B,E01012326,798,515,283,141,27,115
2011,Darlington 005C,E01012332,969,609,360,186,34,140
2011,Darlington 005D,E01012333,1041,727,314,187,37,90
2011,Darlington 006A,E01012309,1380,1066,314,166,46,102
2011,Darlington 006B,E01012310,1444,1028,416,237,40,139
2011,Darlington 006C,E01012311,1106,755,351,158,61,132
2011,Darlington 006D,E01012312,890,521,369,131,34,204
2011,Darlington 006E,E01012313,941,609,332,153,29,150
2011,Darlington 006F,E01012314,954,595,359,173,36,150
2011,Darlington 007A,E01012362,1049,797,252,100,33,119
2011,Darlington 007B,E01012363,1043,792,251,118,38,95
2011,Darlington 007C,E01012364,1166,882,284,126,34,124
2011,Darlington 007D,E01012365,931,680,251,162,34,55
2011,Darlington 008B,E01012353,1241,911,330,96,45,189
2011,Darlington 008C,E01012354,1206,814,392,94,46,252
2011,Darlington 008D,E01012355,1104,817,287,103,36,148
2011,Darlington 008E,E01033483,812,489,323,80,31,212
2011,Darlington 008F,E01033484,919,642,277,111,41,125
2011,Darlington 009A,E01012307,1392,946,446,198,41,207
2011,Darlington 009B,E01012327,1027,588,439,146,64,229
2011,Darlington 009C,E01012342,1222,789,433,216,39,178
2011,Darlington 009D,E01012343,1456,991,465,283,46,136
2011,Darlington 010A,E01012315,1149,862,287,188,51,48
2011,Darlington 010B,E01012316,1821,1356,465,260,81,124
2011,Darlington 010C,E01012360,1143,767,376,277,32,67
2011,Darlington 011A,E01012336,1199,762,437,324,41,72
2011,Darlington 011B,E01012337,1220,783,437,315,44,78
2011,Darlington 011C,E01012347,1231,819,412,315,36,61
2011,Darlington 011D,E01012348,1324,786,538,432,41,65
2011,Darlington 011E,E01012361,1353,932,421,291,52,78
2011,Darlington 012A,E01012304,890,577,313,136,36,141
2011,Darlington 012B,E01012305,944,720,224,87,34,103
2011,Darlington 012C,E01012306,1119,750,369,169,44,156
2011,Darlington 012D,E01012340,1743,1221,522,256,64,202
2011,Darlington 012E,E01012341,1243,735,508,192,54,262
2011,Darlington 013A,E01012317,1008,661,347,230,29,88
2011,Darlington 013B,E01012318,1636,1106,530,177,74,279
2011,Darlington 013C,E01012319,1967,1399,568,261,71,236
2011,Darlington 014A,E01012356,1187,858,329,132,66,131
2011,Darlington 014B,E01012357,1083,758,325,119,62,144
2011,Darlington 014C,E01012358,1208,844,364,170,43,151
2011,Darlington 014D,E01012359,1034,612,422,110,59,253
2011,Darlington 015A,E01012338,1421,967,454,298,42,114
2011,Darlington 015B,E01012339,1286,845,441,323,46,72
2011,Darlington 015C,E01012344,1009,755,254,133,31,90
2011,Darlington 015D,E01012345,1069,679,390,229,27,134
2011,Darlington 015E,E01012346,1355,1074,281,141,45,95
2011,County Durham 002A,E01020613,1060,733,327,233,38,56
2011,County Durham 002B,E01020614,1028,662,366,240,30,96
2011,County Durham 002C,E01020622,1338,1043,295,184,41,70
2011,County Durham 002D,E01020623,1205,951,254,145,49,60
2011,County Durham 005A,E01020606,1135,751,384,204,35,145
2011,County Durham 005B,E01020615,1238,789,449,204,58,187
2011,County Durham 005C,E01020616,1265,885,380,163,53,164
2011,County Durham 005D,E01020617,1444,1006,438,273,41,124
2011,County Durham 007A,E01020596,1186,808,378,208,37,133
2011,County Durham 007B,E01020597,1159,734,425,309,32,84
2011,County Durham 007C,E01020598,1296,887,409,284,48,77
2011,County Durham 007D,E01020611,1009,665,344,263,29,52
2011,County Durham 007E,E01020612,1198,762,436,340,38,58
2011,County Durham 011A,E01020592,1067,633,434,121,78,235
2011,County Durham 011B,E01020593,955,659,296,131,46,119
2011,County Durham 011C,E01020599,1211,790,421,222,40,159
2011,County Durham 011D,E01020601,1171,868,303,186,56,61
2011,County Durham 011E,E01020602,1244,781,463,260,44,159
2011,County Durham 011F,E01020618,1174,763,411,169,58,184
2011,County Durham 013A,E01020594,1272,958,314,171,45,98
2011,County Durham 013B,E01020595,1273,844,429,292,43,94
2011,County Durham 013C,E01020600,1132,734,398,300,43,55
2011,County Durham 013D,E01020603,1390,1057,333,201,82,50
2011,County Durham 013E,E01020605,1370,1020,350,202,49,99
2011,County Durham 015A,E01020590,1042,664,378,205,78,95
2011,County Durham 015B,E01020591,1069,677,392,205,47,140
2011,County Durham 015C,E01020608,1266,888,378,192,53,133
2011,County Durham 015D,E01020609,1038,610,428,282,45,101
2011,County Durham 015E,E01020610,1139,815,324,221,40,63
2011,County Durham 019A,E01020604,1086,758,328,157,38,133
2011,County Durham 019B,E01020607,1257,814,443,238,36,169
2011,County Durham 019C,E01020619,1153,854,299,192,32,75
2011,County Durham 019D,E01020620,1175,826,349,186,45,118
2011,County Durham 019E,E01020621,1436,938,498,253,41,204
2011,County Durham 001A,E01020634,1182,838,344,237,40,67
2011,County Durham 001B,E01020635,1091,779,312,206,36,70
2011,County Durham 001C,E01020636,1240,835,405,224,34,147
2011,County Durham 001D,E01020654,1315,959,356,204,36,116
2011,County Durham 001E,E01020676,1199,851,348,188,43,117
2011,County Durham 003A,E01020627,1181,854,327,198,43,86
2011,County Durham 003B,E01020628,1207,804,403,279,39,85
2011,County Durham 003C,E01020629,1083,742,341,176,46,119
2011,County Durham 003D,E01020655,1483,1047,436,262,55,119
2011,County Durham 003E,E01020656,1055,642,413,243,31,139
2011,County Durham 003F,E01020657,1209,811,398,213,56,129
2011,County Durham 004A,E01020661,1337,933,404,195,54,155
2011,County Durham 004B,E01020662,1331,905,426,191,66,169
2011,County Durham 004C,E01020663,1404,984,420,248,52,120
2011,County Durham 004D,E01020674,1147,758,389,199,25,165
2011,County Durham 004E,E01020678,1041,703,338,181,48,109
2011,County Durham 006A,E01020626,1111,650,461,247,34,180
2011,County Durham 006B,E01020638,1196,792,404,237,32,135
2011,County Durham 006C,E01020639,1072,677,395,160,41,194
2011,County Durham 006D,E01020653,1130,709,421,181,51,189
2011,County Durham 006E,E01020677,1136,684,452,233,59,160
2011,County Durham 008A,E01020647,1524,991,533,140,53,340
2011,County Durham 008B,E01020648,1330,834,496,173,62,261
2011,County Durham 008C,E01020649,1154,779,375,176,38,161
2011,County Durham 008D,E01020673,1210,694,516,204,33,279
2011,County Durham 008E,E01020675,1219,757,462,219,47,196
2011,County Durham 009A,E01020624,1204,815,389,169,40,180
2011,County Durham 009B,E01020625,1176,842,334,166,45,123
2011,County Durham 009C,E01020670,1136,702,434,228,40,166
2011,County Durham 009D,E01020671,988,643,345,127,49,169
2011,County Durham 009E,E01020672,1307,902,405,175,42,188
2011,County Durham 010A,E01020632,1377,1051,326,156,55,115
2011,County Durham 010B,E01020640,1786,1371,415,181,74,160
2011,County Durham 010C,E01020641,1558,1063,495,260,69,166
2011,County Durham 010D,E01020642,1024,711,313,202,37,74
2011,County Durham 010E,E01020643,1632,1181,451,213,53,185
2011,County Durham 010F,E01020667,1189,725,464,277,30,157
2011,County Durham 012A,E01020650,1630,1173,457,245,47,165
2011,County Durham 012B,E01020651,1243,808,435,269,31,135
2011,County Durham 012C,E01020652,1373,945,428,179,78,171
2011,County Durham 012D,E01020668,1097,747,350,150,35,165
2011,County Durham 012E,E01020669,1094,745,349,153,39,157
2011,County Durham 014A,E01020630,1007,648,359,177,35,147
2011,County Durham 014B,E01020631,1162,767,395,207,39,149
2011,County Durham 014C,E01020637,1246,846,400,267,46,87
2011,County Durham 014D,E01020644,1862,1346,516,198,74,244
2011,County Durham 014E,E01020645,1040,632,408,158,65,185
2011,County Durham 020A,E01020633,1206,796,410,207,36,167
2011,County Durham 020B,E01020664,1059,729,330,244,34,52
2011,County Durham 020C,E01020665,989,639,350,220,35,95
2011,County Durham 020D,E01020666,1085,697,388,293,29,66
2011,County Durham 024A,E01020646,1174,815,359,185,33,141
2011,County Durham 024B,E01020658,1255,886,369,157,40,172
2011,County Durham 024C,E01020659,1198,898,300,168,48,84
2011,County Durham 024D,E01020660,1201,782,419,229,75,115
2011,County Durham 022A,E01020709,2168,1221,947,215,85,647
2011,County Durham 022B,E01020717,1246,754,492,387,39,66
2011,County Durham 022C,E01020718,997,658,339,244,29,66
2011,County Durham 022D,E01020719,983,696,287,206,34,47
2011,County Durham 022E,E01020721,957,694,263,189,37,37
2011,County Durham 023A,E01020708,847,573,274,176,52,46
2011,County Durham 023B,E01020710,1224,893,331,169,59,103
2011,County Durham 023C,E01020711,1210,791,419,221,62,136
2011,County Durham 023D,E01020720,1007,678,329,207,34,88
2011,County Durham 026A,E01020679,1186,761,425,173,50,202
2011,County Durham 026B,E01020680,1259,881,378,240,44,94
2011,County Durham 026C,E01020681,1116,736,380,223,42,115
2011,County Durham 026D,E01020714,1267,848,419,291,41,87
2011,County Durham 026E,E01020716,1218,756,462,151,67,244
2011,County Durham 027A,E01020725,1126,796,330,207,30,93
2011,County Durham 027B,E01020726,946,666,280,181,39,60
2011,County Durham 027C,E01020727,804,468,336,176,25,135
2011,County Durham 027D,E01020729,1580,1118,462,230,53,179
2011,County Durham 027E,E01020730,1203,808,395,233,32,130
2011,County Durham 027F,E01020731,1120,812,308,198,34,76
2011,County Durham 028A,E01020682,1425,860,565,459,40,66
2011,County Durham 028B,E01020683,1216,870,346,252,39,55
2011,County Durham 028C,E01020690,962,597,365,284,33,48
2011,County Durham 028D,E01020691,978,712,266,147,44,75
2011,County Durham 028E,E01020692,1121,685,436,360,42,34
2011,County Durham 029A,E01020693,1063,682,381,169,93,119
2011,County Durham 029B,E01020722,1559,879,680,206,271,203
2011,County Durham 029C,E01020723,1425,774,651,158,354,139
2011,County Durham 029D,E01020724,1168,666,502,121,122,259
2011,County Durham 030A,E01020703,1890,585,1305,105,1139,61
2011,County Durham 030D,E01033164,2149,614,1535,63,1442,30
2011,County Durham 030E,E01033195,1242,457,785,105,645,35
2011,County Durham 030F,E01033197,1848,431,1417,85,865,467
2011,County Durham 030G,E01033221,4347,989,3358,87,3231,40
2011,County Durham 033A,E01020684,1779,1331,448,202,113,133
2011,County Durham 033B,E01020702,1752,1036,716,235,372,109
2011,County Durham 033C,E01020704,1597,630,967,142,775,50
2011,County Durham 033D,E01020712,1255,801,454,189,212,53
2011,County Durham 033E,E01020713,1501,1014,487,225,195,67
2011,County Durham 031A,E01020705,1075,686,389,179,37,173
2011,County Durham 031B,E01020706,1420,964,456,285,33,138
2011,County Durham 031C,E01020715,1830,1276,554,245,64,245
2011,County Durham 038A,E01020685,1231,870,361,252,32,77
2011,County Durham 038B,E01020686,1173,704,469,225,44,200
2011,County Durham 038C,E01020687,1114,761,353,240,35,78
2011,County Durham 038D,E01020688,1153,808,345,168,35,142
2011,County Durham 038E,E01020689,1042,640,402,190,43,169
2011,County Durham 041A,E01020694,1087,683,404,198,50,156
2011,County Durham 041B,E01020696,996,669,327,181,29,117
2011,County Durham 041C,E01020697,1186,863,323,173,55,95
2011,County Durham 041D,E01020732,1277,863,414,253,72,89
2011,County Durham 044A,E01020695,1358,928,430,233,63,134
2011,County Durham 044B,E01020698,1210,897,313,166,58,89
2011,County Durham 044C,E01020699,850,524,326,158,36,132
2011,County Durham 044D,E01020700,1160,676,484,244,49,191
2011,County Durham 044E,E01020701,993,722,271,162,36,73
2011,County Durham 016A,E01020750,974,684,290,174,49,67
2011,County Durham 016B,E01020781,785,538,247,134,26,87
2011,County Durham 016D,E01020786,1260,872,388,251,54,83
2011,County Durham 016E,E01020787,1346,875,471,191,50,230
2011,County Durham 016F,E01033163,1441,1190,251,143,35,73
2011,County Durham 016G,E01033202,840,590,250,128,33,89
2011,County Durham 017A,E01020740,1092,775,317,153,43,121
2011,County Durham 017B,E01020741,968,664,304,101,50,153
2011,County Durham 017C,E01020742,1248,867,381,137,54,190
2011,County Durham 017D,E01020782,896,574,322,179,31,112
2011,County Durham 017E,E01020783,1001,680,321,158,44,119
2011,County Durham 017F,E01020784,1054,657,397,169,36,192
2011,County Durham 018A,E01020743,962,614,348,82,53,213
2011,County Durham 018B,E01020747,877,482,395,115,62,218
2011,County Durham 018C,E01020748,942,613,329,93,56,180
2011,County Durham 018D,E01020749,993,434,559,300,21,238
2011,County Durham 018E,E01020773,1088,598,490,234,44,212
2011,County Durham 018F,E01020775,1217,647,570,195,68,307
2011,County Durham 021C,E01020776,1395,892,503,299,48,156
2011,County Durham 021D,E01033161,1120,841,279,121,39,119
2011,County Durham 021E,E01033198,1196,714,482,131,214,137
2011,County Durham 021F,E01033205,1138,777,361,163,46,152
2011,County Durham 021G,E01033206,1108,741,367,143,46,178
2011,County Durham 025A,E01020751,1402,895,507,221,58,228
2011,County Durham 025B,E01020752,873,473,400,146,26,228
2011,County Durham 025C,E01020754,966,592,374,208,27,139
2011,County Durham 025D,E01020756,1046,744,302,198,30,74
2011,County Durham 032A,E01020745,970,530,440,185,47,208
2011,County Durham 032B,E01020753,1332,825,507,212,60,235
2011,County Durham 032C,E01020757,816,474,342,102,40,200
2011,County Durham 032D,E01020758,1019,589,430,124,62,244
2011,County Durham 032E,E01020759,786,443,343,91,54,198
2011,County Durham 032F,E01020765,1272,747,525,156,70,299
2011,County Durham 034A,E01020760,1232,756,476,228,41,207
2011,County Durham 034B,E01020761,951,574,377,118,42,217
2011,County Durham 034C,E01020762,974,531,443,159,42,242
2011,County Durham 034D,E01020763,1373,876,497,217,49,231
2011,County Durham 036A,E01020764,1029,522,507,180,36,291
2011,County Durham 036B,E01020766,1047,620,427,234,35,158
2011,County Durham 036C,E01020767,1424,762,662,222,61,379
2011,County Durham 036D,E01020768,1173,744,429,204,40,185
2011,County Durham 035A,E01020733,929,572,357,136,49,172
2011,County Durham 035B,E01020734,886,590,296,116,33,147
2011,County Durham 035C,E01020735,1009,691,318,170,42,106
2011,County Durham 035D,E01020770,912,598,314,128,51,135
2011,County Durham 035E,E01020771,765,471,294,134,39,121
2011,County Durham 035F,E01020780,833,504,329,146,44,139
2011,County Durham 037A,E01020746,880,536,344,201,26,117
2011,County Durham 037B,E01020769,916,601,315,131,48,136
2011,County Durham 037C,E01020777,1087,658,429,161,60,208
2011,County Durham 037D,E01020778,963,633,330,204,34,92
2011,County Durham 037E,E01020779,1331,933,398,236,76,86
2011,County Durham 039A,E01020736,903,522,381,167,30,184
2011,County Durham 039B,E01020737,1023,664,359,190,35,134
2011,County Durham 039C,E01020738,775,473,302,198,15,89
2011,County Durham 039D,E01020739,951,514,437,193,31,213
2011,County Durham 039E,E01020744,754,467,287,177,23,87
2011,County Durham 040A,E01020788,1146,687,459,203,42,214
2011,County Durham 040B,E01020789,1058,624,434,221,40,173
2011,County Durham 040C,E01020790,956,523,433,179,42,212
2011,County Durham 040D,E01020791,964,595,369,150,34,185
2011,County Durham 040E,E01020792,1075,714,361,157,38,166
2011,County Durham 043A,E01020772,1513,1019,494,261,57,176
2011,County Durham 043B,E01020793,1264,740,524,204,54,266
2011,County Durham 043C,E01020794,1331,956,375,202,47,126
2011,County Durham 043D,E01020795,1311,889,422,168,39,215
2011,County Durham 047A,E01020817,1062,744,318,207,40,71
2011,County Durham 047B,E01020818,1073,681,392,229,29,134
2011,County Durham 047C,E01020819,752,442,310,126,31,153
2011,County Durham 047D,E01020837,1357,909,448,333,31,84
2011,County Durham 047E,E01020843,1223,847,376,247,37,92
2011,County Durham 048A,E01020809,1069,614,455,186,46,223
2011,County Durham 048B,E01020810,997,682,315,154,50,111
2011,County Durham 048C,E01020811,923,583,340,150,39,151
2011,County Durham 048D,E01020812,1140,727,413,228,48,137
2011,County Durham 048E,E01020827,1368,889,479,213,57,209
2011,County Durham 049A,E01020806,1039,650,389,202,47,140
2011,County Durham 049B,E01020807,1019,612,407,127,46,234
2011,County Durham 049C,E01020820,1041,609,432,189,44,199
2011,County Durham 049D,E01020842,1491,941,550,235,62,253
2011,County Durham 050A,E01020797,1875,1072,803,388,68,347
2011,County Durham 050B,E01020798,1048,567,481,256,42,183
2011,County Durham 050C,E01020799,1112,765,347,180,41,126
2011,County Durham 050D,E01020808,1061,663,398,215,37,146
2011,County Durham 052A,E01020821,1392,960,432,236,60,136
2011,County Durham 052B,E01020822,1432,974,458,277,54,127
2011,County Durham 052C,E01020823,1257,765,492,206,66,220
2011,County Durham 052D,E01020835,1245,867,378,183,43,152
2011,County Durham 052E,E01020836,1431,953,478,223,49,206
2011,County Durham 053B,E01020803,1512,1058,454,221,68,165
2011,County Durham 053D,E01020805,1382,806,576,297,43,236
2011,County Durham 053E,E01033203,2121,1435,686,335,58,293
2011,County Durham 054A,E01020796,980,694,286,178,35,73
2011,County Durham 054B,E01020828,1233,820,413,306,47,60
2011,County Durham 054C,E01020829,1786,1272,514,358,70,86
2011,County Durham 054D,E01020830,1105,675,430,287,41,102
2011,County Durham 059A,E01020801,1157,841,316,171,36,109
2011,County Durham 059B,E01020802,1463,952,511,224,38,249
2011,County Durham 059C,E01020838,1305,862,443,222,44,177
2011,County Durham 059D,E01020839,1194,682,512,255,46,211
2011,County Durham 059E,E01020840,1142,666,476,224,50,202
2011,County Durham 059F,E01020841,1257,743,514,181,65,268
2011,County Durham 060A,E01020813,977,661,316,218,34,64
2011,County Durham 060B,E01020814,1102,850,252,130,36,86
2011,County Durham 060C,E01020815,945,625,320,195,38,87
2011,County Durham 060D,E01020848,828,575,253,138,26,89
2011,County Durham 060E,E01020850,1468,1149,319,152,55,112
2011,County Durham 060F,E01020851,1096,751,345,251,23,71
2011,County Durham 061A,E01020816,1005,615,390,120,58,212
2011,County Durham 061B,E01020844,1080,678,402,152,47,203
2011,County Durham 061C,E01020847,1081,669,412,120,67,225
2011,County Durham 061D,E01020849,920,591,329,88,44,197
2011,County Durham 062A,E01020825,1151,777,374,222,43,109
2011,County Durham 062B,E01020831,983,638,345,184,27,134
2011,County Durham 062C,E01020833,894,588,306,156,38,112
2011,County Durham 062D,E01020834,909,601,308,153,29,126
2011,County Durham 063A,E01020824,1092,756,336,197,26,113
2011,County Durham 063B,E01020826,1112,720,392,221,46,125
2011,County Durham 063C,E01020832,1009,639,370,220,30,120
2011,County Durham 063D,E01020845,996,638,358,172,37,149
2011,County Durham 063E,E01020846,956,624,332,182,42,108
2011,County Durham 064A,E01020856,1152,711,441,220,48,173
2011,County Durham 064B,E01020858,788,529,259,152,18,89
2011,County Durham 064C,E01020859,922,622,300,190,41,69
2011,County Durham 064D,E01020860,777,499,278,106,30,142
2011,County Durham 064E,E01020861,894,570,324,199,24,101
2011,County Durham 064F,E01020862,1778,1215,563,380,62,121
2011,County Durham 064G,E01020864,1574,1068,506,327,31,148
2011,County Durham 064H,E01020867,1598,1105,493,312,60,121
2011,County Durham 065A,E01020857,1081,756,325,218,38,69
2011,County Durham 065B,E01020863,1104,802,302,196,32,74
2011,County Durham 065C,E01020865,995,664,331,226,30,75
2011,County Durham 065D,E01020866,789,547,242,159,18,65
2011,County Durham 066A,E01020852,1184,699,485,288,91,106
2011,County Durham 066B,E01020853,1055,708,347,216,44,87
2011,County Durham 066C,E01020854,2095,1165,930,322,73,535
2011,County Durham 066D,E01020855,859,554,305,240,38,27
2011,County Durham 042A,E01020889,1138,763,375,246,27,102
2011,County Durham 042B,E01020890,1308,836,472,294,43,135
2011,County Durham 042C,E01020891,1275,848,427,272,40,115
2011,County Durham 042D,E01020905,1114,730,384,252,39,93
2011,County Durham 042E,E01020906,1247,843,404,275,43,86
2011,County Durham 045A,E01020876,1278,841,437,245,47,145
2011,County Durham 045B,E01020878,1231,761,470,189,53,228
2011,County Durham 045C,E01020887,1420,993,427,211,42,174
2011,County Durham 045D,E01020892,805,492,313,139,56,118
2011,County Durham 045E,E01020894,863,540,323,144,33,146
2011,County Durham 045F,E01020898,1056,594,462,184,46,232
2011,County Durham 046A,E01020877,1206,757,449,258,30,161
2011,County Durham 046B,E01020879,1612,1121,491,303,52,136
2011,County Durham 046C,E01020893,1270,842,428,227,51,150
2011,County Durham 046D,E01020899,999,659,340,212,30,98
2011,County Durham 046E,E01020903,878,624,254,128,33,93
2011,County Durham 046F,E01020904,1310,894,416,237,46,133
2011,County Durham 051A,E01020873,1054,613,441,166,35,240
2011,County Durham 051B,E01020875,1014,697,317,156,47,114
2011,County Durham 051C,E01020900,1046,685,361,187,49,125
2011,County Durham 051D,E01020901,982,515,467,220,46,201
2011,County Durham 051E,E01020902,1053,575,478,181,44,253
2011,County Durham 055A,E01020868,1358,925,433,231,43,159
2011,County Durham 055B,E01020869,1052,720,332,137,44,151
2011,County Durham 055C,E01020874,1097,682,415,187,49,179
2011,County Durham 055D,E01020880,1194,652,542,150,168,224
2011,County Durham 055E,E01020881,980,677,303,178,31,94
2011,County Durham 056A,E01020870,988,598,390,293,37,60
2011,County Durham 056B,E01020871,1020,698,322,191,39,92
2011,County Durham 056C,E01020872,1251,855,396,255,29,112
2011,County Durham 056D,E01020883,1318,976,342,226,46,70
2011,County Durham 056E,E01020886,917,663,254,135,33,86
2011,County Durham 057A,E01020882,1128,788,340,174,41,125
2011,County Durham 057B,E01020888,1486,1101,385,223,42,120
2011,County Durham 057C,E01020895,1104,700,404,175,26,203
2011,County Durham 057D,E01020896,1012,623,389,247,31,111
2011,County Durham 057E,E01020897,1800,1245,555,225,70,260
2011,County Durham 058A,E01020884,1026,643,383,212,36,135
2011,County Durham 058B,E01020885,836,467,369,179,35,155
2011,County Durham 058C,E01020907,1168,729,439,162,51,226
2011,County Durham 058D,E01020908,1057,709,348,130,41,177
2011,County Durham 058E,E01020909,1129,557,572,132,69,371
2011,Hartlepool 001A,E01011954,1545,995,550,215,72,263
2011,Hartlepool 001B,E01011969,1028,663,365,259,32,74
2011,Hartlepool 001C,E01011970,917,671,246,161,33,52
2011,Hartlepool 001D,E01011971,1024,846,178,91,38,49
2011,Hartlepool 001F,E01033465,1352,1061,291,142,51,98
2011,Hartlepool 001G,E01033467,755,461,294,171,32,91
2011,Hartlepool 002A,E01011952,1106,654,452,165,54,233
2011,Hartlepool 002B,E01011953,1321,789,532,142,74,316
2011,Hartlepool 002C,E01011991,1387,880,507,258,77,172
2011,Hartlepool 002D,E01011992,1171,727,444,143,54,247
2011,Hartlepool 002E,E01011993,1274,785,489,203,57,229
2011,Hartlepool 002F,E01011994,1079,565,514,174,44,296
2011,Hartlepool 003A,E01011955,1001,583,418,145,60,213
2011,Hartlepool 003C,E01011957,984,624,360,133,49,178
2011,Hartlepool 003G,E01032540,752,517,235,105,33,97
2011,Hartlepool 003H,E01032541,1525,931,594,317,66,211
2011,Hartlepool 003I,E01033466,1412,774,638,220,72,346
2011,Hartlepool 005A,E01011973,977,550,427,101,49,277
2011,Hartlepool 005B,E01011974,1384,954,430,127,60,243
2011,Hartlepool 005C,E01011975,1016,742,274,120,26,128
2011,Hartlepool 005D,E01011976,754,480,274,88,51,135
2011,Hartlepool 006A,E01011965,1175,854,321,186,54,81
2011,Hartlepool 006B,E01011966,1068,723,345,204,44,97
2011,Hartlepool 006C,E01011983,1247,859,388,220,62,106
2011,Hartlepool 006D,E01012002,1010,721,289,161,44,84
2011,Hartlepool 007A,E01011951,1021,698,323,82,43,198
2011,Hartlepool 007B,E01011964,1035,621,414,138,77,199
2011,Hartlepool 007C,E01011967,1076,791,285,107,69,109
2011,Hartlepool 007D,E01011999,1480,915,565,160,92,313
2011,Hartlepool 007E,E01012000,1027,554,473,201,38,234
2011,Hartlepool 008A,E01011950,1159,755,404,127,48,229
2011,Hartlepool 008B,E01011986,948,662,286,150,44,92
2011,Hartlepool 008C,E01011987,1062,758,304,139,24,141
2011,Hartlepool 008D,E01012001,1441,931,510,181,60,269
2011,Hartlepool 009A,E01011949,1383,868,515,206,80,229
2011,Hartlepool 009B,E01011980,1168,665,503,226,49,228
2011,Hartlepool 009C,E01011981,1102,665,437,158,65,214
2011,Hartlepool 009D,E01011984,861,559,302,202,30,70
2011,Hartlepool 010A,E01011985,876,572,304,195,30,79
2011,Hartlepool 010B,E01011988,1358,915,443,227,44,172
2011,Hartlepool 010C,E01011989,1309,778,531,169,62,300
2011,Hartlepool 010D,E01011990,1269,896,373,170,46,157
2011,Hartlepool 011A,E01011995,1047,663,384,256,45,83
2011,Hartlepool 011B,E01011996,1113,732,381,241,43,97
2011,Hartlepool 011C,E01011997,1531,1123,408,252,61,95
2011,Hartlepool 011D,E01011998,1072,716,356,235,41,80
2011,Hartlepool 012A,E01011961,1034,634,400,203,37,160
2011,Hartlepool 012B,E01011962,1004,604,400,168,58,174
2011,Hartlepool 012C,E01011977,1266,797,469,128,73,268
2011,Hartlepool 012D,E01011978,1041,586,455,136,58,261
2011,Hartlepool 012E,E01011979,1080,676,404,123,59,222
2011,Hartlepool 014A,E01011959,1528,1066,462,298,60,104
2011,Hartlepool 014B,E01011960,1052,610,442,310,41,91
2011,Hartlepool 014C,E01011963,1056,683,373,258,42,73
2011,Hartlepool 014D,E01011968,1557,1022,535,314,67,154
2011,Hartlepool 014E,E01011982,939,631,308,210,46,52
2011,Hartlepool 014F,E01012003,1161,786,375,259,56,60
2011,Hartlepool 014G,E01012005,1484,1172,312,141,66,105
2011,Middlesbrough 001A,E01012068,2017,982,1035,71,697,267
2011,Middlesbrough 001D,E01012092,1766,795,971,72,618,281
2011,Middlesbrough 001E,E01012093,1410,722,688,71,300,317
2011,Middlesbrough 001F,E01012094,1925,1058,867,101,321,445
2011,Middlesbrough 001G,E01033468,1956,935,1021,220,256,545
2011,Middlesbrough 002A,E01012058,1244,773,471,120,62,289
2011,Middlesbrough 002B,E01012059,1088,650,438,150,58,230
2011,Middlesbrough 002C,E01012060,1138,649,489,138,38,313
2011,Middlesbrough 002D,E01012061,980,586,394,127,56,211
2011,Middlesbrough 003A,E01012036,1195,641,554,72,247,235
2011,Middlesbrough 003B,E01012037,1147,667,480,90,113,277
2011,Middlesbrough 003C,E01012038,1125,707,418,103,118,197
2011,Middlesbrough 003D,E01012039,1268,689,579,62,331,186
2011,Middlesbrough 003E,E01012040,1102,625,477,61,189,227
2011,Middlesbrough 003F,E01012041,805,397,408,133,48,227
2011,Middlesbrough 004A,E01012074,1036,701,335,89,41,205
2011,Middlesbrough 004B,E01012075,1025,649,376,114,56,206
2011,Middlesbrough 004C,E01012076,983,558,425,93,57,275
2011,Middlesbrough 004D,E01012077,974,577,397,159,40,198
2011,Middlesbrough 004E,E01012088,895,529,366,84,58,224
2011,Middlesbrough 005A,E01012078,1122,734,388,80,119,189
2011,Middlesbrough 005B,E01012079,1004,667,337,122,57,158
2011,Middlesbrough 005C,E01012080,938,645,293,117,50,126
2011,Middlesbrough 005D,E01012081,1261,863,398,130,76,192
2011,Middlesbrough 006A,E01012026,1173,805,368,142,62,164
2011,Middlesbrough 006B,E01012027,1284,785,499,148,55,296
2011,Middlesbrough 006E,E01033469,1421,875,546,187,82,277
2011,Middlesbrough 007A,E01012015,1107,634,473,203,61,209
2011,Middlesbrough 007B,E01012016,1208,752,456,181,41,234
2011,Middlesbrough 007C,E01012017,1146,731,415,237,37,141
2011,Middlesbrough 007D,E01012089,1060,616,444,125,54,265
2011,Middlesbrough 007E,E01012090,1151,649,502,141,53,308
2011,Middlesbrough 007F,E01012091,1119,612,507,127,65,315
2011,Middlesbrough 008A,E01012011,1341,769,572,187,77,308
2011,Middlesbrough 008B,E01012012,1281,892,389,175,79,135
2011,Middlesbrough 008C,E01012013,956,662,294,112,49,133
2011,Middlesbrough 008D,E01012014,1099,761,338,99,59,180
2011,Middlesbrough 009A,E01012053,1214,840,374,183,78,113
2011,Middlesbrough 009B,E01012054,1241,912,329,113,73,143
2011,Middlesbrough 009C,E01012055,1423,952,471,271,74,126
2011,Middlesbrough 009D,E01012056,1721,1273,448,94,160,194
2011,Middlesbrough 009E,E01012057,1423,990,433,154,107,172
2011,Middlesbrough 010A,E01012082,1095,735,360,108,59,193
2011,Middlesbrough 010B,E01012083,1043,694,349,73,55,221
2011,Middlesbrough 010C,E01012084,1116,668,448,124,63,261
2011,Middlesbrough 010D,E01012085,1018,633,385,103,40,242
2011,Middlesbrough 011A,E01012018,1279,707,572,135,82,355
2011,Middlesbrough 011B,E01012019,861,416,445,151,53,241
2011,Middlesbrough 011C,E01012020,1066,681,385,124,60,201
2011,Middlesbrough 011D,E01012021,925,546,379,107,71,201
2011,Middlesbrough 012A,E01012007,1064,677,387,261,44,82
2011,Middlesbrough 012B,E01012008,1035,751,284,151,61,72
2011,Middlesbrough 012C,E01012009,1292,992,300,153,42,105
2011,Middlesbrough 012D,E01012010,1003,705,298,192,52,54
2011,Middlesbrough 013A,E01012046,1251,759,492,332,51,109
2011,Middlesbrough 013B,E01012047,1108,794,314,171,42,101
2011,Middlesbrough 013C,E01012048,1265,817,448,306,63,79
2011,Middlesbrough 014A,E01012049,1076,754,322,197,43,82
2011,Middlesbrough 014B,E01012050,983,638,345,132,40,173
2011,Middlesbrough 014C,E01012051,919,608,311,110,54,147
2011,Middlesbrough 014D,E01012052,998,663,335,187,57,91
2011,Middlesbrough 015A,E01012022,1204,913,291,152,50,89
2011,Middlesbrough 015B,E01012023,972,497,475,368,28,79
2011,Middlesbrough 015C,E01012024,1155,746,409,297,33,79
2011,Middlesbrough 015D,E01012025,999,681,318,208,34,76
2011,Middlesbrough 017A,E01012065,1177,776,401,293,34,74
2011,Middlesbrough 017B,E01012066,1508,1206,302,139,80,83
2011,Middlesbrough 017C,E01012067,1132,727,405,300,35,70
2011,Middlesbrough 018A,E01012042,1106,698,408,191,42,175
2011,Middlesbrough 018B,E01012043,1104,691,413,259,35,119
2011,Middlesbrough 018C,E01012044,1073,665,408,106,49,253
2011,Middlesbrough 018D,E01012045,1005,598,407,122,53,232
2011,Middlesbrough 018G,E01032552,1198,825,373,150,59,164
2011,Middlesbrough 018H,E01032553,932,562,370,231,20,119
2011,Middlesbrough 019A,E01012030,1112,811,301,178,50,73
2011,Middlesbrough 019B,E01012031,1196,765,431,224,42,165
2011,Middlesbrough 019C,E01012032,1315,1054,261,123,49,89
2011,Middlesbrough 019D,E01012033,961,552,409,153,35,221
2011,Middlesbrough 019E,E01012034,1144,821,323,114,81,128
2011,Middlesbrough 019F,E01012035,968,628,340,168,36,136
2011,Middlesbrough 020A,E01012062,1104,724,380,280,38,62
2011,Middlesbrough 020B,E01012063,1016,722,294,205,29,60
2011,Middlesbrough 020C,E01012064,1375,1002,373,221,58,94
2011,Middlesbrough 020D,E01012071,1119,686,433,340,51,42
2011,Middlesbrough 020E,E01012073,1076,718,358,248,37,73
2011,Middlesbrough 020F,E01032593,1431,967,464,277,91,96
2011,Northumberland 004A,E01027356,1288,813,475,347,44,84
2011,Northumberland 004B,E01027357,930,628,302,227,26,49
2011,Northumberland 004C,E01027366,1152,726,426,305,41,80
2011,Northumberland 004D,E01027367,1424,1119,305,166,38,101
2011,Northumberland 005A,E01027358,1503,1071,432,248,48,136
2011,Northumberland 005B,E01027359,1597,1101,496,235,59,202
2011,Northumberland 005D,E01033715,770,535,235,154,22,59
2011,Northumberland 005E,E01033717,1046,752,294,189,35,70
2011,Northumberland 006A,E01027361,1609,1100,509,302,45,162
2011,Northumberland 006B,E01027362,916,620,296,170,23,103
2011,Northumberland 006C,E01027363,797,495,302,145,30,127
2011,Northumberland 006D,E01027364,1562,1042,520,332,60,128
2011,Northumberland 006E,E01027370,1432,957,475,334,48,93
2011,Northumberland 006F,E01027371,1318,920,398,243,41,114
2011,Northumberland 006G,E01027372,1618,972,646,472,51,123
2011,Northumberland 007A,E01027365,1627,1115,512,355,55,102
2011,Northumberland 007B,E01027368,1303,916,387,238,42,107
2011,Northumberland 007C,E01027369,1090,661,429,349,24,56
2011,Northumberland 007D,E01027373,1537,1110,427,283,34,110
2011,Northumberland 001A,E01027376,1226,845,381,214,32,135
2011,Northumberland 001B,E01027377,1259,901,358,228,23,107
2011,Northumberland 001C,E01027385,897,627,270,99,33,138
2011,Northumberland 001D,E01027387,1299,879,420,264,30,126
2011,Northumberland 001E,E01027388,1048,760,288,136,38,114
2011,Northumberland 001F,E01027389,1195,872,323,171,29,123
2011,Northumberland 002A,E01027378,721,488,233,177,20,36
2011,Northumberland 002B,E01027379,1017,649,368,278,30,60
2011,Northumberland 002C,E01027380,1084,751,333,223,25,85
2011,Northumberland 002D,E01027382,1266,812,454,323,43,88
2011,Northumberland 002E,E01027386,997,664,333,225,32,76
2011,Northumberland 003A,E01027374,1538,1032,506,346,37,123
2011,Northumberland 003B,E01027375,1380,961,419,270,42,107
2011,Northumberland 003C,E01027381,1414,955,459,310,35,114
2011,Northumberland 003D,E01027383,982,593,389,286,12,91
2011,Northumberland 003E,E01027384,1097,703,394,293,29,72
2011,Northumberland 003F,E01027390,1421,945,476,337,36,103
2011,Northumberland 022A,E01027392,1182,668,514,195,58,261
2011,Northumberland 022B,E01027393,1027,651,376,122,47,207
2011,Northumberland 022C,E01027416,1084,605,479,169,52,258
2011,Northumberland 022D,E01027424,1437,864,573,192,76,305
2011,Northumberland 023A,E01027414,1136,802,334,161,33,140
2011,Northumberland 023B,E01027415,1192,723,469,179,38,252
2011,Northumberland 023C,E01027431,1314,880,434,194,26,214
2011,Northumberland 023D,E01027441,1480,1082,398,220,52,126
2011,Northumberland 023E,E01027442,1191,844,347,185,25,137
2011,Northumberland 024A,E01027391,1035,706,329,145,43,141
2011,Northumberland 024B,E01027422,1319,831,488,237,32,219
2011,Northumberland 024C,E01027423,1103,671,432,234,38,160
2011,Northumberland 024D,E01027429,1283,788,495,212,44,239
2011,Northumberland 024E,E01027430,1167,707,460,244,62,154
2011,Northumberland 025A,E01027425,1757,1289,468,277,65,126
2011,Northumberland 025B,E01027426,1023,633,390,100,69,221
2011,Northumberland 025C,E01027427,1198,786,412,199,37,176
2011,Northumberland 025D,E01027428,1224,876,348,235,45,68
2011,Northumberland 026A,E01027437,1408,990,418,304,39,75
2011,Northumberland 026B,E01027438,1151,849,302,194,45,63
2011,Northumberland 026C,E01027439,1497,1189,308,209,37,62
2011,Northumberland 026D,E01027440,1111,766,345,259,30,56
2011,Northumberland 027A,E01027400,964,819,145,77,34,34
2011,Northumberland 027B,E01027401,1108,863,245,164,45,36
2011,Northumberland 027C,E01027402,1037,778,259,164,54,41
2011,Northumberland 027D,E01027403,932,662,270,194,39,37
2011,Northumberland 029A,E01027398,1670,1163,507,169,79,259
2011,Northumberland 029B,E01027409,1132,717,415,303,38,74
2011,Northumberland 029C,E01027411,927,580,347,217,29,101
2011,Northumberland 029D,E01027412,1114,690,424,152,45,227
2011,Northumberland 029E,E01027413,1448,995,453,255,51,147
2011,Northumberland 028A,E01027395,1082,765,317,153,32,132
2011,Northumberland 028B,E01027396,1019,722,297,149,40,108
2011,Northumberland 028C,E01027397,985,589,396,193,31,172
2011,Northumberland 028D,E01027399,1195,982,213,94,38,81
2011,Northumberland 028E,E01027404,1213,935,278,162,36,80
2011,Northumberland 028F,E01027405,1186,800,386,284,49,53
2011,Northumberland 030A,E01027417,1077,677,400,304,26,70
2011,Northumberland 030B,E01027418,1404,1058,346,195,45,106
2011,Northumberland 030C,E01027419,1154,745,409,281,31,97
2011,Northumberland 030D,E01027420,1086,717,369,284,31,54
2011,Northumberland 030E,E01027421,1074,701,373,222,20,131
2011,Northumberland 031A,E01027394,933,622,311,207,30,74
2011,Northumberland 031B,E01027406,1038,644,394,313,23,58
2011,Northumberland 031C,E01027407,1068,735,333,241,28,64
2011,Northumberland 031D,E01027408,980,618,362,242,25,95
2011,Northumberland 031E,E01027410,1249,820,429,317,33,79
2011,Northumberland 032A,E01027432,1182,841,341,191,23,127
2011,Northumberland 032B,E01027433,1249,878,371,187,39,145
2011,Northumberland 032C,E01027434,1086,703,383,261,29,93
2011,Northumberland 032D,E01027435,1091,766,325,199,29,97
2011,Northumberland 032E,E01027436,1179,792,387,231,45,111
2011,Northumberland 008A,E01027443,1077,662,415,217,39,159
2011,Northumberland 008B,E01027444,2129,1079,1050,202,60,788
2011,Northumberland 008C,E01027445,1246,827,419,251,44,124
2011,Northumberland 008D,E01027446,1093,739,354,244,55,55
2011,Northumberland 008E,E01027451,1296,825,471,202,43,226
2011,Northumberland 008F,E01027474,1406,974,432,239,49,144
2011,Northumberland 008G,E01027475,1088,720,368,264,31,73
2011,Northumberland 011A,E01027457,1144,673,471,189,39,243
2011,Northumberland 011B,E01027462,1354,885,469,210,45,214
2011,Northumberland 011C,E01027463,1305,1011,294,196,26,72
2011,Northumberland 015A,E01027447,1359,1031,328,187,49,92
2011,Northumberland 015B,E01027448,1407,966,441,297,67,77
2011,Northumberland 015C,E01027450,1222,869,353,242,50,61
2011,Northumberland 015D,E01027473,1272,867,405,272,47,86
2011,Northumberland 016A,E01027452,1054,727,327,189,53,85
2011,Northumberland 016B,E01027453,954,632,322,210,15,97
2011,Northumberland 016E,E01027461,933,582,351,167,36,148
2011,Northumberland 016F,E01033718,1439,968,471,272,58,141
2011,Northumberland 018A,E01027455,1094,698,396,308,45,43
2011,Northumberland 018B,E01027456,1008,652,356,279,43,34
2011,Northumberland 018C,E01027458,1153,783,370,272,51,47
2011,Northumberland 018D,E01027460,1203,805,398,289,40,69
2011,Northumberland 033A,E01027464,947,599,348,250,43,55
2011,Northumberland 033B,E01027465,1060,727,333,213,49,71
2011,Northumberland 033C,E01027466,811,553,258,143,44,71
2011,Northumberland 033F,E01033714,1751,1110,641,412,85,144
2011,Northumberland 034A,E01027449,1127,738,389,298,33,58
2011,Northumberland 034B,E01027468,922,529,393,282,44,67
2011,Northumberland 034C,E01027469,1008,655,353,226,58,69
2011,Northumberland 034D,E01027471,1213,780,433,307,50,76
2011,Northumberland 034E,E01027472,1315,1001,314,175,50,89
2011,Northumberland 019A,E01027479,1699,1217,482,323,52,107
2011,Northumberland 019B,E01027480,950,702,248,149,42,57
2011,Northumberland 019C,E01027503,1388,993,395,286,30,79
2011,Northumberland 019D,E01027511,860,635,225,144,26,55
2011,Northumberland 037A,E01027484,1704,1165,539,363,53,123
2011,Northumberland 037B,E01027485,1068,720,348,202,30,116
2011,Northumberland 037C,E01027486,845,599,246,136,25,85
2011,Northumberland 037D,E01027487,851,571,280,184,21,75
2011,Northumberland 037E,E01027512,834,573,261,166,29,66
2011,Northumberland 036A,E01027483,977,728,249,171,29,49
2011,Northumberland 036B,E01027496,889,581,308,201,37,70
2011,Northumberland 036C,E01027508,836,608,228,158,25,45
2011,Northumberland 036D,E01027513,1367,963,404,286,61,57
2011,Northumberland 035A,E01027476,1753,1243,510,328,56,126
2011,Northumberland 035B,E01027489,1198,826,372,208,67,97
2011,Northumberland 035C,E01027490,1274,899,375,195,68,112
2011,Northumberland 035D,E01027491,1140,740,400,270,54,76
2011,Northumberland 035E,E01027492,1311,925,386,243,74,69
2011,Northumberland 035F,E01027493,1048,699,349,171,36,142
2011,Northumberland 035G,E01027494,1633,1132,501,345,55,101
2011,Northumberland 038A,E01027497,1976,1523,453,240,81,132
2011,Northumberland 038B,E01027498,1893,1345,548,291,57,200
2011,Northumberland 038C,E01027499,1130,724,406,284,35,87
2011,Northumberland 038D,E01027500,1201,847,354,208,36,110
2011,Northumberland 038E,E01027501,863,600,263,170,33,60
2011,Northumberland 038F,E01027502,993,731,262,161,42,59
2011,Northumberland 039A,E01027481,1150,792,358,252,40,66
2011,Northumberland 039B,E01027482,1133,749,384,259,57,68
2011,Northumberland 039C,E01027504,1444,920,524,313,78,133
2011,Northumberland 039D,E01027506,877,626,251,160,35,56
2011,Northumberland 039E,E01027507,1046,758,288,200,42,46
2011,Northumberland 039F,E01027509,976,641,335,245,27,63
2011,Northumberland 040A,E01027477,965,668,297,178,36,83
2011,Northumberland 040B,E01027478,785,558,227,146,31,50
2011,Northumberland 040C,E01027488,1612,1215,397,244,50,103
2011,Northumberland 040D,E01027495,777,545,232,154,22,56
2011,Northumberland 040E,E01027505,1071,786,285,175,42,68
2011,Northumberland 040F,E01027510,876,659,217,164,20,33
2011,Northumberland 009A,E01027541,1363,868,495,289,45,161
2011,Northumberland 009B,E01027542,1220,690,530,244,42,244
2011,Northumberland 009C,E01027543,935,585,350,128,44,178
2011,Northumberland 009D,E01027544,1040,650,390,239,26,125
2011,Northumberland 010A,E01027528,980,669,311,133,35,143
2011,Northumberland 010B,E01027529,880,629,251,131,37,83
2011,Northumberland 010C,E01027539,1252,771,481,208,36,237
2011,Northumberland 010D,E01027545,1459,924,535,165,53,317
2011,Northumberland 010E,E01027546,1274,837,437,153,50,234
2011,Northumberland 013A,E01027533,1212,722,490,182,42,266
2011,Northumberland 013B,E01027540,1375,882,493,167,72,254
2011,Northumberland 013E,E01027549,1217,968,249,135,32,82
2011,Northumberland 013F,E01033716,1763,1020,743,382,77,284
2011,Northumberland 012A,E01027524,1045,737,308,163,55,90
2011,Northumberland 012B,E01027525,1209,834,375,226,29,120
2011,Northumberland 012C,E01027526,1005,699,306,211,39,56
2011,Northumberland 012D,E01027527,941,601,340,137,35,168
2011,Northumberland 012E,E01027536,1157,785,372,198,50,124
2011,Northumberland 014A,E01027532,1499,1052,447,261,64,122
2011,Northumberland 014B,E01027537,1004,616,388,224,32,132
2011,Northumberland 014C,E01027538,1378,1004,374,250,43,81
2011,Northumberland 017A,E01027530,1018,712,306,134,36,136
2011,Northumberland 017B,E01027531,1269,939,330,160,35,135
2011,Northumberland 017C,E01027534,1309,861,448,215,45,188
2011,Northumberland 017D,E01027535,1092,692,400,333,27,40
2011,Northumberland 017E,E01027553,1259,890,369,225,41,103
2011,Northumberland 017F,E01027554,992,625,367,288,25,54
2011,Northumberland 020A,E01027515,1083,776,307,151,34,122
2011,Northumberland 020B,E01027517,1495,1102,393,230,40,123
2011,Northumberland 020C,E01027518,1020,624,396,145,54,197
2011,Northumberland 020D,E01027519,1015,682,333,142,33,158
2011,Northumberland 020E,E01027550,927,595,332,186,36,110
2011,Northumberland 020F,E01027551,1061,690,371,169,37,165
2011,Northumberland 020G,E01027552,977,649,328,174,30,124
2011,Northumberland 021A,E01027514,1184,782,402,279,36,87
2011,Northumberland 021B,E01027516,860,595,265,156,28,81
2011,Northumberland 021C,E01027520,1115,807,308,215,43,50
2011,Northumberland 021D,E01027521,1235,976,259,140,66,53
2011,Northumberland 021E,E01027522,938,606,332,164,40,128
2011,Northumberland 021F,E01027523,843,582,261,143,27,91
2011,Redcar and Cleveland 001A,E01012100,1272,829,443,140,56,247
2011,Redcar and Cleveland 001B,E01012101,1130,720,410,200,46,164
2011,Redcar and Cleveland 001C,E01012102,1630,1181,449,157,74,218
2011,Redcar and Cleveland 001D,E01012184,1061,716,345,197,40,108
2011,Redcar and Cleveland 002A,E01012105,981,680,301,164,42,95
2011,Redcar and Cleveland 002B,E01012142,1211,809,402,233,52,117
2011,Redcar and Cleveland 002C,E01012143,864,462,402,113,72,217
2011,Redcar and Cleveland 002D,E01012144,1055,694,361,211,52,98
2011,Redcar and Cleveland 003C,E01012106,977,650,327,199,38,90
2011,Redcar and Cleveland 003D,E01012107,979,566,413,197,49,167
2011,Redcar and Cleveland 003E,E01032560,779,494,285,191,26,68
2011,Redcar and Cleveland 003F,E01032561,1121,712,409,120,63,226
2011,Redcar and Cleveland 004A,E01012176,1023,642,381,260,40,81
2011,Redcar and Cleveland 004B,E01012177,1108,837,271,153,42,76
2011,Redcar and Cleveland 004C,E01012178,1055,727,328,210,44,74
2011,Redcar and Cleveland 004D,E01012179,1040,725,315,213,35,67
2011,Redcar and Cleveland 004E,E01012180,1343,1044,299,144,77,78
2011,Redcar and Cleveland 004F,E01012185,1052,723,329,182,31,116
2011,Redcar and Cleveland 004G,E01012186,1203,788,415,276,40,99
2011,Redcar and Cleveland 005A,E01012127,753,366,387,130,43,214
2011,Redcar and Cleveland 005B,E01012128,814,443,371,161,53,157
2011,Redcar and Cleveland 005C,E01012129,1608,1036,572,328,54,190
2011,Redcar and Cleveland 005D,E01012130,1016,635,381,231,40,110
2011,Redcar and Cleveland 005E,E01012131,927,454,473,212,49,212
2011,Redcar and Cleveland 006A,E01012138,1917,1448,469,304,61,104
2011,Redcar and Cleveland 006B,E01012139,1528,976,552,403,54,95
2011,Redcar and Cleveland 006C,E01012140,1011,625,386,240,43,103
2011,Redcar and Cleveland 006D,E01012141,836,518,318,241,34,43
2011,Redcar and Cleveland 006E,E01012154,958,562,396,326,33,37
2011,Redcar and Cleveland 006F,E01012155,1065,649,416,271,31,114
2011,Redcar and Cleveland 006G,E01012156,1255,791,464,349,43,72
2011,Redcar and Cleveland 006H,E01012157,1171,732,439,266,49,124
2011,Redcar and Cleveland 007A,E01012158,1016,605,411,308,37,66
2011,Redcar and Cleveland 007B,E01012159,1261,788,473,235,35,203
2011,Redcar and Cleveland 007C,E01012160,1037,661,376,198,68,110
2011,Redcar and Cleveland 007D,E01012161,1011,696,315,175,47,93
2011,Redcar and Cleveland 009A,E01012113,952,557,395,108,56,231
2011,Redcar and Cleveland 009B,E01012114,997,577,420,79,41,300
2011,Redcar and Cleveland 009E,E01012175,1010,597,413,170,45,198
2011,Redcar and Cleveland 009F,E01033471,1547,963,584,129,96,359
2011,Redcar and Cleveland 010A,E01012095,1013,666,347,241,29,77
2011,Redcar and Cleveland 010B,E01012097,901,496,405,276,28,101
2011,Redcar and Cleveland 010C,E01012098,994,684,310,190,34,86
2011,Redcar and Cleveland 010D,E01012099,1116,700,416,151,41,224
2011,Redcar and Cleveland 011A,E01012108,1061,682,379,185,58,136
2011,Redcar and Cleveland 011B,E01012109,1048,721,327,175,44,108
2011,Redcar and Cleveland 011C,E01012110,1109,844,265,130,38,97
2011,Redcar and Cleveland 011D,E01012111,915,538,377,193,38,146
2011,Redcar and Cleveland 011E,E01012171,1039,588,451,249,53,149
2011,Redcar and Cleveland 011F,E01012172,1031,659,372,247,30,95
2011,Redcar and Cleveland 012A,E01012162,1078,758,320,146,47,127
2011,Redcar and Cleveland 012B,E01012163,1644,1139,505,289,82,134
2011,Redcar and Cleveland 012C,E01012164,1239,800,439,268,48,123
2011,Redcar and Cleveland 012D,E01012165,1571,931,640,250,71,319
2011,Redcar and Cleveland 013A,E01012096,1161,679,482,191,34,257
2011,Redcar and Cleveland 013D,E01012136,1088,676,412,199,47,166
2011,Redcar and Cleveland 013E,E01033473,1499,867,632,244,58,330
2011,Redcar and Cleveland 015A,E01012112,1080,648,432,151,44,237
2011,Redcar and Cleveland 015B,E01012145,1117,768,349,181,42,126
2011,Redcar and Cleveland 015C,E01012147,1217,827,390,280,45,65
2011,Redcar and Cleveland 015D,E01012149,940,607,333,240,25,68
2011,Redcar and Cleveland 016A,E01012132,1516,866,650,348,62,240
2011,Redcar and Cleveland 016B,E01012134,1102,589,513,277,37,199
2011,Redcar and Cleveland 016C,E01012137,1013,613,400,211,47,142
2011,Redcar and Cleveland 016D,E01012181,1231,819,412,179,53,180
2011,Redcar and Cleveland 018A,E01012117,1016,642,374,196,36,142
2011,Redcar and Cleveland 018B,E01012118,1009,695,314,180,31,103
2011,Redcar and Cleveland 018C,E01012119,1512,1032,480,221,72,187
2011,Redcar and Cleveland 018D,E01012121,956,583,373,153,43,177
2011,Redcar and Cleveland 019E,E01032548,1100,619,481,388,33,60
2011,Redcar and Cleveland 019F,E01032549,1253,792,461,340,43,78
2011,Redcar and Cleveland 019G,E01033472,1870,1393,477,267,72,138
2011,Redcar and Cleveland 020A,E01012120,987,584,403,313,30,60
2011,Redcar and Cleveland 020B,E01012124,1103,664,439,326,44,69
2011,Redcar and Cleveland 020C,E01012182,1060,674,386,307,31,48
2011,Redcar and Cleveland 020D,E01012183,1193,880,313,213,41,59
2011,Redcar and Cleveland 021A,E01012148,1061,656,405,127,80,198
2011,Redcar and Cleveland 021B,E01012150,1125,685,440,170,72,198
2011,Redcar and Cleveland 021C,E01012151,1090,694,396,272,39,85
2011,Redcar and Cleveland 021D,E01012152,1181,778,403,267,46,90
2011,Redcar and Cleveland 021E,E01032594,977,596,381,262,32,87
2011,Redcar and Cleveland 022A,E01012146,967,604,363,264,32,67
2011,Redcar and Cleveland 022B,E01012167,1081,782,299,141,49,109
2011,Redcar and Cleveland 022C,E01012168,1386,931,455,185,59,211
2011,Redcar and Cleveland 022D,E01012170,924,512,412,114,53,245
2011,Redcar and Cleveland 022E,E01012173,865,563,302,191,38,73
2011,Redcar and Cleveland 022F,E01012174,816,519,297,214,30,53
2011,Redcar and Cleveland 022G,E01033470,1348,809,539,180,70,289
2011,Stockton-on-Tees 001A,E01012242,1148,784,364,223,40,101
2011,Stockton-on-Tees 001B,E01012243,1234,933,301,167,38,96
2011,Stockton-on-Tees 001C,E01012244,1129,840,289,180,45,64
2011,Stockton-on-Tees 001D,E01012246,1171,907,264,140,46,78
2011,Stockton-on-Tees 001E,E01012296,1035,696,339,182,22,135
2011,Stockton-on-Tees 001F,E01012297,2023,1534,489,237,110,142
2011,Stockton-on-Tees 002A,E01012197,1412,993,419,163,73,183
2011,Stockton-on-Tees 002B,E01012256,979,587,392,297,29,66
2011,Stockton-on-Tees 002C,E01012257,1028,689,339,241,33,65
2011,Stockton-on-Tees 002D,E01012275,1075,732,343,132,43,168
2011,Stockton-on-Tees 002E,E01012276,1178,747,431,207,37,187
2011,Stockton-on-Tees 002F,E01012277,1153,803,350,145,61,144
2011,Stockton-on-Tees 003A,E01012196,1214,817,397,149,67,181
2011,Stockton-on-Tees 003B,E01012198,1069,677,392,121,59,212
2011,Stockton-on-Tees 003C,E01012214,1143,788,355,149,48,158
2011,Stockton-on-Tees 003D,E01012215,862,545,317,103,52,162
2011,Stockton-on-Tees 003E,E01012216,943,627,316,137,53,126
2011,Stockton-on-Tees 003F,E01012245,1135,694,441,178,59,204
2011,Stockton-on-Tees 004A,E01012278,956,654,302,120,41,141
2011,Stockton-on-Tees 004B,E01012279,1265,966,299,140,43,116
2011,Stockton-on-Tees 004C,E01012280,1126,757,369,209,64,96
2011,Stockton-on-Tees 004D,E01012281,893,564,329,172,28,129
2011,Stockton-on-Tees 005A,E01012255,1027,594,433,346,40,47
2011,Stockton-on-Tees 005B,E01012269,1264,846,418,272,47,99
2011,Stockton-on-Tees 005D,E01012294,912,612,300,184,45,71
2011,Stockton-on-Tees 005E,E01012295,884,671,213,110,27,76
2011,Stockton-on-Tees 005F,E01033476,1246,948,298,160,54,84
2011,Stockton-on-Tees 005G,E01033480,1327,940,387,276,37,74
2011,Stockton-on-Tees 006A,E01012210,1240,882,358,248,45,65
2011,Stockton-on-Tees 006B,E01012211,1354,1010,344,202,57,85
2011,Stockton-on-Tees 006C,E01012212,1151,783,368,248,37,83
2011,Stockton-on-Tees 006D,E01012213,980,550,430,323,23,84
2011,Stockton-on-Tees 007A,E01012192,1190,791,399,225,54,120
2011,Stockton-on-Tees 007B,E01012193,1116,743,373,132,59,182
2011,Stockton-on-Tees 007C,E01012260,1215,861,354,233,37,84
2011,Stockton-on-Tees 007D,E01012261,1162,869,293,162,35,96
2011,Stockton-on-Tees 008A,E01012247,890,617,273,72,46,155
2011,Stockton-on-Tees 008B,E01012249,1069,698,371,141,55,175
2011,Stockton-on-Tees 008C,E01012271,1029,638,391,106,50,235
2011,Stockton-on-Tees 008D,E01012272,820,499,321,214,40,67
2011,Stockton-on-Tees 008E,E01012273,1108,718,390,101,68,221
2011,Stockton-on-Tees 008F,E01012274,957,641,316,97,52,167
2011,Stockton-on-Tees 009D,E01012248,1023,646,377,195,44,138
2011,Stockton-on-Tees 009E,E01012250,1004,563,441,177,33,231
2011,Stockton-on-Tees 009F,E01032542,742,502,240,63,38,139
2011,Stockton-on-Tees 009G,E01032543,1528,919,609,174,110,325
2011,Stockton-on-Tees 009H,E01032544,1462,1125,337,101,59,177
2011,Stockton-on-Tees 010A,E01012194,1096,797,299,119,45,135
2011,Stockton-on-Tees 010B,E01012195,1083,642,441,135,56,250
2011,Stockton-on-Tees 010C,E01012258,1664,690,974,135,46,793
2011,Stockton-on-Tees 010D,E01012259,1343,987,356,179,59,118
2011,Stockton-on-Tees 010E,E01012268,1234,786,448,164,57,227
2011,Stockton-on-Tees 011A,E01012187,1082,816,266,151,31,84
2011,Stockton-on-Tees 011B,E01012188,951,734,217,127,29,61
2011,Stockton-on-Tees 011C,E01012189,1057,715,342,254,23,65
2011,Stockton-on-Tees 011D,E01012205,1080,718,362,236,34,92
2011,Stockton-on-Tees 012A,E01012219,1348,998,350,175,59,116
2011,Stockton-on-Tees 012B,E01012251,1171,789,382,106,77,199
2011,Stockton-on-Tees 012C,E01012252,1032,613,419,91,72,256
2011,Stockton-on-Tees 012D,E01012253,909,630,279,115,52,112
2011,Stockton-on-Tees 012E,E01012254,1041,684,357,81,58,218
2011,Stockton-on-Tees 013A,E01012204,986,605,381,301,22,58
2011,Stockton-on-Tees 013B,E01012206,1035,653,382,234,29,119
2011,Stockton-on-Tees 013C,E01012207,1356,913,443,258,58,127
2011,Stockton-on-Tees 013D,E01012208,1227,901,326,204,66,56
2011,Stockton-on-Tees 014A,E01012262,1725,1024,701,104,332,265
2011,Stockton-on-Tees 014C,E01012264,1794,1342,452,171,71,210
2011,Stockton-on-Tees 014E,E01012266,1722,922,800,229,131,440
2011,Stockton-on-Tees 014F,E01012267,1247,639,608,161,116,331
2011,Stockton-on-Tees 014G,E01033477,1979,1143,836,143,247,446
2011,Stockton-on-Tees 015A,E01012190,1154,874,280,187,37,56
2011,Stockton-on-Tees 015B,E01012191,1095,683,412,244,57,111
2011,Stockton-on-Tees 015C,E01012224,1293,838,455,328,48,79
2011,Stockton-on-Tees 015D,E01012225,1157,756,401,283,55,63
2011,Stockton-on-Tees 015E,E01012226,1083,728,355,271,41,43
2011,Stockton-on-Tees 016A,E01012209,1244,877,367,181,79,107
2011,Stockton-on-Tees 016B,E01012217,1152,796,356,118,52,186
2011,Stockton-on-Tees 016C,E01012218,1106,762,344,182,61,101
2011,Stockton-on-Tees 016D,E01012223,1103,754,349,240,44,65
2011,Stockton-on-Tees 017A,E01012286,1096,658,438,97,96,245
2011,Stockton-on-Tees 017B,E01012287,1975,1008,967,112,661,194
2011,Stockton-on-Tees 017C,E01012288,1053,614,439,126,120,193
2011,Stockton-on-Tees 017D,E01012289,903,585,318,108,81,129
2011,Stockton-on-Tees 018A,E01012238,1103,723,380,139,62,179
2011,Stockton-on-Tees 018B,E01012239,1370,1016,354,93,61,200
2011,Stockton-on-Tees 018C,E01012240,1334,946,388,186,49,153
2011,Stockton-on-Tees 018D,E01012241,1183,853,330,187,53,90
2011,Stockton-on-Tees 019A,E01012290,1296,780,516,361,44,111
2011,Stockton-on-Tees 019B,E01012291,1242,838,404,137,57,210
2011,Stockton-on-Tees 019C,E01012292,1724,1216,508,201,79,228
2011,Stockton-on-Tees 020A,E01012282,946,627,319,133,43,143
2011,Stockton-on-Tees 020B,E01012283,936,612,324,141,38,145
2011,Stockton-on-Tees 020C,E01012284,1068,560,508,228,50,230
2011,Stockton-on-Tees 020D,E01012285,1048,669,379,211,37,131
2011,Stockton-on-Tees 021A,E01012199,1129,767,362,275,42,45
2011,Stockton-on-Tees 021B,E01012200,1490,1033,457,302,66,89
2011,Stockton-on-Tees 021C,E01012201,1263,855,408,305,49,54
2011,Stockton-on-Tees 021D,E01012202,1054,778,276,156,41,79
2011,Stockton-on-Tees 021E,E01012203,1346,1062,284,150,67,67
2011,Stockton-on-Tees 021F,E01012270,996,680,316,161,55,100
2011,Stockton-on-Tees 022A,E01012228,1053,847,206,110,31,65
2011,Stockton-on-Tees 022B,E01012230,1189,924,265,135,59,71
2011,Stockton-on-Tees 022C,E01012233,1087,784,303,186,44,73
2011,Stockton-on-Tees 022D,E01012236,1032,767,265,141,49,75
2011,Stockton-on-Tees 022E,E01012237,1064,803,261,136,55,70
2011,Stockton-on-Tees 023A,E01012227,1089,944,145,47,34,64
2011,Stockton-on-Tees 023C,E01012231,1386,1178,208,78,60,70
2011,Stockton-on-Tees 023D,E01012232,1061,874,187,89,37,61
2011,Stockton-on-Tees 023E,E01012234,1241,990,251,116,66,69
2011,Stockton-on-Tees 023F,E01033474,1151,1023,128,37,31,60
2011,Stockton-on-Tees 023G,E01033475,1229,1059,170,38,64,68
2011,Stockton-on-Tees 023H,E01033478,1302,1097,205,74,59,72
2011,Stockton-on-Tees 023I,E01033479,1261,1036,225,117,55,53
2011,Stockton-on-Tees 024A,E01012235,1118,611,507,226,32,249
2011,Stockton-on-Tees 024B,E01012298,1094,741,353,238,46,69
2011,Stockton-on-Tees 024C,E01012299,1138,902,236,149,32,55
2011,Stockton-on-Tees 024D,E01012300,1083,689,394,252,38,104
2011,Stockton-on-Tees 024E,E01012301,1053,782,271,175,46,50
2011,Stockton-on-Tees 024F,E01012302,944,678,266,190,29,47
2011,Stockton-on-Tees 024G,E01012303,1104,841,263,163,32,68
2011,Gateshead 001A,E01008246,1020,723,297,165,34,98
2011,Gateshead 001B,E01008247,1172,736,436,245,45,146
2011,Gateshead 001C,E01008248,1356,1064,292,175,48,69
2011,Gateshead 001D,E01008249,1123,683,440,336,22,82
2011,Gateshead 001E,E01008250,1088,768,320,182,33,105
2011,Gateshead 002A,E01008195,1530,1105,425,220,45,160
2011,Gateshead 002B,E01008197,1193,904,289,190,24,75
2011,Gateshead 002C,E01008198,976,665,311,181,40,90
2011,Gateshead 002D,E01008199,1034,763,271,183,33,55
2011,Gateshead 002E,E01008200,1037,743,294,190,47,57
2011,Gateshead 002F,E01008245,1085,739,346,249,38,59
2011,Gateshead 003A,E01008214,1182,672,510,158,62,290
2011,Gateshead 003B,E01008215,1243,834,409,119,49,241
2011,Gateshead 003C,E01008243,1149,760,389,263,42,84
2011,Gateshead 003D,E01008244,1588,1219,369,145,59,165
2011,Gateshead 004A,E01008178,1247,964,283,84,44,155
2011,Gateshead 004B,E01008180,1057,645,412,183,53,176
2011,Gateshead 004C,E01008182,1186,844,342,171,32,139
2011,Gateshead 004D,E01008277,1071,649,422,246,45,131
2011,Gateshead 004E,E01008280,1333,919,414,178,44,192
2011,Gateshead 005A,E01008177,1074,760,314,184,35,95
2011,Gateshead 005B,E01008179,940,747,193,110,25,58
2011,Gateshead 005C,E01008181,1116,761,355,224,31,100
2011,Gateshead 005D,E01008276,1072,741,331,202,32,97
2011,Gateshead 005E,E01008279,1113,715,398,290,36,72
2011,Gateshead 007A,E01008209,1625,1179,446,203,54,189
2011,Gateshead 007B,E01008210,1038,712,326,144,36,146
2011,Gateshead 007C,E01008258,1810,1298,512,132,71,309
2011,Gateshead 007D,E01008259,1499,992,507,169,56,282
2011,Gateshead 008A,E01008167,1260,861,399,120,72,207
2011,Gateshead 008B,E01008169,939,581,358,48,118,192
2011,Gateshead 008C,E01008170,1564,1052,512,181,84,247
2011,Gateshead 008D,E01008171,1168,594,574,72,367,135
2011,Gateshead 008E,E01008257,1055,613,442,208,39,195
2011,Gateshead 009A,E01008262,1387,1014,373,137,41,195
2011,Gateshead 009B,E01008263,1109,802,307,137,28,142
2011,Gateshead 009C,E01008264,1037,699,338,238,39,61
2011,Gateshead 009D,E01008265,1076,752,324,159,44,121
2011,Gateshead 009E,E01008266,1008,688,320,252,29,39
2011,Gateshead 010A,E01008251,1445,1078,367,129,62,176
2011,Gateshead 010B,E01008252,1234,841,393,105,114,174
2011,Gateshead 010C,E01008253,1345,1043,302,73,73,156
2011,Gateshead 010D,E01008254,1053,748,305,91,42,172
2011,Gateshead 010E,E01008255,1256,831,425,203,55,167
2011,Gateshead 011A,E01008165,1058,682,376,126,50,200
2011,Gateshead 011B,E01008201,1100,571,529,166,81,282
2011,Gateshead 011C,E01008202,1371,1015,356,131,58,167
2011,Gateshead 011D,E01008204,1148,671,477,157,43,277
2011,Gateshead 012A,E01008212,1033,643,390,162,36,192
2011,Gateshead 012B,E01008213,1072,696,376,212,42,122
2011,Gateshead 012C,E01008216,1092,670,422,198,34,190
2011,Gateshead 012D,E01008228,879,564,315,150,33,132
2011,Gateshead 013A,E01008206,1243,931,312,187,29,96
2011,Gateshead 013B,E01008207,1101,792,309,200,33,76
2011,Gateshead 013C,E01008208,1209,801,408,203,44,161
2011,Gateshead 013D,E01008211,1306,940,366,192,44,130
2011,Gateshead 014A,E01008283,1089,803,286,208,32,46
2011,Gateshead 014B,E01008284,1099,757,342,191,43,108
2011,Gateshead 014C,E01008286,1074,693,381,200,48,133
2011,Gateshead 014D,E01008287,1496,1220,276,116,62,98
2011,Gateshead 015A,E01008231,1129,738,391,163,47,181
2011,Gateshead 015B,E01008240,1076,680,396,196,41,159
2011,Gateshead 015C,E01008241,1135,733,402,204,45,153
2011,Gateshead 015D,E01008242,1147,755,392,162,51,179
2011,Gateshead 015E,E01008281,1012,650,362,167,36,159
2011,Gateshead 015F,E01008282,1031,686,345,142,43,160
2011,Gateshead 016A,E01008219,1266,883,383,177,41,165
2011,Gateshead 016B,E01008235,1108,823,285,177,44,64
2011,Gateshead 016C,E01008236,1077,762,315,192,33,90
2011,Gateshead 016D,E01008237,1120,846,274,173,54,47
2011,Gateshead 016E,E01008238,1179,897,282,161,56,65
2011,Gateshead 017A,E01008267,988,587,401,250,31,120
2011,Gateshead 017B,E01008269,1093,724,369,296,36,37
2011,Gateshead 017C,E01008270,966,559,407,338,22,47
2011,Gateshead 017D,E01008271,1106,742,364,262,43,59
2011,Gateshead 017E,E01008275,1126,747,379,290,43,46
2011,Gateshead 018A,E01008229,1010,637,373,250,34,89
2011,Gateshead 018B,E01008230,1003,703,300,132,42,126
2011,Gateshead 018C,E01008232,958,582,376,139,47,190
2011,Gateshead 018D,E01008233,1117,836,281,190,27,64
2011,Gateshead 018E,E01008285,1022,662,360,136,40,184
2011,Gateshead 019A,E01008256,1354,977,377,224,46,107
2011,Gateshead 019B,E01008260,1191,944,247,144,33,70
2011,Gateshead 019C,E01008261,1060,692,368,154,37,177
2011,Gateshead 019D,E01008268,1074,760,314,170,51,93
2011,Gateshead 019E,E01008272,1024,672,352,273,30,49
2011,Gateshead 019F,E01008273,1142,866,276,174,30,72
2011,Gateshead 019G,E01008274,1085,767,318,160,40,118
2011,Gateshead 020A,E01008193,888,599,289,196,32,61
2011,Gateshead 020B,E01008194,1049,721,328,244,33,51
2011,Gateshead 020C,E01008234,1597,1117,480,329,52,99
2011,Gateshead 020D,E01008239,1147,865,282,188,37,57
2011,Gateshead 021A,E01008218,1165,706,459,205,37,217
2011,Gateshead 021B,E01008220,847,489,358,113,42,203
2011,Gateshead 021C,E01008221,1230,783,447,169,56,222
2011,Gateshead 021D,E01008225,1300,839,461,276,30,155
2011,Gateshead 021E,E01008227,1186,658,528,82,66,380
2011,Gateshead 022A,E01008184,1039,664,375,289,24,62
2011,Gateshead 022B,E01008185,966,585,381,169,45,167
2011,Gateshead 022C,E01008188,1044,724,320,214,40,66
2011,Gateshead 022D,E01008278,1079,727,352,269,34,49
2011,Gateshead 023A,E01008189,1014,650,364,171,40,153
2011,Gateshead 023B,E01008190,970,602,368,279,34,55
2011,Gateshead 023C,E01008191,1125,692,433,204,54,175
2011,Gateshead 023D,E01008192,1071,679,392,194,50,148
2011,Gateshead 023E,E01008217,1114,731,383,211,40,132
2011,Gateshead 024A,E01008183,1070,732,338,168,38,132
2011,Gateshead 024B,E01008186,1511,1014,497,199,48,250
2011,Gateshead 024C,E01008187,1186,740,446,238,54,154
2011,Gateshead 024D,E01008196,1439,976,463,288,48,127
2011,Gateshead 025A,E01008222,1100,754,346,158,43,145
2011,Gateshead 025B,E01008223,1272,794,478,181,50,247
2011,Gateshead 025C,E01008224,1368,861,507,313,72,122
2011,Gateshead 025D,E01008226,1140,762,378,197,48,133
2011,Gateshead 026A,E01008172,1228,750,478,328,50,100
2011,Gateshead 026B,E01008173,1151,743,408,134,63,211
2011,Gateshead 026C,E01008174,1475,1010,465,252,62,151
2011,Gateshead 026D,E01008175,1098,793,305,139,38,128
2011,Gateshead 026E,E01008176,1149,788,361,225,50,86
2011,Gateshead 027A,E01008162,1967,1477,490,130,160,200
2011,Gateshead 027B,E01008164,1009,674,335,83,62,190
2011,Gateshead 027C,E01008166,1368,830,538,138,143,257
2011,Gateshead 027D,E01008168,1981,1200,781,139,437,205
2011,Gateshead 028A,E01008163,1342,807,535,139,212,184
2011,Gateshead 028B,E01008203,1433,977,456,123,114,219
2011,Gateshead 028C,E01008205,1099,811,288,188,37,63
2011,Newcastle upon Tyne 001A,E01008294,1184,880,304,141,74,89
2011,Newcastle upon Tyne 001B,E01008306,1215,759,456,271,36,149
2011,Newcastle upon Tyne 001C,E01008307,715,499,216,107,31,78
2011,Newcastle upon Tyne 001D,E01008308,1043,753,290,156,42,92
2011,Newcastle upon Tyne 001E,E01008311,1297,990,307,155,78,74
2011,Newcastle upon Tyne 001F,E01008312,940,672,268,117,70,81
2011,Newcastle upon Tyne 001G,E01008313,932,676,256,135,50,71
2011,Newcastle upon Tyne 002A,E01008309,1178,815,363,245,58,60
2011,Newcastle upon Tyne 002C,E01008352,1054,740,314,125,84,105
2011,Newcastle upon Tyne 002D,E01008357,1178,776,402,251,71,80
2011,Newcastle upon Tyne 002E,E01008358,1113,790,323,170,51,102
2011,Newcastle upon Tyne 002F,E01033550,1380,1153,227,74,63,90
2011,Newcastle upon Tyne 002G,E01033551,1295,896,399,270,69,60
2011,Newcastle upon Tyne 003A,E01008336,994,613,381,162,56,163
2011,Newcastle upon Tyne 003B,E01008337,979,604,375,152,52,171
2011,Newcastle upon Tyne 003C,E01008338,908,615,293,92,61,140
2011,Newcastle upon Tyne 003D,E01008339,1069,705,364,115,73,176
2011,Newcastle upon Tyne 003E,E01008340,1034,623,411,73,67,271
2011,Newcastle upon Tyne 003F,E01008341,998,678,320,136,48,136
2011,Newcastle upon Tyne 003G,E01008342,1020,709,311,233,29,49
2011,Newcastle upon Tyne 004A,E01008293,1110,829,281,136,66,79
2011,Newcastle upon Tyne 004B,E01008456,1057,707,350,158,38,154
2011,Newcastle upon Tyne 004C,E01008457,1144,768,376,136,32,208
2011,Newcastle upon Tyne 004D,E01008458,1178,827,351,219,43,89
2011,Newcastle upon Tyne 004E,E01008459,1234,702,532,126,78,328
2011,Newcastle upon Tyne 004F,E01008460,1056,658,398,169,50,179
2011,Newcastle upon Tyne 005A,E01008351,1040,686,354,201,61,92
2011,Newcastle upon Tyne 005B,E01008354,1288,918,370,135,102,133
2011,Newcastle upon Tyne 005C,E01008418,1461,1093,368,200,94,74
2011,Newcastle upon Tyne 005D,E01008420,980,687,293,162,75,56
2011,Newcastle upon Tyne 005E,E01008422,1292,880,412,146,217,49
2011,Newcastle upon Tyne 005F,E01008424,1421,939,482,73,328,81
2011,Newcastle upon Tyne 006A,E01008353,1091,697,394,162,83,149
2011,Newcastle upon Tyne 006B,E01008355,1136,877,259,138,62,59
2011,Newcastle upon Tyne 006C,E01008356,1167,730,437,162,75,200
2011,Newcastle upon Tyne 006D,E01008378,1012,715,297,144,74,79
2011,Newcastle upon Tyne 006E,E01008419,1138,908,230,100,76,54
2011,Newcastle upon Tyne 006F,E01008421,1111,854,257,130,60,67
2011,Newcastle upon Tyne 006G,E01008423,955,657,298,165,86,47
2011,Newcastle upon Tyne 007A,E01008317,1037,778,259,134,61,64
2011,Newcastle upon Tyne 007B,E01008319,1399,1080,319,171,65,83
2011,Newcastle upon Tyne 007C,E01008320,1071,762,309,159,55,95
2011,Newcastle upon Tyne 007D,E01008321,1266,898,368,198,75,95
2011,Newcastle upon Tyne 007E,E01008322,1104,835,269,139,67,63
2011,Newcastle upon Tyne 007F,E01008323,1359,989,370,100,199,71
2011,Newcastle upon Tyne 008A,E01008295,1037,650,387,117,57,213
2011,Newcastle upon Tyne 008B,E01008374,1162,845,317,144,56,117
2011,Newcastle upon Tyne 008C,E01008375,1104,714,390,167,45,178
2011,Newcastle upon Tyne 008D,E01008376,894,673,221,125,40,56
2011,Newcastle upon Tyne 008E,E01008377,1534,1111,423,94,80,249
2011,Newcastle upon Tyne 008F,E01008379,1071,669,402,211,54,137
2011,Newcastle upon Tyne 008G,E01008380,1178,672,506,76,99,331
2011,Newcastle upon Tyne 011A,E01008296,1093,703,390,224,22,144
2011,Newcastle upon Tyne 011B,E01008297,990,562,428,165,39,224
2011,Newcastle upon Tyne 011C,E01008298,1028,707,321,139,48,134
2011,Newcastle upon Tyne 011D,E01008299,915,590,325,114,54,157
2011,Newcastle upon Tyne 012A,E01008314,1232,667,565,120,382,63
2011,Newcastle upon Tyne 012B,E01008315,1139,837,302,135,79,88
2011,Newcastle upon Tyne 012C,E01008316,1236,924,312,187,56,69
2011,Newcastle upon Tyne 012D,E01008318,1038,693,345,142,69,134
2011,Newcastle upon Tyne 012E,E01008363,1259,897,362,228,60,74
2011,Newcastle upon Tyne 012F,E01008365,1254,949,305,114,113,78
2011,Newcastle upon Tyne 013A,E01008366,1934,870,1064,62,967,35
2011,Newcastle upon Tyne 013B,E01008369,1837,913,924,73,809,42
2011,Newcastle upon Tyne 013C,E01008371,1004,655,349,163,135,51
2011,Newcastle upon Tyne 013D,E01008372,1799,860,939,77,806,56
2011,Newcastle upon Tyne 013E,E01008373,2281,966,1315,30,1265,20
2011,Newcastle upon Tyne 014A,E01008400,957,571,386,189,30,167
2011,Newcastle upon Tyne 014B,E01008401,1051,618,433,225,44,164
2011,Newcastle upon Tyne 014C,E01008402,1106,765,341,198,27,116
2011,Newcastle upon Tyne 014D,E01008403,1059,688,371,263,40,68
2011,Newcastle upon Tyne 014E,E01008404,1290,964,326,144,32,150
2011,Newcastle upon Tyne 014F,E01008405,1020,716,304,133,38,133
2011,Newcastle upon Tyne 014G,E01008443,1055,788,267,199,26,42
2011,Newcastle upon Tyne 015A,E01008324,878,527,351,160,46,145
2011,Newcastle upon Tyne 015B,E01008325,969,563,406,217,29,160
2011,Newcastle upon Tyne 015C,E01008326,1057,825,232,118,51,63
2011,Newcastle upon Tyne 015D,E01008327,868,509,359,137,44,178
2011,Newcastle upon Tyne 015E,E01008328,895,586,309,241,24,44
2011,Newcastle upon Tyne 015F,E01008329,1084,775,309,147,53,109
2011,Newcastle upon Tyne 015G,E01008330,927,613,314,132,37,145
2011,Newcastle upon Tyne 016A,E01008300,1140,744,396,152,63,181
2011,Newcastle upon Tyne 016B,E01008450,979,608,371,100,82,189
2011,Newcastle upon Tyne 016C,E01008451,1358,974,384,142,72,170
2011,Newcastle upon Tyne 016D,E01008452,1044,686,358,135,115,108
2011,Newcastle upon Tyne 017A,E01008367,2068,1168,900,75,768,57
2011,Newcastle upon Tyne 017B,E01008368,1681,692,989,48,891,50
2011,Newcastle upon Tyne 017C,E01008370,1435,865,570,139,383,48
2011,Newcastle upon Tyne 017D,E01008409,1502,949,553,66,413,74
2011,Newcastle upon Tyne 017E,E01008411,1674,862,812,75,672,65
2011,Newcastle upon Tyne 018A,E01008303,1546,806,740,222,222,296
2011,Newcastle upon Tyne 018B,E01008359,1454,946,508,52,378,78
2011,Newcastle upon Tyne 018C,E01008360,1520,1150,370,45,254,71
2011,Newcastle upon Tyne 018D,E01008361,1423,1006,417,46,267,104
2011,Newcastle upon Tyne 018E,E01008362,1630,1029,601,66,430,105
2011,Newcastle upon Tyne 018F,E01008364,1498,1132,366,52,255,59
2011,Newcastle upon Tyne 019A,E01008343,1101,772,329,166,58,105
2011,Newcastle upon Tyne 019B,E01008344,1128,735,393,171,63,159
2011,Newcastle upon Tyne 019C,E01008345,1151,754,397,155,39,203
2011,Newcastle upon Tyne 019D,E01008346,1367,748,619,81,418,120
2011,Newcastle upon Tyne 019E,E01008347,1017,713,304,125,52,127
2011,Newcastle upon Tyne 019F,E01008348,794,465,329,78,74,177
2011,Newcastle upon Tyne 019G,E01008349,1067,652,415,82,138,195
2011,Newcastle upon Tyne 019H,E01008350,936,650,286,121,38,127
2011,Newcastle upon Tyne 020A,E01008430,1017,686,331,138,52,141
2011,Newcastle upon Tyne 020B,E01008431,1052,752,300,156,39,105
2011,Newcastle upon Tyne 020C,E01008433,1024,678,346,241,35,70
2011,Newcastle upon Tyne 020D,E01008434,1111,791,320,178,62,80
2011,Newcastle upon Tyne 020E,E01008435,1051,679,372,143,43,186
2011,Newcastle upon Tyne 020F,E01008436,1112,736,376,109,55,212
2011,Newcastle upon Tyne 021A,E01008381,1102,841,261,176,31,54
2011,Newcastle upon Tyne 021B,E01008382,855,495,360,118,53,189
2011,Newcastle upon Tyne 021C,E01008383,1042,686,356,146,47,163
2011,Newcastle upon Tyne 021D,E01008384,1026,736,290,183,43,64
2011,Newcastle upon Tyne 021E,E01008385,1060,763,297,126,31,140
2011,Newcastle upon Tyne 021F,E01008386,988,709,279,163,35,81
2011,Newcastle upon Tyne 021G,E01008387,1052,727,325,202,27,96
2011,Newcastle upon Tyne 022B,E01008396,2525,973,1552,62,1250,240
2011,Newcastle upon Tyne 022C,E01008398,1289,752,537,78,158,301
2011,Newcastle upon Tyne 022D,E01008449,1436,819,617,35,368,214
2011,Newcastle upon Tyne 022E,E01008453,1180,776,404,137,123,144
2011,Newcastle upon Tyne 022G,E01008455,1122,674,448,63,177,208
2011,Newcastle upon Tyne 022H,E01033556,2137,1171,966,108,660,198
2011,Newcastle upon Tyne 023A,E01008406,1279,612,667,151,323,193
2011,Newcastle upon Tyne 023B,E01008407,2658,1146,1512,93,1314,105
2011,Newcastle upon Tyne 023D,E01008410,1499,834,665,125,442,98
2011,Newcastle upon Tyne 023E,E01008412,1479,1018,461,67,338,56
2011,Newcastle upon Tyne 023F,E01008413,1337,772,565,55,382,128
2011,Newcastle upon Tyne 023G,E01033548,977,662,315,70,154,91
2011,Newcastle upon Tyne 023H,E01033553,2540,1184,1356,40,1232,84
2011,Newcastle upon Tyne 024A,E01008394,1387,472,915,16,873,26
2011,Newcastle upon Tyne 024B,E01008395,1231,563,668,145,381,142
2011,Newcastle upon Tyne 024C,E01008397,1755,640,1115,33,1025,57
2011,Newcastle upon Tyne 024D,E01008399,1324,700,624,144,167,313
2011,Newcastle upon Tyne 024E,E01008439,1301,725,576,114,122,340
2011,Newcastle upon Tyne 024G,E01033543,1260,637,623,17,562,44
2011,Newcastle upon Tyne 024H,E01033545,1145,714,431,39,300,92
2011,Newcastle upon Tyne 024I,E01033554,1192,709,483,55,331,97
2011,Newcastle upon Tyne 025B,E01008415,866,557,309,113,41,155
2011,Newcastle upon Tyne 025C,E01008416,1298,922,376,198,62,116
2011,Newcastle upon Tyne 025E,E01033547,1440,785,655,216,59,380
2011,Newcastle upon Tyne 026A,E01008301,1478,1056,422,125,102,195
2011,Newcastle upon Tyne 026B,E01008302,1215,728,487,180,43,264
2011,Newcastle upon Tyne 026C,E01008304,1482,849,633,144,101,388
2011,Newcastle upon Tyne 026D,E01008305,1437,826,611,166,97,348
2011,Newcastle upon Tyne 026E,E01008391,1047,601,446,137,59,250
2011,Newcastle upon Tyne 026F,E01008392,1230,809,421,144,44,233
2011,Newcastle upon Tyne 026G,E01008432,1042,661,381,174,48,159
2011,Newcastle upon Tyne 027A,E01008288,1002,699,303,143,34,126
2011,Newcastle upon Tyne 027B,E01008289,1061,619,442,142,66,234
2011,Newcastle upon Tyne 027C,E01008290,930,569,361,120,54,187
2011,Newcastle upon Tyne 027D,E01008291,1449,805,644,139,116,389
2011,Newcastle upon Tyne 027E,E01008292,998,742,256,154,39,63
2011,Newcastle upon Tyne 028A,E01008388,1257,729,528,172,65,291
2011,Newcastle upon Tyne 028B,E01008389,1217,707,510,156,62,292
2011,Newcastle upon Tyne 028C,E01008426,1111,622,489,121,63,305
2011,Newcastle upon Tyne 028D,E01008429,968,572,396,155,43,198
2011,Newcastle upon Tyne 029A,E01008331,1297,699,598,59,185,354
2011,Newcastle upon Tyne 029B,E01008332,1560,902,658,134,167,357
2011,Newcastle upon Tyne 029C,E01008333,1271,708,563,124,118,321
2011,Newcastle upon Tyne 029D,E01008334,1489,904,585,128,170,287
2011,Newcastle upon Tyne 029E,E01008335,1400,840,560,102,176,282
2011,Newcastle upon Tyne 029F,E01008437,870,451,419,121,60,238
2011,Newcastle upon Tyne 029G,E01008438,1276,707,569,148,72,349
2011,Newcastle upon Tyne 030A,E01008390,1192,712,480,127,49,304
2011,Newcastle upon Tyne 030B,E01008425,1354,799,555,177,67,311
2011,Newcastle upon Tyne 030C,E01008427,890,458,432,116,45,271
2011,Newcastle upon Tyne 030D,E01008428,903,556,347,148,37,162
2011,Newcastle upon Tyne 031A,E01008441,1178,759,419,223,58,138
2011,Newcastle upon Tyne 031B,E01008442,1010,657,353,296,23,34
2011,Newcastle upon Tyne 031C,E01008444,1137,779,358,251,43,64
2011,Newcastle upon Tyne 031D,E01008445,1388,972,416,225,52,139
2011,Newcastle upon Tyne 031E,E01008446,1055,653,402,312,32,58
2011,Newcastle upon Tyne 031F,E01008447,943,605,338,239,42,57
2011,Newcastle upon Tyne 031G,E01008448,1197,836,361,269,38,54
2011,North Tyneside 001A,E01008547,971,569,402,327,40,35
2011,North Tyneside 001B,E01008548,1014,626,388,291,43,54
2011,North Tyneside 001C,E01008549,1023,659,364,283,35,46
2011,North Tyneside 001D,E01008551,1010,638,372,288,33,51
2011,North Tyneside 002A,E01008478,1148,725,423,207,32,184
2011,North Tyneside 002B,E01008480,1141,736,405,235,27,143
2011,North Tyneside 002C,E01008504,1198,839,359,245,34,80
2011,North Tyneside 002D,E01008578,1087,752,335,173,35,127
2011,North Tyneside 002E,E01008583,1078,795,283,118,45,120
2011,North Tyneside 003A,E01008520,989,713,276,167,45,64
2011,North Tyneside 003B,E01008523,941,694,247,168,42,37
2011,North Tyneside 003C,E01008546,1024,703,321,241,41,39
2011,North Tyneside 003D,E01008550,1188,887,301,168,58,75
2011,North Tyneside 004A,E01008577,947,649,298,191,32,75
2011,North Tyneside 004B,E01008579,1025,659,366,302,31,33
2011,North Tyneside 004C,E01008580,1050,741,309,199,32,78
2011,North Tyneside 004D,E01008581,942,571,371,301,20,50
2011,North Tyneside 004E,E01008582,983,709,274,158,25,91
2011,North Tyneside 005A,E01008517,1103,798,305,206,47,52
2011,North Tyneside 005B,E01008519,1023,750,273,150,51,72
2011,North Tyneside 005C,E01008521,1084,750,334,239,32,63
2011,North Tyneside 005D,E01008522,1166,867,299,218,36,45
2011,North Tyneside 006A,E01008584,1229,879,350,117,53,180
2011,North Tyneside 006B,E01008585,1159,877,282,139,53,90
2011,North Tyneside 006C,E01008587,1060,792,268,143,37,88
2011,North Tyneside 006D,E01008588,1238,924,314,134,50,130
2011,North Tyneside 006E,E01008589,1075,787,288,190,51,47
2011,North Tyneside 007A,E01008518,1143,797,346,218,39,89
2011,North Tyneside 007B,E01008564,1088,793,295,199,30,66
2011,North Tyneside 007C,E01008565,1501,1128,373,150,56,167
2011,North Tyneside 007D,E01008567,1024,703,321,138,39,144
2011,North Tyneside 008A,E01008475,1293,1034,259,172,33,54
2011,North Tyneside 008B,E01008476,1229,855,374,196,36,142
2011,North Tyneside 008C,E01008477,1139,815,324,137,48,139
2011,North Tyneside 008D,E01008479,1096,814,282,198,15,69
2011,North Tyneside 009A,E01008552,1217,860,357,236,30,91
2011,North Tyneside 009B,E01008553,1308,979,329,192,44,93
2011,North Tyneside 009C,E01008554,1223,839,384,177,69,138
2011,North Tyneside 009D,E01008555,1109,751,358,180,52,126
2011,North Tyneside 009E,E01008586,1078,818,260,147,34,79
2011,North Tyneside 010A,E01008495,1245,873,372,274,41,57
2011,North Tyneside 010B,E01008496,1148,797,351,199,39,113
2011,North Tyneside 010C,E01008497,1030,705,325,244,35,46
2011,North Tyneside 010D,E01008498,982,584,398,305,37,56
2011,North Tyneside 011B,E01008568,1066,687,379,232,28,119
2011,North Tyneside 011C,E01008569,978,638,340,156,41,143
2011,North Tyneside 011D,E01008570,1009,822,187,108,23,56
2011,North Tyneside 011E,E01032647,1309,1124,185,68,52,65
2011,North Tyneside 011F,E01032648,1059,766,293,98,35,160
2011,North Tyneside 012A,E01008500,1189,875,314,200,37,77
2011,North Tyneside 012B,E01008505,1255,894,361,238,40,83
2011,North Tyneside 012C,E01008506,1057,714,343,178,36,129
2011,North Tyneside 012D,E01008507,1141,863,278,175,38,65
2011,North Tyneside 013A,E01008493,1092,725,367,244,47,76
2011,North Tyneside 013B,E01008494,1064,710,354,216,38,100
2011,North Tyneside 013C,E01008556,1387,1006,381,237,53,91
2011,North Tyneside 013D,E01008557,1247,876,371,225,66,80
2011,North Tyneside 014A,E01008470,1020,705,315,169,47,99
2011,North Tyneside 014B,E01008499,1210,862,348,178,47,123
2011,North Tyneside 014C,E01008502,1162,790,372,174,48,150
2011,North Tyneside 014D,E01008516,918,634,284,212,26,46
2011,North Tyneside 015A,E01008488,1052,728,324,157,36,131
2011,North Tyneside 015B,E01008489,1145,756,389,144,59,186
2011,North Tyneside 015C,E01008490,1182,768,414,266,37,111
2011,North Tyneside 015D,E01008491,1130,781,349,150,46,153
2011,North Tyneside 016A,E01008558,1170,845,325,208,40,77
2011,North Tyneside 016B,E01008560,1287,966,321,196,33,92
2011,North Tyneside 016C,E01008561,1237,804,433,249,26,158
2011,North Tyneside 016D,E01008562,1059,735,324,219,37,68
2011,North Tyneside 017A,E01008525,1103,770,333,236,30,67
2011,North Tyneside 017B,E01008527,1163,898,265,158,34,73
2011,North Tyneside 017C,E01008559,1185,961,224,114,21,89
2011,North Tyneside 017D,E01008563,1010,679,331,215,54,62
2011,North Tyneside 018A,E01008469,1096,804,292,178,45,69
2011,North Tyneside 018B,E01008472,1062,773,289,214,33,42
2011,North Tyneside 018C,E01008473,965,674,291,154,38,99
2011,North Tyneside 018D,E01008501,1521,1256,265,113,57,95
2011,North Tyneside 018E,E01008503,1166,828,338,163,39,136
2011,North Tyneside 019A,E01008471,1181,812,369,168,50,151
2011,North Tyneside 019B,E01008474,1070,709,361,127,61,173
2011,North Tyneside 019C,E01008513,1671,1253,418,174,45,199
2011,North Tyneside 019D,E01008514,1271,885,386,157,71,158
2011,North Tyneside 019F,E01032649,843,665,178,72,19,87
2011,North Tyneside 019G,E01032650,837,585,252,102,24,126
2011,North Tyneside 020A,E01008486,1024,696,328,160,32,136
2011,North Tyneside 020B,E01008487,1047,690,357,187,41,129
2011,North Tyneside 020C,E01008526,1137,820,317,225,33,59
2011,North Tyneside 020D,E01008530,1169,751,418,294,34,90
2011,North Tyneside 021A,E01008461,1069,678,391,205,53,133
2011,North Tyneside 021B,E01008466,1109,848,261,181,25,55
2011,North Tyneside 021C,E01008467,1109,844,265,144,36,85
2011,North Tyneside 021D,E01008468,1081,765,316,132,49,135
2011,North Tyneside 022A,E01008483,1250,965,285,121,38,126
2011,North Tyneside 022B,E01008524,1342,894,448,220,29,199
2011,North Tyneside 022C,E01008528,1101,847,254,147,43,64
2011,North Tyneside 022D,E01008529,1186,873,313,203,31,79
2011,North Tyneside 023A,E01008481,1057,725,332,145,45,142
2011,North Tyneside 023B,E01008482,1190,769,421,177,41,203
2011,North Tyneside 023C,E01008484,996,642,354,102,39,213
2011,North Tyneside 023D,E01008485,1015,566,449,103,65,281
2011,North Tyneside 023E,E01008492,1255,850,405,143,59,203
2011,North Tyneside 024A,E01008462,893,608,285,143,39,103
2011,North Tyneside 024B,E01008463,1004,669,335,189,33,113
2011,North Tyneside 024C,E01008464,1054,732,322,214,24,84
2011,North Tyneside 024D,E01008465,1063,735,328,219,32,77
2011,North Tyneside 025A,E01008531,1197,922,275,161,34,80
2011,North Tyneside 025B,E01008532,1108,769,339,178,42,119
2011,North Tyneside 025C,E01008534,1084,785,299,183,38,78
2011,North Tyneside 025D,E01008538,1030,827,203,116,36,51
2011,North Tyneside 026A,E01008508,1134,761,373,148,53,172
2011,North Tyneside 026B,E01008509,1139,748,391,136,48,207
2011,North Tyneside 026C,E01008510,1175,827,348,189,24,135
2011,North Tyneside 026D,E01008512,1131,761,370,157,45,168
2011,North Tyneside 027A,E01008539,1159,923,236,115,22,99
2011,North Tyneside 027B,E01008540,1142,719,423,138,45,240
2011,North Tyneside 027C,E01008541,1144,747,397,173,40,184
2011,North Tyneside 027D,E01008544,1252,808,444,157,35,252
2011,North Tyneside 027E,E01008545,936,564,372,135,36,201
2011,North Tyneside 028A,E01008511,1243,833,410,168,51,191
2011,North Tyneside 028B,E01008542,1059,695,364,120,54,190
2011,North Tyneside 028C,E01008543,1590,1199,391,123,55,213
2011,North Tyneside 028D,E01008571,1273,861,412,195,44,173
2011,North Tyneside 029A,E01008572,1311,938,373,116,43,214
2011,North Tyneside 029B,E01008573,1272,951,321,105,46,170
2011,North Tyneside 029C,E01008574,1181,840,341,190,48,103
2011,North Tyneside 029D,E01008576,1510,1092,418,143,78,197
2011,North Tyneside 030A,E01008533,1045,710,335,144,44,147
2011,North Tyneside 030B,E01008535,1133,802,331,192,50,89
2011,North Tyneside 030C,E01008536,1130,882,248,104,34,110
2011,North Tyneside 030D,E01008537,1002,710,292,132,37,123
2011,North Tyneside 030E,E01008575,1040,741,299,123,33,143
2011,South Tyneside 001A,E01008595,1231,897,334,141,49,144
2011,South Tyneside 001B,E01008596,975,590,385,109,69,207
2011,South Tyneside 001C,E01008597,1851,1375,476,205,74,197
2011,South Tyneside 001D,E01008598,1181,832,349,146,47,156
2011,South Tyneside 001E,E01008599,1064,639,425,212,49,164
2011,South Tyneside 002A,E01008664,1109,725,384,102,97,185
2011,South Tyneside 002B,E01008665,1136,797,339,115,40,184
2011,South Tyneside 002C,E01008666,1041,569,472,124,54,294
2011,South Tyneside 002D,E01008667,1196,719,477,217,40,220
2011,South Tyneside 002E,E01008668,1166,758,408,145,46,217
2011,South Tyneside 003A,E01008673,923,680,243,144,43,56
2011,South Tyneside 003B,E01008675,1084,839,245,105,35,105
2011,South Tyneside 003C,E01008676,919,693,226,92,39,95
2011,South Tyneside 003D,E01008677,1090,743,347,184,78,85
2011,South Tyneside 003E,E01008678,987,693,294,126,76,92
2011,South Tyneside 004A,E01008647,1079,720,359,235,38,86
2011,South Tyneside 004B,E01008648,1020,641,379,235,48,96
2011,South Tyneside 004C,E01008649,1128,734,394,177,54,163
2011,South Tyneside 004D,E01008651,1252,770,482,140,69,273
2011,South Tyneside 005A,E01008679,989,685,304,158,44,102
2011,South Tyneside 005B,E01008680,1041,698,343,239,42,62
2011,South Tyneside 005C,E01008682,825,482,343,135,49,159
2011,South Tyneside 005D,E01008683,1125,813,312,124,59,129
2011,South Tyneside 006A,E01008635,972,617,355,224,40,91
2011,South Tyneside 006B,E01008650,1072,777,295,186,36,73
2011,South Tyneside 006C,E01008674,981,679,302,194,51,57
2011,South Tyneside 006D,E01008681,1055,670,385,261,46,78
2011,South Tyneside 007A,E01008600,1022,668,354,135,32,187
2011,South Tyneside 007B,E01008604,1201,761,440,164,50,226
2011,South Tyneside 007C,E01008660,1140,828,312,142,49,121
2011,South Tyneside 007D,E01008661,873,569,304,169,25,110
2011,South Tyneside 008A,E01008633,983,667,316,118,39,159
2011,South Tyneside 008B,E01008634,886,550,336,134,49,153
2011,South Tyneside 008C,E01008636,1054,662,392,182,50,160
2011,South Tyneside 008D,E01008637,1059,708,351,170,55,126
2011,South Tyneside 009A,E01008639,1461,1037,424,137,68,219
2011,South Tyneside 009B,E01008652,840,538,302,147,33,122
2011,South Tyneside 009C,E01008653,922,629,293,112,48,133
2011,South Tyneside 009D,E01008654,983,729,254,91,36,127
2011,South Tyneside 009E,E01008655,1065,679,386,158,47,181
2011,South Tyneside 009F,E01008657,1037,752,285,191,41,53
2011,South Tyneside 010A,E01008638,1086,916,170,58,44,68
2011,South Tyneside 010B,E01008640,1480,1080,400,189,62,149
2011,South Tyneside 010C,E01008641,1103,696,407,164,47,196
2011,South Tyneside 010D,E01008642,1088,789,299,189,45,65
2011,South Tyneside 011A,E01008590,1154,739,415,201,42,172
2011,South Tyneside 011B,E01008591,1126,772,354,130,29,195
2011,South Tyneside 011C,E01008592,1123,822,301,124,39,138
2011,South Tyneside 011D,E01008594,1244,815,429,192,58,179
2011,South Tyneside 012A,E01008601,1050,674,376,164,39,173
2011,South Tyneside 012B,E01008669,1023,608,415,177,45,193
2011,South Tyneside 012C,E01008671,977,642,335,119,43,173
2011,South Tyneside 012D,E01008672,993,630,363,170,41,152
2011,South Tyneside 013A,E01008622,1223,741,482,322,39,121
2011,South Tyneside 013C,E01008625,1050,580,470,230,52,188
2011,South Tyneside 013E,E01033074,1557,1002,555,241,77,237
2011,South Tyneside 014A,E01008602,1047,689,358,133,42,183
2011,South Tyneside 014B,E01008603,978,630,348,138,36,174
2011,South Tyneside 014C,E01008608,757,444,313,137,25,151
2011,South Tyneside 014D,E01008670,1095,703,392,162,43,187
2011,South Tyneside 015A,E01008643,1070,769,301,163,44,94
2011,South Tyneside 015B,E01008644,1049,647,402,202,34,166
2011,South Tyneside 015C,E01008645,1025,674,351,125,54,172
2011,South Tyneside 015D,E01008646,973,632,341,204,34,103
2011,South Tyneside 015E,E01008656,1042,687,355,177,39,139
2011,South Tyneside 015F,E01008658,986,607,379,184,52,143
2011,South Tyneside 016A,E01008593,912,565,347,116,30,201
2011,South Tyneside 016B,E01008605,885,636,249,128,30,91
2011,South Tyneside 016C,E01008606,982,599,383,126,49,208
2011,South Tyneside 016D,E01008607,918,567,351,112,34,205
2011,South Tyneside 016E,E01008609,1006,633,373,127,49,197
2011,South Tyneside 017A,E01008631,1106,731,375,174,44,157
2011,South Tyneside 017B,E01008632,935,616,319,144,33,142
2011,South Tyneside 017C,E01008659,1063,680,383,212,36,135
2011,South Tyneside 017D,E01008662,915,585,330,134,45,151
2011,South Tyneside 017E,E01008663,944,578,366,202,33,131
2011,South Tyneside 018A,E01008624,1019,692,327,155,56,116
2011,South Tyneside 018B,E01008684,898,567,331,164,19,148
2011,South Tyneside 018C,E01008685,1396,894,502,271,63,168
2011,South Tyneside 018D,E01008686,1213,790,423,242,52,129
2011,South Tyneside 018E,E01008687,1183,738,445,291,33,121
2011,South Tyneside 019A,E01008688,962,652,310,134,33,143
2011,South Tyneside 019B,E01008689,1076,648,428,196,35,197
2011,South Tyneside 019C,E01008690,1059,697,362,125,56,181
2011,South Tyneside 019D,E01008691,1022,729,293,181,44,68
2011,South Tyneside 019E,E01008692,1018,685,333,149,43,141
2011,South Tyneside 020A,E01008627,1068,727,341,240,33,68
2011,South Tyneside 020B,E01008628,1023,625,398,193,41,164
2011,South Tyneside 020C,E01008629,1086,778,308,204,30,74
2011,South Tyneside 020D,E01008630,1036,671,365,166,35,164
2011,South Tyneside 021A,E01008610,930,539,391,169,47,175
2011,South Tyneside 021B,E01008611,1172,938,234,124,43,67
2011,South Tyneside 021C,E01008612,1177,866,311,172,42,97
2011,South Tyneside 021D,E01008613,1177,791,386,155,30,201
2011,South Tyneside 022A,E01008616,1150,863,287,168,49,70
2011,South Tyneside 022B,E01008618,930,610,320,228,37,55
2011,South Tyneside 022C,E01008619,1137,718,419,303,48,68
2011,South Tyneside 022D,E01008621,1032,702,330,223,43,64
2011,South Tyneside 023A,E01008614,1143,818,325,172,43,110
2011,South Tyneside 023B,E01008615,1030,733,297,171,32,94
2011,South Tyneside 023C,E01008617,1071,732,339,229,52,58
2011,South Tyneside 023D,E01008620,990,652,338,235,50,53
2011,Sunderland 001A,E01008713,1223,873,350,200,65,85
2011,Sunderland 001B,E01008722,1073,746,327,249,36,42
2011,Sunderland 001C,E01008724,881,658,223,139,35,49
2011,Sunderland 001D,E01008726,1083,758,325,207,44,74
2011,Sunderland 002A,E01008723,959,626,333,220,49,64
2011,Sunderland 002B,E01008725,1035,694,341,242,37,62
2011,Sunderland 002C,E01008727,1150,807,343,217,36,90
2011,Sunderland 002D,E01008728,1114,812,302,161,54,87
2011,Sunderland 002E,E01008792,912,579,333,216,29,88
2011,Sunderland 003A,E01008698,1052,670,382,176,31,175
2011,Sunderland 003B,E01008837,947,628,319,118,37,164
2011,Sunderland 003C,E01008838,1157,733,424,158,46,220
2011,Sunderland 003D,E01008839,1003,620,383,122,38,223
2011,Sunderland 003E,E01008840,1008,679,329,102,37,190
2011,Sunderland 003F,E01008841,851,478,373,137,45,191
2011,Sunderland 004A,E01008712,1226,722,504,200,46,258
2011,Sunderland 004B,E01008817,806,444,362,91,44,227
2011,Sunderland 004C,E01008819,1005,627,378,184,44,150
2011,Sunderland 004D,E01008821,923,515,408,183,37,188
2011,Sunderland 004E,E01008822,1174,726,448,172,42,234
2011,Sunderland 004F,E01008842,1109,782,327,140,38,149
2011,Sunderland 005A,E01008708,1068,710,358,184,35,139
2011,Sunderland 005B,E01008709,1062,660,402,137,45,220
2011,Sunderland 005D,E01008711,1089,771,318,153,37,128
2011,Sunderland 005F,E01008820,885,584,301,124,28,149
2011,Sunderland 005G,E01033075,1500,868,632,212,68,352
2011,Sunderland 006A,E01008786,1044,710,334,213,36,85
2011,Sunderland 006B,E01008787,1320,865,455,165,158,132
2011,Sunderland 006C,E01008788,1137,806,331,211,30,90
2011,Sunderland 006D,E01008789,1091,759,332,175,58,99
2011,Sunderland 006E,E01008790,1163,798,365,161,81,123
2011,Sunderland 006F,E01008791,1438,795,643,197,214,232
2011,Sunderland 007A,E01008855,1153,896,257,120,35,102
2011,Sunderland 007B,E01008856,1097,714,383,292,23,68
2011,Sunderland 007C,E01008876,1177,789,388,255,57,76
2011,Sunderland 007D,E01008877,1080,756,324,204,33,87
2011,Sunderland 008A,E01008693,951,600,351,152,37,162
2011,Sunderland 008B,E01008694,1001,663,338,145,35,158
2011,Sunderland 008C,E01008695,1089,748,341,117,38,186
2011,Sunderland 008D,E01008696,998,765,233,98,47,88
2011,Sunderland 008E,E01008697,923,558,365,201,31,133
2011,Sunderland 008F,E01008699,1039,670,369,157,49,163
2011,Sunderland 009A,E01008853,992,640,352,137,38,177
2011,Sunderland 009B,E01008854,1174,848,326,102,48,176
2011,Sunderland 009C,E01008857,977,688,289,127,35,127
2011,Sunderland 009D,E01008858,951,588,363,113,48,202
2011,Sunderland 009E,E01008859,963,646,317,82,39,196
2011,Sunderland 009F,E01008860,1038,666,372,161,36,175
2011,Sunderland 009G,E01008878,1114,743,371,189,54,128
2011,Sunderland 010A,E01008873,1030,712,318,223,28,67
2011,Sunderland 010B,E01008874,1285,867,418,160,68,190
2011,Sunderland 010C,E01008875,1177,858,319,137,43,139
2011,Sunderland 010D,E01008879,1115,810,305,167,36,102
2011,Sunderland 010E,E01008880,912,620,292,154,30,108
2011,Sunderland 011A,E01008701,1477,952,525,99,240,186
2011,Sunderland 011B,E01008704,1155,793,362,128,84,150
2011,Sunderland 011C,E01008706,1171,774,397,118,132,147
2011,Sunderland 011D,E01008707,1269,776,493,65,308,120
2011,Sunderland 012A,E01008756,1085,693,392,171,43,178
2011,Sunderland 012B,E01008762,1092,667,425,149,57,219
2011,Sunderland 012C,E01008812,1258,832,426,149,47,230
2011,Sunderland 012F,E01033076,1138,630,508,174,61,273
2011,Sunderland 013A,E01008700,986,597,389,105,151,133
2011,Sunderland 013B,E01008703,1943,991,952,170,487,295
2011,Sunderland 013C,E01008705,906,553,353,99,119,135
2011,Sunderland 013D,E01008831,1901,1181,720,139,368,213
2011,Sunderland 013E,E01008834,1585,1131,454,70,199,185
2011,Sunderland 014A,E01008810,1227,780,447,172,46,229
2011,Sunderland 014B,E01008811,1224,839,385,213,45,127
2011,Sunderland 014C,E01008813,1125,712,413,176,45,192
2011,Sunderland 014D,E01008814,1170,783,387,203,41,143
2011,Sunderland 015A,E01008757,1109,685,424,202,50,172
2011,Sunderland 015B,E01008758,1084,727,357,205,52,100
2011,Sunderland 015C,E01008759,1120,756,364,212,56,96
2011,Sunderland 015D,E01008761,1004,687,317,215,32,70
2011,Sunderland 016A,E01008702,808,425,383,135,33,215
2011,Sunderland 016B,E01008735,1485,990,495,177,79,239
2011,Sunderland 016C,E01008736,927,546,381,104,56,221
2011,Sunderland 016D,E01008737,1042,677,365,101,55,209
2011,Sunderland 016E,E01008738,1023,628,395,129,84,182
2011,Sunderland 016F,E01008836,1201,614,587,171,97,319
2011,Sunderland 017A,E01008845,1134,753,381,269,27,85
2011,Sunderland 017B,E01008846,820,524,296,104,47,145
2011,Sunderland 017C,E01008847,965,611,354,119,55,180
2011,Sunderland 017D,E01008850,1338,1029,309,154,55,100
2011,Sunderland 017E,E01008851,1202,843,359,163,44,152
2011,Sunderland 018A,E01008760,1127,832,295,157,46,92
2011,Sunderland 018B,E01008830,1156,772,384,84,189,111
2011,Sunderland 018C,E01008832,1117,764,353,142,73,138
2011,Sunderland 018D,E01008833,1061,687,374,172,85,117
2011,Sunderland 019A,E01008843,1023,718,305,202,41,62
2011,Sunderland 019B,E01008844,1072,687,385,260,29,96
2011,Sunderland 019C,E01008848,1038,623,415,311,38,66
2011,Sunderland 019D,E01008849,882,592,290,83,44,163
2011,Sunderland 019E,E01008852,990,765,225,145,24,56
2011,Sunderland 020A,E01008867,1277,919,358,84,47,227
2011,Sunderland 020B,E01008868,1012,753,259,173,36,50
2011,Sunderland 020C,E01008869,1017,729,288,173,33,82
2011,Sunderland 020D,E01008870,1127,861,266,161,41,64
2011,Sunderland 020E,E01008871,1115,795,320,135,50,135
2011,Sunderland 020F,E01008872,1172,854,318,199,38,81
2011,Sunderland 021A,E01008729,787,477,310,81,38,191
2011,Sunderland 021B,E01008730,1204,737,467,137,74,256
2011,Sunderland 021C,E01008731,908,542,366,144,35,187
2011,Sunderland 021D,E01008732,1480,1039,441,161,73,207
2011,Sunderland 021E,E01008733,1224,750,474,197,41,236
2011,Sunderland 021F,E01008734,1091,655,436,326,36,74
2011,Sunderland 022A,E01008740,1077,686,391,212,43,136
2011,Sunderland 022B,E01008781,1155,792,363,197,67,99
2011,Sunderland 022C,E01008782,1075,700,375,260,52,63
2011,Sunderland 022D,E01008783,1071,713,358,236,50,72
2011,Sunderland 022E,E01008784,1140,789,351,222,54,75
2011,Sunderland 022F,E01008785,1088,666,422,303,51,68
2011,Sunderland 022G,E01008835,1223,833,390,110,131,149
2011,Sunderland 023A,E01008823,1059,609,450,195,75,180
2011,Sunderland 023B,E01008824,1082,701,381,109,53,219
2011,Sunderland 023C,E01008825,1132,688,444,214,49,181
2011,Sunderland 023D,E01008826,1068,678,390,156,69,165
2011,Sunderland 023E,E01008827,882,536,346,109,49,188
2011,Sunderland 023F,E01008828,1120,684,436,155,62,219
2011,Sunderland 023G,E01008829,977,565,412,111,59,242
2011,Sunderland 024A,E01008739,1153,760,393,140,71,182
2011,Sunderland 024B,E01008741,1092,744,348,180,43,125
2011,Sunderland 024C,E01008779,1042,695,347,188,42,117
2011,Sunderland 024D,E01008780,1430,972,458,181,63,214
2011,Sunderland 025A,E01008799,1287,987,300,168,47,85
2011,Sunderland 025B,E01008861,1162,772,390,202,47,141
2011,Sunderland 025C,E01008862,1191,873,318,204,44,70
2011,Sunderland 025D,E01008863,1282,894,388,254,49,85
2011,Sunderland 025E,E01008864,1041,660,381,243,51,87
2011,Sunderland 025F,E01008865,1021,668,353,205,33,115
2011,Sunderland 025G,E01008866,1047,755,292,135,36,121
2011,Sunderland 026A,E01008773,1015,651,364,128,49,187
2011,Sunderland 026B,E01008776,849,563,286,100,44,142
2011,Sunderland 026C,E01008777,971,483,488,300,22,166
2011,Sunderland 026D,E01008778,977,670,307,151,47,109
2011,Sunderland 026E,E01008809,1187,798,389,220,37,132
2011,Sunderland 027A,E01008803,1031,672,359,180,30,149
2011,Sunderland 027B,E01008804,1140,736,404,171,62,171
2011,Sunderland 027C,E01008805,1064,735,329,121,68,140
2011,Sunderland 027F,E01033077,1334,893,441,185,76,180
2011,Sunderland 028A,E01008763,1077,732,345,147,54,144
2011,Sunderland 028B,E01008764,1140,777,363,182,56,125
2011,Sunderland 028C,E01008766,1617,1120,497,181,90,226
2011,Sunderland 028D,E01008768,1061,754,307,155,41,111
2011,Sunderland 028E,E01008769,1264,809,455,194,64,197
2011,Sunderland 029A,E01008772,1004,689,315,221,40,54
2011,Sunderland 029B,E01008774,932,587,345,237,43,65
2011,Sunderland 029C,E01008775,1066,693,373,270,42,61
2011,Sunderland 029D,E01008802,1065,697,368,258,40,70
2011,Sunderland 029E,E01008808,1203,909,294,174,50,70
2011,Sunderland 030A,E01008793,1171,678,493,199,36,258
2011,Sunderland 030B,E01008795,1339,966,373,195,51,127
2011,Sunderland 030C,E01008797,1442,965,477,304,56,117
2011,Sunderland 030D,E01008800,1026,643,383,117,54,212
2011,Sunderland 030E,E01008801,1218,872,346,222,33,91
2011,Sunderland 031A,E01008765,1175,864,311,173,45,93
2011,Sunderland 031B,E01008767,1110,756,354,181,48,125
2011,Sunderland 031C,E01008770,1132,851,281,147,49,85
2011,Sunderland 031D,E01008771,1140,811,329,171,44,114
2011,Sunderland 032A,E01008720,1042,684,358,191,38,129
2011,Sunderland 032B,E01008721,1181,873,308,144,56,108
2011,Sunderland 032D,E01008796,1181,898,283,118,48,117
2011,Sunderland 032F,E01032483,1311,902,409,169,54,186
2011,Sunderland 032G,E01032484,1004,657,347,206,33,108
2011,Sunderland 033A,E01008750,1426,1016,410,213,57,140
2011,Sunderland 033B,E01008751,786,510,276,119,31,126
2011,Sunderland 033C,E01008752,1136,722,414,137,56,221
2011,Sunderland 033D,E01008753,868,589,279,131,37,111
2011,Sunderland 033E,E01008755,1014,657,357,169,30,158
2011,Sunderland 034A,E01008714,876,532,344,115,42,187
2011,Sunderland 034B,E01008715,973,663,310,145,38,127
2011,Sunderland 034C,E01008716,1045,687,358,264,28,66
2011,Sunderland 034D,E01008717,1196,790,406,180,65,161
2011,Sunderland 034E,E01008749,1087,668,419,294,38,87
2011,Sunderland 034F,E01008754,1009,613,396,200,36,160
2011,Sunderland 035A,E01008718,1058,627,431,223,32,176
2011,Sunderland 035B,E01008719,887,555,332,164,32,136
2011,Sunderland 035C,E01008742,1269,875,394,172,53,169
2011,Sunderland 035D,E01008747,1103,685,418,259,35,124
2011,Sunderland 035E,E01008748,1051,575,476,308,33,135
2011,Sunderland 036A,E01008743,1179,645,534,191,43,300
2011,Sunderland 036B,E01008744,1174,702,472,188,61,223
2011,Sunderland 036C,E01008745,1298,821,477,321,36,120
2011,Sunderland 036D,E01008746,1173,649,524,175,51,298
2011,Blackburn with Darwen 001A,E01012607,1099,647,452,245,53,154
2011,Blackburn with Darwen 001B,E01012608,1158,747,411,142,50,219
2011,Blackburn with Darwen 001C,E01012633,1144,829,315,181,40,94
2011,Blackburn with Darwen 001D,E01012634,1004,707,297,147,47,103
2011,Blackburn with Darwen 001E,E01012635,1139,739,400,168,84,148
2011,Blackburn with Darwen 001F,E01012636,1068,697,371,261,45,65
2011,Blackburn with Darwen 002A,E01012581,870,606,264,165,37,62
2011,Blackburn with Darwen 002B,E01012582,1192,805,387,164,89,134
2011,Blackburn with Darwen 002C,E01012583,1169,797,372,225,54,93
2011,Blackburn with Darwen 002D,E01012587,1343,866,477,139,86,252
2011,Blackburn with Darwen 002E,E01012588,1331,804,527,82,114,331
2011,Blackburn with Darwen 003A,E01012574,956,469,487,156,75,256
2011,Blackburn with Darwen 003B,E01012577,1212,638,574,76,111,387
2011,Blackburn with Darwen 003C,E01012578,1326,690,636,94,140,402
2011,Blackburn with Darwen 003D,E01012605,1232,673,559,90,129,340
2011,Blackburn with Darwen 003E,E01012606,1063,595,468,74,95,299
2011,Blackburn with Darwen 004A,E01012579,1127,607,520,68,110,342
2011,Blackburn with Darwen 004B,E01012580,1502,780,722,97,156,469
2011,Blackburn with Darwen 004C,E01012642,1152,619,533,80,132,321
2011,Blackburn with Darwen 004D,E01012645,1267,811,456,104,92,260
2011,Blackburn with Darwen 005A,E01012585,1085,646,439,125,95,219
2011,Blackburn with Darwen 005B,E01012586,1145,651,494,67,98,329
2011,Blackburn with Darwen 005C,E01012656,1158,644,514,100,86,328
2011,Blackburn with Darwen 005D,E01012657,1363,757,606,102,101,403
2011,Blackburn with Darwen 005E,E01012658,1291,883,408,160,52,196
2011,Blackburn with Darwen 006A,E01012629,852,588,264,58,52,154
2011,Blackburn with Darwen 006B,E01012631,888,453,435,121,49,265
2011,Blackburn with Darwen 006C,E01012643,1111,531,580,119,87,374
2011,Blackburn with Darwen 006D,E01012644,1851,1045,806,134,169,503
2011,Blackburn with Darwen 006E,E01012655,1333,623,710,164,87,459
2011,Blackburn with Darwen 007A,E01012571,977,508,469,61,102,306
2011,Blackburn with Darwen 007B,E01012572,1042,520,522,88,97,337
2011,Blackburn with Darwen 007C,E01012573,1201,688,513,72,125,316
2011,Blackburn with Darwen 007D,E01012575,902,433,469,129,59,281
2011,Blackburn with Darwen 007E,E01012630,1485,832,653,82,161,410
2011,Blackburn with Darwen 008A,E01012576,1120,530,590,127,189,274
2011,Blackburn with Darwen 008B,E01012637,1081,593,488,118,53,317
2011,Blackburn with Darwen 008C,E01012638,1151,650,501,120,57,324
2011,Blackburn with Darwen 008D,E01012639,1229,634,595,149,90,356
2011,Blackburn with Darwen 008E,E01012640,1256,786,470,168,68,234
2011,Blackburn with Darwen 008F,E01012641,1061,616,445,94,77,274
2011,Blackburn with Darwen 009A,E01012595,1361,946,415,151,64,200
2011,Blackburn with Darwen 009B,E01012596,1314,928,386,111,53,222
2011,Blackburn with Darwen 009C,E01012622,1153,681,472,120,66,286
2011,Blackburn with Darwen 009D,E01012623,1099,824,275,116,52,107
2011,Blackburn with Darwen 009E,E01012624,1141,791,350,155,42,153
2011,Blackburn with Darwen 009F,E01012625,1182,837,345,145,34,166
2011,Blackburn with Darwen 010A,E01012584,1052,737,315,156,53,106
2011,Blackburn with Darwen 010B,E01012609,1188,816,372,284,42,46
2011,Blackburn with Darwen 010C,E01012610,920,695,225,135,38,52
2011,Blackburn with Darwen 010D,E01012611,800,558,242,180,27,35
2011,Blackburn with Darwen 010E,E01012612,1026,647,379,298,22,59
2011,Blackburn with Darwen 010F,E01012613,965,718,247,163,42,42
2011,Blackburn with Darwen 011A,E01012600,971,539,432,184,63,185
2011,Blackburn with Darwen 011B,E01012601,1062,566,496,134,71,291
2011,Blackburn with Darwen 011C,E01012602,1223,1022,201,102,34,65
2011,Blackburn with Darwen 011D,E01012603,1101,705,396,103,67,226
2011,Blackburn with Darwen 011E,E01012604,1149,852,297,108,59,130
2011,Blackburn with Darwen 011F,E01012632,1484,990,494,144,118,232
2011,Blackburn with Darwen 012A,E01012594,1008,599,409,163,55,191
2011,Blackburn with Darwen 012B,E01012618,1074,771,303,199,45,59
2011,Blackburn with Darwen 012C,E01012619,934,527,407,113,50,244
2011,Blackburn with Darwen 012D,E01012620,1058,657,401,282,27,92
2011,Blackburn with Darwen 012E,E01012621,1094,764,330,112,50,168
2011,Blackburn with Darwen 013A,E01012593,1331,982,349,186,39,124
2011,Blackburn with Darwen 013B,E01012597,1334,1059,275,143,52,80
2011,Blackburn with Darwen 013C,E01012598,2120,1812,308,136,85,87
2011,Blackburn with Darwen 013D,E01012599,881,675,206,132,22,52
2011,Blackburn with Darwen 014A,E01012589,1027,702,325,131,47,147
2011,Blackburn with Darwen 014B,E01012590,943,611,332,148,38,146
2011,Blackburn with Darwen 014C,E01012591,1144,707,437,186,41,210
2011,Blackburn with Darwen 014D,E01012648,863,595,268,106,31,131
2011,Blackburn with Darwen 014E,E01012652,1173,802,371,264,48,59
2011,Blackburn with Darwen 015A,E01012617,1062,759,303,128,46,129
2011,Blackburn with Darwen 015B,E01012646,1142,700,442,162,42,238
2011,Blackburn with Darwen 015C,E01012647,993,555,438,184,40,214
2011,Blackburn with Darwen 015D,E01012650,955,600,355,110,45,200
2011,Blackburn with Darwen 016A,E01012649,1014,633,381,124,53,204
2011,Blackburn with Darwen 016B,E01012651,1198,853,345,159,48,138
2011,Blackburn with Darwen 016C,E01012653,967,700,267,127,40,100
2011,Blackburn with Darwen 016D,E01012654,1254,846,408,123,53,232
2011,Blackburn with Darwen 017A,E01012614,1320,979,341,183,68,90
2011,Blackburn with Darwen 017B,E01012615,1106,696,410,226,34,150
2011,Blackburn with Darwen 017C,E01012616,1338,1017,321,188,49,84
2011,Blackburn with Darwen 017D,E01012659,1060,796,264,153,25,86
2011,Blackburn with Darwen 017E,E01012660,890,649,241,147,41,53
2011,Blackburn with Darwen 017F,E01012661,1129,845,284,149,38,97
2011,Blackburn with Darwen 018A,E01012592,1516,1095,421,280,50,91
2011,Blackburn with Darwen 018D,E01012628,940,705,235,158,27,50
2011,Blackburn with Darwen 018E,E01032485,1359,1015,344,217,47,80
2011,Blackburn with Darwen 018F,E01032486,1063,738,325,224,49,52
2011,Blackpool 001A,E01012663,1104,709,395,252,27,116
2011,Blackpool 001B,E01012664,1169,810,359,221,36,102
2011,Blackpool 001C,E01012665,1128,633,495,367,26,102
2011,Blackpool 001D,E01012716,1017,707,310,190,37,83
2011,Blackpool 001E,E01012719,964,650,314,221,13,80
2011,Blackpool 002A,E01012662,1032,595,437,314,23,100
2011,Blackpool 002B,E01012703,1051,646,405,261,31,113
2011,Blackpool 002C,E01012704,1491,853,638,243,60,335
2011,Blackpool 002D,E01012706,1207,892,315,193,44,78
2011,Blackpool 002E,E01012717,1175,808,367,248,33,86
2011,Blackpool 003A,E01012666,1055,708,347,191,32,124
2011,Blackpool 003B,E01012667,1091,759,332,212,45,75
2011,Blackpool 003C,E01012668,1113,765,348,203,47,98
2011,Blackpool 003D,E01012669,1318,904,414,250,40,124
2011,Blackpool 003E,E01012718,1130,672,458,338,40,80
2011,Blackpool 004A,E01012690,1287,960,327,194,45,88
2011,Blackpool 004B,E01012691,1329,929,400,215,47,138
2011,Blackpool 004C,E01012692,1251,830,421,205,44,172
2011,Blackpool 004D,E01012705,1118,720,398,204,44,150
2011,Blackpool 004E,E01012723,1083,799,284,176,30,78
2011,Blackpool 005A,E01012693,1125,791,334,224,36,74
2011,Blackpool 005B,E01012711,1043,701,342,161,44,137
2011,Blackpool 005C,E01012747,1088,765,323,211,40,72
2011,Blackpool 005D,E01012750,1266,888,378,194,46,138
2011,Blackpool 006A,E01012681,1362,911,451,124,33,294
2011,Blackpool 006B,E01012683,1124,642,482,139,52,291
2011,Blackpool 006C,E01012748,1282,875,407,169,39,199
2011,Blackpool 006D,E01012749,1295,853,442,193,39,210
2011,Blackpool 007A,E01012707,921,599,322,150,28,144
2011,Blackpool 007B,E01012720,1046,569,477,136,54,287
2011,Blackpool 007C,E01012721,1201,550,651,183,58,410
2011,Blackpool 007D,E01012724,930,529,401,141,31,229
2011,Blackpool 008A,E01012678,1077,612,465,101,44,320
2011,Blackpool 008B,E01012679,1002,576,426,98,53,275
2011,Blackpool 008C,E01012680,1134,743,391,112,49,230
2011,Blackpool 008D,E01012682,1060,588,472,148,28,296
2011,Blackpool 008E,E01012684,1033,671,362,127,29,206
2011,Blackpool 009A,E01012676,1017,693,324,146,48,130
2011,Blackpool 009B,E01012677,1012,720,292,132,47,113
2011,Blackpool 009C,E01012708,985,725,260,129,34,97
2011,Blackpool 009D,E01012709,1141,844,297,110,28,159
2011,Blackpool 009E,E01012710,865,602,263,142,40,81
2011,Blackpool 009F,E01012722,1020,716,304,122,89,93
2011,Blackpool 010A,E01012673,1048,557,491,116,85,290
2011,Blackpool 010B,E01012675,1106,681,425,115,50,260
2011,Blackpool 010C,E01012735,996,647,349,141,36,172
2011,Blackpool 010D,E01012736,1203,906,297,119,25,153
2011,Blackpool 010E,E01012737,1171,691,480,135,77,268
2011,Blackpool 011A,E01012670,914,562,352,98,43,211
2011,Blackpool 011B,E01012733,772,497,275,93,41,141
2011,Blackpool 011C,E01012734,1048,745,303,143,41,119
2011,Blackpool 011D,E01012738,928,573,355,124,44,187
2011,Blackpool 011E,E01012739,999,622,377,141,58,178
2011,Blackpool 011F,E01012742,874,602,272,127,42,103
2011,Blackpool 012A,E01012712,1249,934,315,179,50,86
2011,Blackpool 012B,E01012713,1402,1060,342,169,56,117
2011,Blackpool 012C,E01012715,1156,830,326,180,43,103
2011,Blackpool 012D,E01012740,1092,753,339,187,47,105
2011,Blackpool 012E,E01012741,969,684,285,152,26,107
2011,Blackpool 013A,E01012671,1145,712,433,123,49,261
2011,Blackpool 013B,E01012672,1099,742,357,121,32,204
2011,Blackpool 013C,E01012674,1247,821,426,134,47,245
2011,Blackpool 013D,E01012751,1214,802,412,137,36,239
2011,Blackpool 014A,E01012686,1026,586,440,124,59,257
2011,Blackpool 014B,E01012687,1019,630,389,120,37,232
2011,Blackpool 014C,E01012688,884,522,362,229,18,115
2011,Blackpool 014D,E01012689,949,626,323,185,24,114
2011,Blackpool 014E,E01012714,1243,848,395,261,23,111
2011,Blackpool 015A,E01012695,991,668,323,125,43,155
2011,Blackpool 015B,E01012743,1220,766,454,157,67,230
2011,Blackpool 015C,E01012744,1154,756,398,163,38,197
2011,Blackpool 015D,E01012745,1230,806,424,223,43,158
2011,Blackpool 015E,E01012746,1280,797,483,220,65,198
2011,Blackpool 016A,E01012685,1077,786,291,120,31,140
2011,Blackpool 016B,E01012694,967,673,294,171,28,95
2011,Blackpool 016C,E01012696,1101,777,324,129,38,157
2011,Blackpool 016D,E01012697,1025,619,406,256,22,128
2011,Blackpool 016E,E01012698,1076,662,414,143,65,206
2011,Blackpool 017A,E01012726,1217,791,426,265,37,124
2011,Blackpool 017B,E01012728,1088,750,338,181,30,127
2011,Blackpool 017C,E01012752,1013,642,371,179,30,162
2011,Blackpool 017D,E01012753,859,628,231,117,39,75
2011,Blackpool 017E,E01012754,908,592,316,131,34,151
2011,Blackpool 017F,E01012755,1087,787,300,159,33,108
2011,Blackpool 018A,E01012701,1039,738,301,176,31,94
2011,Blackpool 018B,E01012729,1154,732,422,320,17,85
2011,Blackpool 018C,E01012730,1262,915,347,209,41,97
2011,Blackpool 018D,E01012731,1156,809,347,196,30,121
2011,Blackpool 018E,E01012732,1214,772,442,280,31,131
2011,Blackpool 019A,E01012699,1276,870,406,245,36,125
2011,Blackpool 019B,E01012700,1317,956,361,206,56,99
2011,Blackpool 019C,E01012702,1017,545,472,292,24,156
2011,Blackpool 019D,E01012725,1032,728,304,201,34,69
2011,Blackpool 019E,E01012727,1158,830,328,200,44,84
2011,Cheshire East 022A,E01018393,1542,1083,459,312,49,98
2011,Cheshire East 022B,E01018411,1683,1124,559,387,74,98
2011,Cheshire East 022C,E01018412,1092,706,386,261,40,85
2011,Cheshire East 023A,E01018413,926,681,245,165,35,45
2011,Cheshire East 023B,E01018414,1046,653,393,300,32,61
2011,Cheshire East 023C,E01018415,1047,750,297,185,38,74
2011,Cheshire East 023D,E01018416,1000,698,302,220,34,48
2011,Cheshire East 024A,E01018424,1289,972,317,189,41,87
2011,Cheshire East 024B,E01018425,1190,802,388,253,30,105
2011,Cheshire East 024C,E01018426,1214,796,418,281,42,95
2011,Cheshire East 024D,E01018427,994,764,230,136,39,55
2011,Cheshire East 025A,E01018419,1056,849,207,110,43,54
2011,Cheshire East 025B,E01018420,1343,1106,237,108,56,73
2011,Cheshire East 025C,E01018421,997,804,193,89,39,65
2011,Cheshire East 025D,E01018422,941,647,294,182,44,68
2011,Cheshire East 025E,E01018423,1046,692,354,151,24,179
2011,Cheshire East 026A,E01018395,1210,827,383,264,29,90
2011,Cheshire East 026B,E01018396,1061,680,381,217,41,123
2011,Cheshire East 026C,E01018400,1536,1009,527,195,47,285
2011,Cheshire East 026D,E01018401,1126,771,355,160,66,129
2011,Cheshire East 027A,E01018398,1053,712,341,199,41,101
2011,Cheshire East 027B,E01018399,1110,813,297,163,44,90
2011,Cheshire East 027C,E01018402,1487,1073,414,205,39,170
2011,Cheshire East 027D,E01018403,1472,1015,457,327,45,85
2011,Cheshire East 028A,E01018397,1311,1012,299,172,55,72
2011,Cheshire East 028B,E01018408,1338,941,397,296,38,63
2011,Cheshire East 028C,E01018409,1276,822,454,296,39,119
2011,Cheshire East 028D,E01018410,1138,726,412,289,44,79
2011,Cheshire East 029A,E01018404,1064,755,309,210,50,49
2011,Cheshire East 029B,E01018405,1095,826,269,182,24,63
2011,Cheshire East 029C,E01018406,1048,719,329,240,37,52
2011,Cheshire East 029D,E01018407,1083,766,317,219,33,65
2011,Cheshire East 030A,E01018436,1052,713,339,235,53,51
2011,Cheshire East 030B,E01018437,1175,843,332,183,29,120
2011,Cheshire East 030C,E01018438,1077,692,385,298,38,49
2011,Cheshire East 030D,E01018439,944,567,377,292,41,44
2011,Cheshire East 031A,E01018440,1323,1018,305,128,75,102
2011,Cheshire East 031B,E01018441,1222,1008,214,70,70,74
2011,Cheshire East 031C,E01018442,1324,960,364,204,69,91
2011,Cheshire East 031D,E01018443,1149,810,339,225,40,74
2011,Cheshire East 032A,E01018432,1113,773,340,208,38,94
2011,Cheshire East 032B,E01018433,956,580,376,268,33,75
2011,Cheshire East 032C,E01018434,1019,695,324,221,28,75
2011,Cheshire East 032D,E01018435,974,648,326,170,46,110
2011,Cheshire East 033A,E01018394,1559,1112,447,278,60,109
2011,Cheshire East 033B,E01018417,1213,735,478,365,38,75
2011,Cheshire East 033C,E01018418,1150,798,352,229,38,85
2011,Cheshire East 033D,E01018428,1067,728,339,201,42,96
2011,Cheshire East 033E,E01018429,1132,735,397,278,47,72
2011,Cheshire East 033F,E01018430,1081,779,302,192,47,63
2011,Cheshire East 033G,E01018431,930,710,220,157,25,38
2011,Cheshire East 040A,E01018387,1264,728,536,430,62,44
2011,Cheshire East 040B,E01018388,1146,726,420,180,63,177
2011,Cheshire East 040C,E01018389,1112,767,345,220,56,69
2011,Cheshire East 040D,E01018390,1203,786,417,309,33,75
2011,Cheshire East 042A,E01018386,999,628,371,241,60,70
2011,Cheshire East 042B,E01018391,1346,1002,344,201,51,92
2011,Cheshire East 042C,E01018392,1453,1011,442,294,76,72
2011,Cheshire East 034A,E01018472,1091,834,257,144,35,78
2011,Cheshire East 034B,E01018473,1249,1038,211,99,30,82
2011,Cheshire East 034C,E01018474,1396,1178,218,94,61,63
2011,Cheshire East 034D,E01018475,1351,1151,200,66,59,75
2011,Cheshire East 035A,E01018463,1082,782,300,110,45,145
2011,Cheshire East 035B,E01018476,904,528,376,135,50,191
2011,Cheshire East 035C,E01018477,1013,648,365,155,50,160
2011,Cheshire East 035D,E01018478,1026,688,338,114,52,172
2011,Cheshire East 035E,E01018479,1183,877,306,172,29,105
2011,Cheshire East 036A,E01018459,912,588,324,98,45,181
2011,Cheshire East 036B,E01018460,1009,653,356,243,22,91
2011,Cheshire East 036C,E01018461,1015,626,389,219,34,136
2011,Cheshire East 036D,E01018466,1703,1170,533,189,65,279
2011,Cheshire East 036E,E01018467,1686,1267,419,113,86,220
2011,Cheshire East 037A,E01018482,1038,658,380,199,45,136
2011,Cheshire East 037B,E01018483,1040,677,363,229,31,103
2011,Cheshire East 037C,E01018484,1530,1055,475,137,54,284
2011,Cheshire East 037D,E01018485,1090,696,394,119,62,213
2011,Cheshire East 038A,E01018499,1160,850,310,180,40,90
2011,Cheshire East 038B,E01018500,980,670,310,246,26,38
2011,Cheshire East 038C,E01018501,1179,760,419,252,86,81
2011,Cheshire East 038D,E01018502,1765,919,846,260,542,44
2011,Cheshire East 039A,E01018462,1089,748,341,107,62,172
2011,Cheshire East 039B,E01018464,1086,800,286,141,55,90
2011,Cheshire East 039C,E01018496,1225,886,339,151,78,110
2011,Cheshire East 039D,E01018497,909,677,232,89,41,102
2011,Cheshire East 039E,E01018498,1127,796,331,96,59,176
2011,Cheshire East 041A,E01018465,2121,1503,618,406,77,135
2011,Cheshire East 041B,E01018468,1231,900,331,196,61,74
2011,Cheshire East 041C,E01018469,1130,783,347,215,40,92
2011,Cheshire East 041D,E01018470,1128,820,308,174,60,74
2011,Cheshire East 041E,E01018471,1148,825,323,223,40,60
2011,Cheshire East 043A,E01018486,1168,824,344,101,109,134
2011,Cheshire East 043B,E01018487,1225,930,295,83,93,119
2011,Cheshire East 043C,E01018488,1121,832,289,159,60,70
2011,Cheshire East 043D,E01018489,1046,760,286,87,101,98
2011,Cheshire East 044A,E01018510,1218,952,266,147,37,82
2011,Cheshire East 044B,E01018511,1025,716,309,147,49,113
2011,Cheshire East 044C,E01018512,1161,801,360,182,59,119
2011,Cheshire East 044D,E01018513,1174,834,340,225,38,77
2011,Cheshire East 045A,E01018445,1416,978,438,140,68,230
2011,Cheshire East 045B,E01018446,979,700,279,115,49,115
2011,Cheshire East 045C,E01018447,1319,983,336,132,93,111
2011,Cheshire East 045D,E01018448,1255,937,318,174,58,86
2011,Cheshire East 046A,E01018490,1044,662,382,308,27,47
2011,Cheshire East 046B,E01018491,1064,753,311,221,35,55
2011,Cheshire East 046C,E01018492,777,472,305,233,30,42
2011,Cheshire East 046D,E01018505,817,558,259,179,39,41
2011,Cheshire East 046E,E01018506,1108,825,283,185,46,52
2011,Cheshire East 046F,E01018507,1088,701,387,285,42,60
2011,Cheshire East 047A,E01018451,912,599,313,183,26,104
2011,Cheshire East 047B,E01018454,1177,814,363,168,48,147
2011,Cheshire East 047C,E01018455,945,641,304,230,21,53
2011,Cheshire East 047D,E01018456,873,545,328,253,30,45
2011,Cheshire East 047E,E01018457,1074,832,242,150,29,63
2011,Cheshire East 049A,E01018444,1605,1150,455,276,69,110
2011,Cheshire East 049B,E01018480,1710,1182,528,231,176,121
2011,Cheshire East 049C,E01018515,1723,1255,468,276,69,123
2011,Cheshire East 049D,E01018516,1046,731,315,223,35,57
2011,Cheshire East 049F,E01033375,889,750,139,52,43,44
2011,Cheshire East 049G,E01033376,825,711,114,34,24,56
2011,Cheshire East 049H,E01033378,1014,752,262,165,40,57
2011,Cheshire East 048A,E01018493,905,570,335,261,14,60
2011,Cheshire East 048B,E01018494,1002,703,299,212,35,52
2011,Cheshire East 048C,E01018495,964,674,290,194,32,64
2011,Cheshire East 048D,E01018508,877,590,287,194,42,51
2011,Cheshire East 048E,E01018509,801,584,217,143,28,46
2011,Cheshire East 050A,E01018452,782,493,289,156,24,109
2011,Cheshire East 050C,E01018503,1149,701,448,351,39,58
2011,Cheshire East 050D,E01018504,1256,835,421,253,41,127
2011,Cheshire East 050E,E01033372,985,784,201,106,34,61
2011,Cheshire East 050F,E01033373,899,614,285,133,46,106
2011,Cheshire East 051A,E01018449,1250,814,436,328,29,79
2011,Cheshire East 051B,E01018450,1611,1104,507,327,62,118
2011,Cheshire East 051C,E01018458,1565,1113,452,286,67,99
2011,Cheshire East 051D,E01018481,1477,1020,457,282,54,121
2011,Cheshire East 051E,E01018514,1473,1035,438,280,59,99
2011,Cheshire East 001A,E01018585,1041,732,309,191,52,66
2011,Cheshire East 001B,E01018586,1181,891,290,166,43,81
2011,Cheshire East 001C,E01018587,1121,783,338,242,35,61
2011,Cheshire East 001D,E01018661,946,629,317,211,45,61
2011,Cheshire East 002A,E01018657,749,546,203,113,32,58
2011,Cheshire East 002B,E01018662,889,647,242,164,35,43
2011,Cheshire East 002C,E01018663,1018,710,308,227,33,48
2011,Cheshire East 002D,E01018664,1098,749,349,246,52,51
2011,Cheshire East 002E,E01018665,821,595,226,154,33,39
2011,Cheshire East 003A,E01018655,1045,729,316,246,28,42
2011,Cheshire East 003B,E01018656,1026,706,320,244,37,39
2011,Cheshire East 003C,E01018658,979,702,277,177,38,62
2011,Cheshire East 003D,E01018659,932,594,338,262,30,46
2011,Cheshire East 003E,E01018660,749,512,237,172,28,37
2011,Cheshire East 004A,E01018582,1339,1018,321,150,66,105
2011,Cheshire East 004B,E01018592,1181,877,304,173,39,92
2011,Cheshire East 004C,E01018593,1237,853,384,252,38,94
2011,Cheshire East 004D,E01018594,1213,850,363,165,38,160
2011,Cheshire East 004E,E01018595,1129,792,337,206,46,85
2011,Cheshire East 004F,E01018596,1411,1024,387,135,45,207
2011,Cheshire East 005A,E01018583,1380,1091,289,153,53,83
2011,Cheshire East 005B,E01018584,1397,1025,372,206,65,101
2011,Cheshire East 005C,E01018612,871,647,224,113,40,71
2011,Cheshire East 005D,E01018613,1094,799,295,167,33,95
2011,Cheshire East 006A,E01018600,1139,755,384,213,72,99
2011,Cheshire East 006B,E01018601,1187,900,287,164,41,82
2011,Cheshire East 006C,E01018602,1192,879,313,180,52,81
2011,Cheshire East 006D,E01018652,1116,808,308,164,72,72
2011,Cheshire East 007A,E01018598,1201,904,297,182,38,77
2011,Cheshire East 007B,E01018599,859,559,300,229,18,53
2011,Cheshire East 007C,E01018648,1586,1128,458,261,52,145
2011,Cheshire East 007D,E01018649,953,599,354,252,26,76
2011,Cheshire East 007E,E01018650,1226,956,270,161,41,68
2011,Cheshire East 007F,E01018651,1199,693,506,139,46,321
2011,Cheshire East 007G,E01018654,1707,1089,618,298,133,187
2011,Cheshire East 008A,E01018588,1084,810,274,152,59,63
2011,Cheshire East 008B,E01018589,1084,797,287,190,32,65
2011,Cheshire East 008C,E01018590,1289,944,345,221,45,79
2011,Cheshire East 008D,E01018653,1358,933,425,259,78,88
2011,Cheshire East 009A,E01018605,756,493,263,202,17,44
2011,Cheshire East 009B,E01018609,1164,738,426,294,46,86
2011,Cheshire East 009C,E01018610,1414,1052,362,188,40,134
2011,Cheshire East 009D,E01018611,1207,890,317,112,38,167
2011,Cheshire East 011A,E01018666,1256,770,486,303,78,105
2011,Cheshire East 011B,E01018667,1074,701,373,222,54,97
2011,Cheshire East 011C,E01018668,1180,772,408,280,44,84
2011,Cheshire East 010A,E01018603,903,608,295,202,37,56
2011,Cheshire East 010B,E01018604,947,675,272,158,37,77
2011,Cheshire East 010C,E01018606,1001,745,256,152,26,78
2011,Cheshire East 010D,E01018607,901,631,270,173,34,63
2011,Cheshire East 010E,E01018608,970,655,315,180,49,86
2011,Cheshire East 012A,E01018572,1139,789,350,215,51,84
2011,Cheshire East 012B,E01018573,1085,778,307,183,53,71
2011,Cheshire East 012C,E01018574,1411,1048,363,180,60,123
2011,Cheshire East 012D,E01018580,1096,751,345,208,37,100
2011,Cheshire East 012E,E01018581,838,554,284,206,29,49
2011,Cheshire East 013A,E01018575,808,625,183,115,21,47
2011,Cheshire East 013B,E01018576,1345,1084,261,165,41,55
2011,Cheshire East 013C,E01018577,1812,1298,514,338,47,129
2011,Cheshire East 013D,E01018578,895,664,231,153,24,54
2011,Cheshire East 013E,E01018579,778,513,265,134,37,94
2011,Cheshire East 014A,E01018641,946,660,286,197,37,52
2011,Cheshire East 014B,E01018642,1007,739,268,154,49,65
2011,Cheshire East 014C,E01018643,1386,1014,372,215,85,72
2011,Cheshire East 014D,E01018644,999,686,313,208,26,79
2011,Cheshire East 015A,E01018614,1420,1057,363,198,61,104
2011,Cheshire East 015B,E01018618,1036,731,305,132,60,113
2011,Cheshire East 015C,E01018619,1046,791,255,156,47,52
2011,Cheshire East 015D,E01018620,997,694,303,156,45,102
2011,Cheshire East 015E,E01018621,1004,748,256,162,44,50
2011,Cheshire East 016A,E01018626,1651,1243,408,231,44,133
2011,Cheshire East 016B,E01018628,1188,837,351,236,49,66
2011,Cheshire East 016C,E01018629,1296,943,353,152,39,162
2011,Cheshire East 016D,E01018630,952,704,248,169,21,58
2011,Cheshire East 016E,E01018631,1018,699,319,148,31,140
2011,Cheshire East 017A,E01018615,911,725,186,92,29,65
2011,Cheshire East 017B,E01018616,950,688,262,163,37,62
2011,Cheshire East 017C,E01018617,1083,746,337,220,35,82
2011,Cheshire East 017D,E01018632,1190,901,289,190,38,61
2011,Cheshire East 017E,E01018633,1113,740,373,298,36,39
2011,Cheshire East 018A,E01018622,998,782,216,100,27,89
2011,Cheshire East 018B,E01018623,1145,867,278,159,29,90
2011,Cheshire East 018C,E01018624,1522,1245,277,120,35,122
2011,Cheshire East 018D,E01018625,1063,856,207,86,42,79
2011,Cheshire East 018E,E01018627,1275,997,278,137,34,107
2011,Cheshire East 018F,E01018635,932,694,238,124,34,80
2011,Cheshire East 018G,E01018636,1031,780,251,148,41,62
2011,Cheshire East 019A,E01018634,1410,1036,374,267,41,66
2011,Cheshire East 019B,E01018645,1258,812,446,228,45,173
2011,Cheshire East 019C,E01018646,1245,882,363,156,54,153
2011,Cheshire East 019D,E01018647,1148,796,352,183,58,111
2011,Cheshire East 020A,E01018591,1716,1149,567,418,64,85
2011,Cheshire East 020B,E01018597,1775,1197,578,387,79,112
2011,Cheshire East 020C,E01018669,1938,1412,526,354,68,104
2011,Cheshire East 020D,E01018670,1682,1160,522,339,52,131
2011,Cheshire East 021A,E01018637,1245,897,348,113,62,173
2011,Cheshire East 021B,E01018638,1120,744,376,196,42,138
2011,Cheshire East 021C,E01018639,1117,860,257,92,43,122
2011,Cheshire East 021D,E01018640,946,641,305,138,28,139
2011,Cheshire West and Chester 022A,E01018308,1357,946,411,239,53,119
2011,Cheshire West and Chester 022B,E01018336,981,690,291,191,29,71
2011,Cheshire West and Chester 022C,E01018337,1039,740,299,174,22,103
2011,Cheshire West and Chester 022D,E01018338,1346,1006,340,185,43,112
2011,Cheshire West and Chester 022E,E01018358,879,622,257,147,44,66
2011,Cheshire West and Chester 022F,E01018359,802,567,235,161,31,43
2011,Cheshire West and Chester 025A,E01018360,1447,1015,432,249,58,125
2011,Cheshire West and Chester 025B,E01018366,1155,800,355,258,32,65
2011,Cheshire West and Chester 025C,E01018367,1413,1005,408,236,55,117
2011,Cheshire West and Chester 027A,E01018364,1083,726,357,124,39,194
2011,Cheshire West and Chester 027B,E01018365,1327,906,421,293,54,74
2011,Cheshire West and Chester 027C,E01018378,846,586,260,108,37,115
2011,Cheshire West and Chester 027D,E01018379,950,595,355,243,39,73
2011,Cheshire West and Chester 027E,E01018380,822,517,305,190,36,79
2011,Cheshire West and Chester 028A,E01018362,1108,830,278,166,51,61
2011,Cheshire West and Chester 028B,E01018363,735,473,262,180,29,53
2011,Cheshire West and Chester 028C,E01018374,1376,1009,367,197,92,78
2011,Cheshire West and Chester 028D,E01018375,1519,1070,449,148,205,96
2011,Cheshire West and Chester 028E,E01018376,1050,757,293,174,48,71
2011,Cheshire West and Chester 028F,E01018377,1151,842,309,191,32,86
2011,Cheshire West and Chester 029A,E01018309,1224,841,383,167,50,166
2011,Cheshire West and Chester 029B,E01018310,1096,725,371,126,46,199
2011,Cheshire West and Chester 029C,E01018311,989,640,349,119,28,202
2011,Cheshire West and Chester 029D,E01018312,1091,752,339,123,48,168
2011,Cheshire West and Chester 031A,E01018313,1036,700,336,207,38,91
2011,Cheshire West and Chester 031B,E01018314,1177,788,389,158,41,190
2011,Cheshire West and Chester 031C,E01018315,834,570,264,148,30,86
2011,Cheshire West and Chester 031D,E01018316,981,658,323,112,45,166
2011,Cheshire West and Chester 031E,E01018317,1069,666,403,114,37,252
2011,Cheshire West and Chester 030A,E01018349,1183,827,356,245,43,68
2011,Cheshire West and Chester 030B,E01018350,1370,915,455,318,51,86
2011,Cheshire West and Chester 030C,E01018368,973,684,289,177,37,75
2011,Cheshire West and Chester 030D,E01018370,967,634,333,250,34,49
2011,Cheshire West and Chester 032A,E01018345,942,706,236,147,25,64
2011,Cheshire West and Chester 032B,E01018346,964,730,234,168,28,38
2011,Cheshire West and Chester 032C,E01018347,993,698,295,134,33,128
2011,Cheshire West and Chester 032D,E01018383,1073,787,286,172,49,65
2011,Cheshire West and Chester 032E,E01018384,1050,718,332,240,35,57
2011,Cheshire West and Chester 033B,E01018327,1681,1171,510,195,102,213
2011,Cheshire West and Chester 033C,E01018343,1321,977,344,120,77,147
2011,Cheshire West and Chester 033D,E01018361,1158,876,282,123,71,88
2011,Cheshire West and Chester 033E,E01032930,1541,1131,410,199,66,145
2011,Cheshire West and Chester 033F,E01032931,960,770,190,70,50,70
2011,Cheshire West and Chester 034A,E01018326,1669,1191,478,203,143,132
2011,Cheshire West and Chester 034B,E01018328,1684,909,775,52,678,45
2011,Cheshire West and Chester 034C,E01018329,1933,1262,671,93,443,135
2011,Cheshire West and Chester 034D,E01018330,1062,691,371,101,239,31
2011,Cheshire West and Chester 034E,E01018331,1501,1053,448,74,320,54
2011,Cheshire West and Chester 036A,E01018319,1607,1228,379,171,59,149
2011,Cheshire West and Chester 036B,E01018344,1551,1313,238,83,73,82
2011,Cheshire West and Chester 036C,E01018381,866,692,174,107,32,35
2011,Cheshire West and Chester 036D,E01018382,1078,751,327,184,59,84
2011,Cheshire West and Chester 039A,E01018323,955,695,260,148,51,61
2011,Cheshire West and Chester 039B,E01018324,957,647,310,192,70,48
2011,Cheshire West and Chester 039C,E01018325,1094,738,356,269,43,44
2011,Cheshire West and Chester 039D,E01018385,1470,928,542,376,79,87
2011,Cheshire West and Chester 041A,E01018320,991,697,294,183,57,54
2011,Cheshire West and Chester 041B,E01018321,883,656,227,155,28,44
2011,Cheshire West and Chester 041C,E01018322,803,572,231,150,36,45
2011,Cheshire West and Chester 041D,E01018348,1582,1223,359,223,50,86
2011,Cheshire West and Chester 043A,E01018332,742,523,219,120,26,73
2011,Cheshire West and Chester 043B,E01018333,1089,671,418,324,43,51
2011,Cheshire West and Chester 043C,E01018334,1095,671,424,319,39,66
2011,Cheshire West and Chester 043D,E01018340,1017,710,307,186,37,84
2011,Cheshire West and Chester 043E,E01018341,793,511,282,208,19,55
2011,Cheshire West and Chester 043F,E01018342,1209,954,255,158,26,71
2011,Cheshire West and Chester 044A,E01018351,1073,626,447,124,52,271
2011,Cheshire West and Chester 044B,E01018352,1392,1129,263,120,30,113
2011,Cheshire West and Chester 044C,E01018353,1173,837,336,167,61,108
2011,Cheshire West and Chester 044D,E01018354,1146,767,379,134,52,193
2011,Cheshire West and Chester 046A,E01018335,1522,1106,416,244,55,117
2011,Cheshire West and Chester 046B,E01018369,1169,834,335,210,49,76
2011,Cheshire West and Chester 046C,E01018371,1308,911,397,260,44,93
2011,Cheshire West and Chester 046D,E01018372,1408,1038,370,256,29,85
2011,Cheshire West and Chester 047A,E01018339,1426,969,457,307,49,101
2011,Cheshire West and Chester 047B,E01018355,804,558,246,153,21,72
2011,Cheshire West and Chester 047C,E01018356,1120,858,262,147,35,80
2011,Cheshire West and Chester 047D,E01018357,971,674,297,188,39,70
2011,Cheshire West and Chester 047E,E01018373,1503,1054,449,296,64,89
2011,Cheshire West and Chester 001A,E01018534,1842,1230,612,256,122,234
2011,Cheshire West and Chester 001B,E01018535,1088,662,426,237,66,123
2011,Cheshire West and Chester 001C,E01018536,1227,821,406,276,51,79
2011,Cheshire West and Chester 001D,E01018537,1405,829,576,431,59,86
2011,Cheshire West and Chester 004A,E01018518,1161,722,439,317,49,73
2011,Cheshire West and Chester 004B,E01018569,922,590,332,241,39,52
2011,Cheshire West and Chester 004C,E01018570,901,599,302,200,36,66
2011,Cheshire West and Chester 004D,E01018571,973,630,343,241,37,65
2011,Cheshire West and Chester 005A,E01018546,1072,722,350,145,38,167
2011,Cheshire West and Chester 005B,E01018547,1042,713,329,224,26,79
2011,Cheshire West and Chester 005C,E01018548,1186,757,429,231,33,165
2011,Cheshire West and Chester 005D,E01018549,1067,685,382,234,44,104
2011,Cheshire West and Chester 006A,E01018532,1326,885,441,259,72,110
2011,Cheshire West and Chester 006B,E01018533,1097,727,370,281,51,38
2011,Cheshire West and Chester 006C,E01018544,1173,753,420,265,71,84
2011,Cheshire West and Chester 006D,E01018545,1483,997,486,298,95,93
2011,Cheshire West and Chester 007A,E01018519,1080,813,267,101,30,136
2011,Cheshire West and Chester 007B,E01018520,781,598,183,66,23,94
2011,Cheshire West and Chester 007C,E01018525,886,625,261,82,39,140
2011,Cheshire West and Chester 007D,E01018563,1517,1049,468,166,42,260
2011,Cheshire West and Chester 007E,E01018564,1695,1211,484,207,37,240
2011,Cheshire West and Chester 008A,E01018523,921,630,291,109,35,147
2011,Cheshire West and Chester 008B,E01018524,941,585,356,104,57,195
2011,Cheshire West and Chester 008C,E01018541,988,720,268,158,28,82
2011,Cheshire West and Chester 008D,E01018542,842,586,256,64,47,145
2011,Cheshire West and Chester 008E,E01018543,949,652,297,145,25,127
2011,Cheshire West and Chester 009A,E01018528,912,682,230,158,24,48
2011,Cheshire West and Chester 009B,E01018529,1140,770,370,270,23,77
2011,Cheshire West and Chester 009C,E01018530,1118,891,227,136,35,56
2011,Cheshire West and Chester 009D,E01018531,1166,869,297,198,33,66
2011,Cheshire West and Chester 009E,E01018560,918,702,216,157,23,36
2011,Cheshire West and Chester 009F,E01018561,956,725,231,157,36,38
2011,Cheshire West and Chester 009G,E01018562,1068,888,180,92,33,55
2011,Cheshire West and Chester 010A,E01018522,978,656,322,151,44,127
2011,Cheshire West and Chester 010B,E01018538,816,549,267,110,41,116
2011,Cheshire West and Chester 010C,E01018539,788,538,250,103,29,118
2011,Cheshire West and Chester 010D,E01018540,1038,767,271,147,33,91
2011,Cheshire West and Chester 011A,E01018521,873,553,320,129,44,147
2011,Cheshire West and Chester 011B,E01018550,796,542,254,74,27,153
2011,Cheshire West and Chester 011C,E01018551,1140,783,357,136,28,193
2011,Cheshire West and Chester 011D,E01018552,1118,776,342,153,38,151
2011,Cheshire West and Chester 011E,E01018553,1063,670,393,213,44,136
2011,Cheshire West and Chester 013A,E01018556,1047,689,358,261,25,72
2011,Cheshire West and Chester 013B,E01018557,1038,690,348,188,39,121
2011,Cheshire West and Chester 013C,E01018558,1017,819,198,99,29,70
2011,Cheshire West and Chester 013D,E01018559,910,649,261,191,26,44
2011,Cheshire West and Chester 014A,E01018565,1095,791,304,200,26,78
2011,Cheshire West and Chester 014B,E01018566,993,633,360,278,23,59
2011,Cheshire West and Chester 014C,E01018567,1086,785,301,205,33,63
2011,Cheshire West and Chester 014D,E01018568,1150,973,177,93,25,59
2011,Cheshire West and Chester 016A,E01018526,1206,868,338,220,43,75
2011,Cheshire West and Chester 016B,E01018527,1280,969,311,202,36,73
2011,Cheshire West and Chester 016C,E01018554,1791,1314,477,344,62,71
2011,Cheshire West and Chester 016D,E01018555,926,721,205,146,10,49
2011,Cheshire West and Chester 002A,E01018685,843,531,312,142,39,131
2011,Cheshire West and Chester 002B,E01018686,1047,796,251,131,32,88
2011,Cheshire West and Chester 002C,E01018687,979,627,352,276,29,47
2011,Cheshire West and Chester 002D,E01018688,1175,774,401,299,35,67
2011,Cheshire West and Chester 002E,E01018689,981,638,343,211,31,101
2011,Cheshire West and Chester 002F,E01018690,1514,1066,448,343,39,66
2011,Cheshire West and Chester 003A,E01018675,1587,1096,491,357,59,75
2011,Cheshire West and Chester 003B,E01018708,1602,1087,515,341,57,117
2011,Cheshire West and Chester 003C,E01018721,1700,1212,488,296,60,132
2011,Cheshire West and Chester 012A,E01018671,961,677,284,206,31,47
2011,Cheshire West and Chester 012B,E01018672,1122,792,330,150,44,136
2011,Cheshire West and Chester 012C,E01018673,906,636,270,180,21,69
2011,Cheshire West and Chester 012D,E01018674,1153,869,284,130,53,101
2011,Cheshire West and Chester 015A,E01018684,1659,1174,485,326,66,93
2011,Cheshire West and Chester 015B,E01018695,1268,959,309,212,34,63
2011,Cheshire West and Chester 015C,E01018696,1068,719,349,241,48,60
2011,Cheshire West and Chester 015D,E01018697,1250,903,347,204,57,86
2011,Cheshire West and Chester 015E,E01018698,1460,995,465,337,62,66
2011,Cheshire West and Chester 017A,E01018704,867,585,282,192,27,63
2011,Cheshire West and Chester 017B,E01018705,1154,874,280,171,48,61
2011,Cheshire West and Chester 017C,E01018706,971,725,246,133,29,84
2011,Cheshire West and Chester 017D,E01018718,1275,964,311,194,29,88
2011,Cheshire West and Chester 017E,E01018722,1658,1148,510,344,56,110
2011,Cheshire West and Chester 018A,E01018713,1995,1568,427,218,60,149
2011,Cheshire West and Chester 018B,E01018714,1303,925,378,138,37,203
2011,Cheshire West and Chester 018C,E01018715,1315,986,329,133,35,161
2011,Cheshire West and Chester 019A,E01018726,1054,709,345,185,35,125
2011,Cheshire West and Chester 019B,E01018727,1259,827,432,327,34,71
2011,Cheshire West and Chester 019C,E01018728,1123,818,305,165,46,94
2011,Cheshire West and Chester 019D,E01018729,1162,775,387,191,45,151
2011,Cheshire West and Chester 020A,E01018709,1136,881,255,107,31,117
2011,Cheshire West and Chester 020B,E01018710,1085,752,333,113,47,173
2011,Cheshire West and Chester 020C,E01018711,1207,909,298,174,39,85
2011,Cheshire West and Chester 020D,E01018712,1220,877,343,158,35,150
2011,Cheshire West and Chester 021A,E01018699,1176,874,302,174,31,97
2011,Cheshire West and Chester 021B,E01018701,1039,683,356,161,40,155
2011,Cheshire West and Chester 021C,E01018716,1139,709,430,173,53,204
2011,Cheshire West and Chester 021D,E01018717,1314,1010,304,133,30,141
2011,Cheshire West and Chester 021E,E01018719,1130,830,300,148,38,114
2011,Cheshire West and Chester 021F,E01018720,1113,767,346,158,52,136
2011,Cheshire West and Chester 023A,E01018691,1080,736,344,202,49,93
2011,Cheshire West and Chester 023B,E01018693,1175,844,331,216,50,65
2011,Cheshire West and Chester 023C,E01018694,1122,777,345,236,50,59
2011,Cheshire West and Chester 023D,E01018700,1445,1191,254,114,59,81
2011,Cheshire West and Chester 023E,E01018702,922,733,189,96,36,57
2011,Cheshire West and Chester 023F,E01018703,1422,1119,303,188,33,82
2011,Cheshire West and Chester 024A,E01018676,1049,681,368,277,43,48
2011,Cheshire West and Chester 024B,E01018677,1110,709,401,319,27,55
2011,Cheshire West and Chester 024C,E01018678,889,573,316,220,43,53
2011,Cheshire West and Chester 024D,E01018679,1222,868,354,200,44,110
2011,Cheshire West and Chester 024E,E01018692,1462,1016,446,286,59,101
2011,Cheshire West and Chester 026A,E01018680,1239,906,333,211,47,75
2011,Cheshire West and Chester 026B,E01018681,1073,757,316,208,20,88
2011,Cheshire West and Chester 026C,E01018682,754,529,225,134,20,71
2011,Cheshire West and Chester 026D,E01018683,1049,769,280,210,19,51
2011,Cheshire West and Chester 035A,E01018733,1085,729,356,233,24,99
2011,Cheshire West and Chester 035B,E01018734,933,627,306,165,26,115
2011,Cheshire West and Chester 035C,E01018748,916,567,349,102,48,199
2011,Cheshire West and Chester 035D,E01018749,1816,1486,330,102,60,168
2011,Cheshire West and Chester 037A,E01018736,1234,925,309,151,46,112
2011,Cheshire West and Chester 037B,E01018737,1029,789,240,135,44,61
2011,Cheshire West and Chester 037C,E01018743,1142,817,325,196,37,92
2011,Cheshire West and Chester 037D,E01018744,1248,858,390,189,61,140
2011,Cheshire West and Chester 038A,E01018732,1019,719,300,134,34,132
2011,Cheshire West and Chester 038B,E01018745,1128,723,405,152,48,205
2011,Cheshire West and Chester 038C,E01018746,1246,867,379,183,48,148
2011,Cheshire West and Chester 038D,E01018747,1147,836,311,151,35,125
2011,Cheshire West and Chester 040A,E01018730,1052,673,379,192,44,143
2011,Cheshire West and Chester 040B,E01018738,894,495,399,105,57,237
2011,Cheshire West and Chester 040C,E01018739,1012,675,337,113,35,189
2011,Cheshire West and Chester 040D,E01018741,961,648,313,195,28,90
2011,Cheshire West and Chester 042A,E01018731,1163,852,311,149,35,127
2011,Cheshire West and Chester 042B,E01018735,1015,792,223,126,29,68
2011,Cheshire West and Chester 042C,E01018740,1090,684,406,133,70,203
2011,Cheshire West and Chester 042D,E01018742,1200,864,336,188,38,110
2011,Cheshire West and Chester 045A,E01018707,1312,855,457,301,46,110
2011,Cheshire West and Chester 045B,E01018723,768,541,227,151,27,49
2011,Cheshire West and Chester 045C,E01018724,1103,760,343,238,36,69
2011,Cheshire West and Chester 045D,E01018725,962,675,287,200,30,57
2011,Halton 001A,E01012392,1754,1426,328,168,75,85
2011,Halton 001B,E01012393,1499,1086,413,300,39,74
2011,Halton 001C,E01012395,1092,723,369,276,42,51
2011,Halton 001D,E01012411,995,652,343,214,33,96
2011,Halton 002A,E01012374,2004,1598,406,238,63,105
2011,Halton 002B,E01012375,1212,900,312,184,67,61
2011,Halton 002C,E01012376,1916,1618,298,110,81,107
2011,Halton 002D,E01012421,1077,793,284,173,46,65
2011,Halton 002E,E01012423,1105,802,303,188,42,73
2011,Halton 003A,E01012368,1348,921,427,223,56,148
2011,Halton 003B,E01012410,1014,771,243,140,36,67
2011,Halton 003C,E01012412,1086,720,366,128,48,190
2011,Halton 003D,E01012413,1031,659,372,154,52,166
2011,Halton 003E,E01012414,966,684,282,180,28,74
2011,Halton 004A,E01012377,1360,897,463,198,57,208
2011,Halton 004B,E01012390,1084,704,380,176,35,169
2011,Halton 004C,E01012419,845,551,294,97,36,161
2011,Halton 004D,E01012420,1070,630,440,188,47,205
2011,Halton 004E,E01012422,1013,640,373,130,51,192
2011,Halton 005A,E01012369,1115,752,363,144,45,174
2011,Halton 005B,E01012394,1058,701,357,191,41,125
2011,Halton 005C,E01012425,1198,760,438,193,63,182
2011,Halton 005D,E01012426,1009,741,268,172,33,63
2011,Halton 005E,E01012427,1296,949,347,120,73,154
2011,Halton 006A,E01012378,1156,761,395,249,47,99
2011,Halton 006B,E01012379,1146,817,329,132,48,149
2011,Halton 006C,E01012380,951,643,308,110,46,152
2011,Halton 006D,E01012388,1267,858,409,122,62,225
2011,Halton 006E,E01012442,1094,681,413,122,73,218
2011,Halton 007A,E01012367,1154,735,419,159,47,213
2011,Halton 007B,E01012370,1323,969,354,141,38,175
2011,Halton 007C,E01012424,1334,789,545,154,87,304
2011,Halton 007D,E01012441,1698,1082,616,196,71,349
2011,Halton 008A,E01012389,1365,866,499,367,42,90
2011,Halton 008B,E01012391,1611,1123,488,218,40,230
2011,Halton 008C,E01012401,1410,935,475,314,55,106
2011,Halton 008D,E01012443,1218,893,325,120,57,148
2011,Halton 009A,E01012385,1096,853,243,130,38,75
2011,Halton 009B,E01012386,1428,1232,196,78,51,67
2011,Halton 009C,E01012387,814,560,254,186,25,43
2011,Halton 009D,E01012434,1196,897,299,157,40,102
2011,Halton 009E,E01012435,1608,1224,384,181,74,129
2011,Halton 010A,E01012381,996,566,430,102,48,280
2011,Halton 010B,E01012382,1087,588,499,170,47,282
2011,Halton 010C,E01012384,1208,734,474,236,39,199
2011,Halton 010D,E01012444,795,422,373,95,66,212
2011,Halton 010E,E01012445,950,535,415,124,48,243
2011,Halton 011A,E01012398,876,621,255,146,30,79
2011,Halton 011B,E01012400,888,686,202,107,25,70
2011,Halton 011C,E01012402,1125,708,417,152,57,208
2011,Halton 011D,E01012404,1020,723,297,164,31,102
2011,Halton 011E,E01012405,1482,1054,428,211,61,156
2011,Halton 012A,E01012416,1281,880,401,254,40,107
2011,Halton 012B,E01012417,956,700,256,101,44,111
2011,Halton 012C,E01012428,1662,1277,385,176,58,151
2011,Halton 012D,E01012429,981,659,322,167,45,110
2011,Halton 012E,E01012430,1323,882,441,133,64,244
2011,Halton 012F,E01012431,1615,1249,366,132,50,184
2011,Halton 013A,E01012383,1265,795,470,211,47,212
2011,Halton 013B,E01012396,1076,657,419,172,61,186
2011,Halton 013C,E01012397,1062,615,447,135,50,262
2011,Halton 013D,E01012399,995,651,344,163,40,141
2011,Halton 013E,E01012403,1129,664,465,152,61,252
2011,Halton 013F,E01012408,1354,789,565,134,95,336
2011,Halton 014A,E01012432,1094,798,296,123,39,134
2011,Halton 014B,E01012433,1148,725,423,152,43,228
2011,Halton 014C,E01012436,873,535,338,81,66,191
2011,Halton 014D,E01012438,825,461,364,124,50,190
2011,Halton 014E,E01012440,1080,812,268,131,31,106
2011,Halton 015A,E01012406,1186,726,460,192,63,205
2011,Halton 015B,E01012407,1197,757,440,146,55,239
2011,Halton 015C,E01012409,1037,656,381,188,40,153
2011,Halton 015D,E01012437,956,650,306,105,46,155
2011,Halton 015E,E01012439,1105,708,397,153,46,198
2011,Halton 016A,E01012371,996,758,238,136,27,75
2011,Halton 016B,E01012372,934,664,270,186,24,60
2011,Halton 016C,E01012373,1040,697,343,269,20,54
2011,Halton 016D,E01012415,1069,776,293,194,35,64
2011,Halton 016E,E01012418,1026,637,389,294,36,59
2011,Warrington 001A,E01012471,1937,952,985,201,59,725
2011,Warrington 001B,E01012472,1306,905,401,269,59,73
2011,Warrington 001C,E01012476,1198,849,349,225,45,79
2011,Warrington 001D,E01012477,1110,774,336,205,54,77
2011,Warrington 002A,E01012473,1022,661,361,259,33,69
2011,Warrington 002B,E01012474,1003,665,338,179,53,106
2011,Warrington 002C,E01012475,1090,783,307,180,51,76
2011,Warrington 002D,E01012554,1514,1102,412,273,40,99
2011,Warrington 003A,E01012467,964,582,382,298,27,57
2011,Warrington 003B,E01012468,1717,1266,451,216,43,192
2011,Warrington 003C,E01012469,1172,814,358,200,36,122
2011,Warrington 003D,E01012470,824,556,268,164,20,84
2011,Warrington 004A,E01012460,1077,772,305,114,44,147
2011,Warrington 004B,E01012462,972,796,176,103,24,49
2011,Warrington 004C,E01012463,896,566,330,250,34,46
2011,Warrington 004D,E01012464,1081,742,339,167,55,117
2011,Warrington 005A,E01012459,1042,738,304,107,40,157
2011,Warrington 005B,E01012461,1025,792,233,127,39,67
2011,Warrington 005C,E01012465,1024,785,239,123,32,84
2011,Warrington 005D,E01012466,1108,772,336,99,46,191
2011,Warrington 006A,E01012526,1146,766,380,83,60,237
2011,Warrington 006B,E01012534,1079,739,340,95,56,189
2011,Warrington 006C,E01012535,1151,840,311,102,44,165
2011,Warrington 006D,E01012537,1030,705,325,114,49,162
2011,Warrington 006E,E01012539,1108,796,312,154,30,128
2011,Warrington 007A,E01012538,1170,931,239,159,30,50
2011,Warrington 007B,E01012540,1018,751,267,173,29,65
2011,Warrington 007C,E01012541,1006,748,258,113,55,90
2011,Warrington 007D,E01012542,1050,729,321,202,41,78
2011,Warrington 007E,E01012543,1370,873,497,232,204,61
2011,Warrington 007F,E01012544,1094,743,351,232,22,97
2011,Warrington 008A,E01012521,1167,800,367,213,35,119
2011,Warrington 008B,E01012522,1016,692,324,163,29,132
2011,Warrington 008C,E01012533,950,591,359,113,41,205
2011,Warrington 008D,E01012536,1003,742,261,102,37,122
2011,Warrington 008E,E01012545,1143,724,419,148,55,216
2011,Warrington 008F,E01012546,1096,746,350,91,58,201
2011,Warrington 009A,E01012561,1191,951,240,128,33,79
2011,Warrington 009B,E01012562,1313,1078,235,101,62,72
2011,Warrington 009C,E01012567,1404,1177,227,102,66,59
2011,Warrington 009D,E01012568,1844,1600,244,102,55,87
2011,Warrington 010A,E01012563,1331,1028,303,177,53,73
2011,Warrington 010B,E01012564,1068,822,246,119,39,88
2011,Warrington 010C,E01012565,1778,1379,399,163,63,173
2011,Warrington 010D,E01012566,1520,1241,279,106,70,103
2011,Warrington 010E,E01012569,1443,1155,288,133,58,97
2011,Warrington 010F,E01012570,924,602,322,171,27,124
2011,Warrington 011A,E01012481,1176,909,267,102,52,113
2011,Warrington 011B,E01012482,1107,757,350,195,28,127
2011,Warrington 011C,E01012520,1080,686,394,124,38,232
2011,Warrington 011D,E01012523,1071,807,264,124,32,108
2011,Warrington 011E,E01012524,1153,838,315,201,36,78
2011,Warrington 011F,E01012525,1095,802,293,132,42,119
2011,Warrington 012A,E01012478,1031,782,249,131,30,88
2011,Warrington 012B,E01012547,1264,927,337,204,46,87
2011,Warrington 012C,E01012548,1358,1033,325,195,51,79
2011,Warrington 012D,E01012549,1007,647,360,273,22,65
2011,Warrington 012E,E01012550,1154,811,343,242,32,69
2011,Warrington 013A,E01012453,1175,730,445,104,66,275
2011,Warrington 013B,E01012454,1503,1135,368,138,54,176
2011,Warrington 013C,E01012455,1347,880,467,109,59,299
2011,Warrington 013D,E01012457,1258,964,294,117,36,141
2011,Warrington 014A,E01012551,1202,907,295,174,50,71
2011,Warrington 014B,E01012552,1009,712,297,192,31,74
2011,Warrington 014C,E01012553,1083,842,241,151,42,48
2011,Warrington 014D,E01012555,1024,752,272,181,31,60
2011,Warrington 014E,E01012556,1159,795,364,259,23,82
2011,Warrington 015A,E01012491,1048,676,372,253,37,82
2011,Warrington 015B,E01012492,1062,713,349,273,28,48
2011,Warrington 015C,E01012493,1301,959,342,230,38,74
2011,Warrington 015D,E01012494,1270,1019,251,160,37,54
2011,Warrington 015E,E01012500,1074,747,327,257,17,53
2011,Warrington 016A,E01012495,1294,1078,216,124,42,50
2011,Warrington 016B,E01012496,1046,752,294,197,37,60
2011,Warrington 016C,E01012497,952,659,293,154,32,107
2011,Warrington 016D,E01012498,1095,774,321,154,48,119
2011,Warrington 016E,E01012499,1427,1148,279,164,35,80
2011,Warrington 016F,E01012501,1092,811,281,168,35,78
2011,Warrington 017A,E01012479,1222,866,356,142,29,185
2011,Warrington 017B,E01012480,1504,1139,365,135,30,200
2011,Warrington 017D,E01012510,1379,1002,377,135,61,181
2011,Warrington 017E,E01012511,1322,1011,311,153,42,116
2011,Warrington 017F,E01033299,1569,1299,270,53,48,169
2011,Warrington 017G,E01033303,926,703,223,84,32,107
2011,Warrington 018B,E01012458,1745,1348,397,135,51,211
2011,Warrington 018C,E01012483,1206,810,396,169,41,186
2011,Warrington 018D,E01012509,1356,945,411,283,28,100
2011,Warrington 018E,E01012512,1183,799,384,287,26,71
2011,Warrington 018F,E01033300,929,727,202,57,16,129
2011,Warrington 018G,E01033302,1220,910,310,118,39,153
2011,Warrington 019A,E01012527,1131,813,318,211,29,78
2011,Warrington 019B,E01012528,942,606,336,259,28,49
2011,Warrington 019C,E01012529,1089,727,362,270,28,64
2011,Warrington 019D,E01012530,1055,764,291,200,36,55
2011,Warrington 019E,E01012531,1060,688,372,278,28,66
2011,Warrington 019F,E01012532,973,629,344,253,35,56
2011,Warrington 020A,E01012504,1308,981,327,130,48,149
2011,Warrington 020B,E01012505,1048,744,304,131,50,123
2011,Warrington 020C,E01012506,1124,818,306,117,38,151
2011,Warrington 020D,E01012507,1408,1085,323,162,35,126
2011,Warrington 020E,E01012508,1127,742,385,142,32,211
2011,Warrington 021A,E01012513,1386,997,389,237,66,86
2011,Warrington 021B,E01012514,1330,962,368,188,64,116
2011,Warrington 021C,E01012515,1080,745,335,223,30,82
2011,Warrington 021D,E01012516,968,652,316,221,35,60
2011,Warrington 021E,E01012517,1611,1222,389,249,63,77
2011,Warrington 021F,E01012518,1443,1080,363,226,59,78
2011,Warrington 021G,E01012519,1061,745,316,207,46,63
2011,Warrington 022A,E01012485,1146,840,306,196,37,73
2011,Warrington 022B,E01012486,1068,797,271,177,30,64
2011,Warrington 022C,E01012487,1104,848,256,165,32,59
2011,Warrington 022D,E01012489,1240,912,328,218,45,65
2011,Warrington 022E,E01012490,1026,725,301,237,29,35
2011,Warrington 023A,E01012450,941,660,281,189,38,54
2011,Warrington 023B,E01012451,1066,738,328,165,60,103
2011,Warrington 023C,E01012557,1194,944,250,155,28,67
2011,Warrington 023D,E01012558,1278,1008,270,162,48,60
2011,Warrington 023E,E01012559,1081,791,290,198,34,58
2011,Warrington 023F,E01012560,1033,702,331,204,43,84
2011,Warrington 024A,E01012448,1293,743,550,172,46,332
2011,Warrington 024B,E01012488,1231,843,388,279,48,61
2011,Warrington 024C,E01012502,1157,867,290,182,49,59
2011,Warrington 024D,E01012503,1085,853,232,126,50,56
2011,Warrington 025A,E01012446,1089,785,304,181,52,71
2011,Warrington 025B,E01012447,1070,811,259,131,71,57
2011,Warrington 025C,E01012449,1013,647,366,277,37,52
2011,Warrington 025D,E01012452,1229,819,410,288,49,73
2011,Allerdale 001A,E01019126,1197,766,431,241,44,146
2011,Allerdale 001B,E01019127,1128,697,431,333,23,75
2011,Allerdale 001C,E01019132,1387,1016,371,248,45,78
2011,Allerdale 001D,E01019134,1110,738,372,265,39,68
2011,Allerdale 001E,E01019135,1160,782,378,191,43,144
2011,Allerdale 001F,E01019136,1176,846,330,183,49,98
2011,Allerdale 001G,E01019137,753,532,221,121,24,76
2011,Allerdale 002A,E01019083,1393,1013,380,284,31,65
2011,Allerdale 002B,E01019107,1195,839,356,230,32,94
2011,Allerdale 002C,E01019130,1247,913,334,230,31,73
2011,Allerdale 002D,E01019131,1420,1061,359,251,50,58
2011,Allerdale 003A,E01019081,1366,916,450,229,37,184
2011,Allerdale 003B,E01019082,1123,797,326,209,32,85
2011,Allerdale 003C,E01019102,1294,901,393,231,47,115
2011,Allerdale 003D,E01019128,1231,881,350,223,36,91
2011,Allerdale 003E,E01019133,1163,844,319,207,42,70
2011,Allerdale 004A,E01019093,1179,840,339,204,30,105
2011,Allerdale 004B,E01019094,1239,827,412,267,43,102
2011,Allerdale 004C,E01019096,1721,1142,579,407,46,126
2011,Allerdale 004D,E01019114,1097,787,310,198,41,71
2011,Allerdale 004E,E01019115,1210,817,393,223,34,136
2011,Allerdale 005A,E01019095,1120,699,421,178,49,194
2011,Allerdale 005B,E01019097,1233,703,530,206,50,274
2011,Allerdale 005C,E01019098,1224,808,416,251,38,127
2011,Allerdale 005D,E01019099,1278,837,441,235,33,173
2011,Allerdale 006A,E01019084,1095,789,306,172,27,107
2011,Allerdale 006B,E01019085,1176,855,321,211,39,71
2011,Allerdale 006C,E01019086,831,559,272,203,31,38
2011,Allerdale 006D,E01019088,1218,875,343,218,31,94
2011,Allerdale 006E,E01019091,1380,963,417,269,61,87
2011,Allerdale 007A,E01019078,1106,773,333,248,34,51
2011,Allerdale 007B,E01019079,1057,745,312,212,28,72
2011,Allerdale 007C,E01019080,1335,958,377,201,44,132
2011,Allerdale 007D,E01019087,1176,802,374,260,36,78
2011,Allerdale 007E,E01019090,1187,829,358,261,32,65
2011,Allerdale 008A,E01019116,946,678,268,148,28,92
2011,Allerdale 008B,E01019118,1040,809,231,129,26,76
2011,Allerdale 008C,E01019122,1015,642,373,173,28,172
2011,Allerdale 008D,E01019123,1158,745,413,279,28,106
2011,Allerdale 008E,E01019124,1564,1162,402,274,49,79
2011,Allerdale 008F,E01019125,1143,804,339,245,25,69
2011,Allerdale 009A,E01019111,1118,726,392,175,31,186
2011,Allerdale 009B,E01019112,1222,743,479,186,45,248
2011,Allerdale 009C,E01019113,1192,745,447,170,40,237
2011,Allerdale 009D,E01019120,1370,1044,326,186,28,112
2011,Allerdale 009E,E01019121,1509,1004,505,218,41,246
2011,Allerdale 010A,E01019108,1067,718,349,157,33,159
2011,Allerdale 010B,E01019109,1304,853,451,222,42,187
2011,Allerdale 010C,E01019110,1224,748,476,228,56,192
2011,Allerdale 010D,E01019117,1005,755,250,170,21,59
2011,Allerdale 010E,E01019119,1088,713,375,297,25,53
2011,Allerdale 011A,E01019089,1211,833,378,231,27,120
2011,Allerdale 011B,E01019100,1227,879,348,231,34,83
2011,Allerdale 011C,E01019101,1108,721,387,295,21,71
2011,Allerdale 011D,E01019129,1287,879,408,311,29,68
2011,Allerdale 012A,E01019092,1211,863,348,261,39,48
2011,Allerdale 012B,E01019103,893,687,206,135,17,54
2011,Allerdale 012C,E01019104,932,609,323,215,35,73
2011,Allerdale 012D,E01019105,894,722,172,102,24,46
2011,Allerdale 012E,E01019106,1045,672,373,284,24,65
2011,Barrow-in-Furness 001A,E01019144,1071,706,365,233,38,94
2011,Barrow-in-Furness 001B,E01019145,1487,1092,395,245,40,110
2011,Barrow-in-Furness 001C,E01019146,1018,719,299,211,20,68
2011,Barrow-in-Furness 001D,E01019147,1153,860,293,158,34,101
2011,Barrow-in-Furness 002A,E01019148,1097,764,333,245,31,57
2011,Barrow-in-Furness 002B,E01019149,1148,847,301,181,33,87
2011,Barrow-in-Furness 002C,E01019150,1153,804,349,199,37,113
2011,Barrow-in-Furness 002D,E01019151,1029,637,392,252,36,104
2011,Barrow-in-Furness 003A,E01019152,885,566,319,185,23,111
2011,Barrow-in-Furness 003B,E01019153,780,548,232,174,20,38
2011,Barrow-in-Furness 003C,E01019154,866,509,357,284,20,53
2011,Barrow-in-Furness 003D,E01019155,924,509,415,352,17,46
2011,Barrow-in-Furness 003E,E01019162,1078,750,328,219,35,74
2011,Barrow-in-Furness 003F,E01019163,953,657,296,209,31,56
2011,Barrow-in-Furness 004A,E01019156,1048,586,462,182,40,240
2011,Barrow-in-Furness 004B,E01019159,802,553,249,113,21,115
2011,Barrow-in-Furness 004C,E01019164,1024,580,444,106,58,280
2011,Barrow-in-Furness 004D,E01019165,1090,717,373,163,32,178
2011,Barrow-in-Furness 004E,E01019166,1039,691,348,168,26,154
2011,Barrow-in-Furness 005A,E01019167,1150,866,284,176,29,79
2011,Barrow-in-Furness 005B,E01019168,1044,747,297,189,37,71
2011,Barrow-in-Furness 005C,E01019169,950,704,246,142,37,67
2011,Barrow-in-Furness 005D,E01019170,951,720,231,116,30,85
2011,Barrow-in-Furness 005E,E01019171,1002,737,265,111,29,125
2011,Barrow-in-Furness 006A,E01019161,1231,860,371,177,43,151
2011,Barrow-in-Furness 006B,E01019176,1276,846,430,308,33,89
2011,Barrow-in-Furness 006C,E01019177,1017,676,341,155,35,151
2011,Barrow-in-Furness 006D,E01019178,1164,847,317,219,24,74
2011,Barrow-in-Furness 006E,E01019179,960,672,288,223,23,42
2011,Barrow-in-Furness 007A,E01019140,760,425,335,100,34,201
2011,Barrow-in-Furness 007B,E01019160,1000,589,411,151,41,219
2011,Barrow-in-Furness 007C,E01019172,1061,720,341,141,27,173
2011,Barrow-in-Furness 007D,E01019173,935,626,309,150,25,134
2011,Barrow-in-Furness 007E,E01019174,857,542,315,95,47,173
2011,Barrow-in-Furness 007F,E01019175,1044,666,378,175,40,163
2011,Barrow-in-Furness 008A,E01019141,909,532,377,121,29,227
2011,Barrow-in-Furness 008B,E01019142,1041,675,366,120,31,215
2011,Barrow-in-Furness 008C,E01019143,1159,653,506,158,72,276
2011,Barrow-in-Furness 008D,E01019157,1075,724,351,121,31,199
2011,Barrow-in-Furness 008E,E01019158,880,558,322,107,35,180
2011,Barrow-in-Furness 009A,E01019180,1408,777,631,478,25,128
2011,Barrow-in-Furness 009C,E01019182,1021,701,320,204,35,81
2011,Barrow-in-Furness 009E,E01019184,1004,690,314,173,34,107
2011,Barrow-in-Furness 009F,E01033160,1484,925,559,228,57,274
2011,Barrow-in-Furness 010A,E01019138,976,629,347,207,28,112
2011,Barrow-in-Furness 010B,E01019139,1107,675,432,129,21,282
2011,Barrow-in-Furness 010C,E01019185,1056,726,330,244,29,57
2011,Barrow-in-Furness 010D,E01019186,965,654,311,184,21,106
2011,Barrow-in-Furness 010E,E01019187,971,640,331,187,39,105
2011,Carlisle 001A,E01019226,905,666,239,153,30,56
2011,Carlisle 001B,E01019227,1057,704,353,196,13,144
2011,Carlisle 001C,E01019228,1193,902,291,178,26,87
2011,Carlisle 001D,E01019229,1462,1068,394,229,48,117
2011,Carlisle 002A,E01019200,1121,760,361,234,35,92
2011,Carlisle 002B,E01019201,959,659,300,182,33,85
2011,Carlisle 002C,E01019202,1151,844,307,178,28,101
2011,Carlisle 002D,E01019225,1518,1120,398,254,45,99
2011,Carlisle 003A,E01019188,1071,771,300,160,35,105
2011,Carlisle 003B,E01019189,1131,851,280,114,45,121
2011,Carlisle 003C,E01019190,1135,767,368,289,27,52
2011,Carlisle 003D,E01019191,1144,815,329,240,28,61
2011,Carlisle 003E,E01019244,1037,780,257,180,33,44
2011,Carlisle 004A,E01019196,1332,1019,313,172,30,111
2011,Carlisle 004B,E01019238,957,699,258,192,26,40
2011,Carlisle 004C,E01019240,1264,967,297,196,36,65
2011,Carlisle 004D,E01019241,1139,803,336,240,31,65
2011,Carlisle 004E,E01019243,1117,792,325,190,82,53
2011,Carlisle 004F,E01019251,1248,914,334,235,39,60
2011,Carlisle 005A,E01019192,1078,757,321,235,24,62
2011,Carlisle 005B,E01019195,1029,781,248,166,24,58
2011,Carlisle 005C,E01019203,1607,1198,409,266,42,101
2011,Carlisle 005D,E01019254,1043,734,309,205,24,80
2011,Carlisle 005E,E01019255,1080,812,268,184,26,58
2011,Carlisle 006A,E01019204,1094,787,307,71,138,98
2011,Carlisle 006B,E01019206,1249,948,301,108,85,108
2011,Carlisle 006C,E01019234,1256,823,433,150,113,170
2011,Carlisle 006D,E01019235,1143,882,261,148,52,61
2011,Carlisle 006E,E01019237,1171,835,336,134,125,77
2011,Carlisle 006F,E01019242,965,684,281,134,98,49
2011,Carlisle 007A,E01019219,1620,1215,405,281,37,87
2011,Carlisle 007B,E01019224,1543,1066,477,341,54,82
2011,Carlisle 007C,E01019239,1166,897,269,174,31,64
2011,Carlisle 007D,E01019249,1065,737,328,248,35,45
2011,Carlisle 007E,E01019250,1036,769,267,185,26,56
2011,Carlisle 008A,E01019205,1253,899,354,147,57,150
2011,Carlisle 008B,E01019207,1054,753,301,127,27,147
2011,Carlisle 008C,E01019215,1131,831,300,126,49,125
2011,Carlisle 008D,E01019218,1109,804,305,135,41,129
2011,Carlisle 008E,E01019233,911,614,297,209,18,70
2011,Carlisle 009A,E01019193,1050,696,354,112,27,215
2011,Carlisle 009B,E01019194,1529,1140,389,173,33,183
2011,Carlisle 009C,E01019230,1078,724,354,197,25,132
2011,Carlisle 009D,E01019231,1041,646,395,208,20,167
2011,Carlisle 009E,E01019232,1117,782,335,200,25,110
2011,Carlisle 009F,E01019252,1055,686,369,251,14,104
2011,Carlisle 010A,E01019209,1065,822,243,118,27,98
2011,Carlisle 010B,E01019211,1424,1190,234,97,45,92
2011,Carlisle 010C,E01019216,1287,950,337,170,58,109
2011,Carlisle 010D,E01019217,1391,1097,294,121,36,137
2011,Carlisle 010E,E01019220,1187,924,263,136,34,93
2011,Carlisle 010F,E01019236,1307,976,331,80,109,142
2011,Carlisle 011A,E01019197,1382,884,498,191,45,262
2011,Carlisle 011B,E01019198,951,675,276,130,26,120
2011,Carlisle 011C,E01019199,746,521,225,84,18,123
2011,Carlisle 011D,E01019221,1403,1033,370,154,41,175
2011,Carlisle 011E,E01019222,1133,802,331,145,31,155
2011,Carlisle 011F,E01019245,1098,690,408,134,37,237
2011,Carlisle 012A,E01019208,1083,778,305,130,30,145
2011,Carlisle 012B,E01019210,1010,679,331,132,37,162
2011,Carlisle 012C,E01019246,862,550,312,174,15,123
2011,Carlisle 012D,E01019247,1092,725,367,199,26,142
2011,Carlisle 012E,E01019248,791,533,258,98,18,142
2011,Carlisle 013A,E01019212,1120,739,381,236,86,59
2011,Carlisle 013B,E01019213,2044,1560,484,305,44,135
2011,Carlisle 013C,E01019214,1279,899,380,278,28,74
2011,Carlisle 013D,E01019223,1151,820,331,237,26,68
2011,Carlisle 013E,E01019253,1311,962,349,255,21,73
2011,Copeland 001A,E01019268,864,576,288,201,21,66
2011,Copeland 001B,E01019269,1156,728,428,182,38,208
2011,Copeland 001C,E01019270,1026,721,305,170,22,113
2011,Copeland 001D,E01019297,1039,767,272,138,41,93
2011,Copeland 002A,E01019260,1149,838,311,166,34,111
2011,Copeland 002B,E01019280,1208,704,504,228,15,261
2011,Copeland 002C,E01019281,913,605,308,202,25,81
2011,Copeland 002D,E01019282,988,725,263,134,32,97
2011,Copeland 003A,E01019261,1332,982,350,243,44,63
2011,Copeland 003B,E01019262,1329,992,337,210,20,107
2011,Copeland 003C,E01019284,870,567,303,175,26,102
2011,Copeland 003D,E01019285,1123,814,309,107,36,166
2011,Copeland 003E,E01019286,965,648,317,204,26,87
2011,Copeland 003F,E01019287,913,613,300,227,29,44
2011,Copeland 003G,E01019288,1101,846,255,180,23,52
2011,Copeland 004A,E01019256,1191,851,340,220,39,81
2011,Copeland 004B,E01019263,860,535,325,145,39,141
2011,Copeland 004C,E01019264,1269,910,359,205,36,118
2011,Copeland 004D,E01019265,999,623,376,189,30,157
2011,Copeland 004E,E01019266,1153,833,320,171,38,111
2011,Copeland 004F,E01019267,920,578,342,154,28,160
2011,Copeland 004G,E01019276,805,532,273,175,27,71
2011,Copeland 004H,E01019277,884,518,366,173,30,163
2011,Copeland 004I,E01019278,1035,718,317,186,34,97
2011,Copeland 005A,E01019291,969,670,299,147,28,124
2011,Copeland 005B,E01019292,862,578,284,191,25,68
2011,Copeland 005C,E01019294,1064,702,362,167,35,160
2011,Copeland 005D,E01019295,1056,672,384,123,38,223
2011,Copeland 005E,E01019296,1032,713,319,170,16,133
2011,Copeland 005F,E01019301,1037,581,456,130,34,292
2011,Copeland 005G,E01019302,803,564,239,127,29,83
2011,Copeland 006A,E01019271,968,619,349,156,38,155
2011,Copeland 006B,E01019272,1074,711,363,179,26,158
2011,Copeland 006C,E01019273,1246,882,364,236,38,90
2011,Copeland 006D,E01019274,1153,778,375,239,23,113
2011,Copeland 006E,E01019275,1614,1119,495,315,49,131
2011,Copeland 007A,E01019257,1110,678,432,290,31,111
2011,Copeland 007B,E01019258,1174,833,341,239,41,61
2011,Copeland 007C,E01019279,1054,690,364,278,20,66
2011,Copeland 007D,E01019300,1369,926,443,259,100,84
2011,Copeland 007E,E01019303,1082,745,337,227,39,71
2011,Copeland 007F,E01019304,978,702,276,207,18,51
2011,Copeland 008A,E01019259,973,672,301,192,22,87
2011,Copeland 008B,E01019283,1548,732,816,271,37,508
2011,Copeland 008C,E01019289,1009,634,375,212,35,128
2011,Copeland 008D,E01019290,819,553,266,132,45,89
2011,Copeland 008E,E01019293,1059,697,362,266,20,76
2011,Copeland 008F,E01019298,1113,709,404,266,33,105
2011,Copeland 008G,E01019299,1444,951,493,253,43,197
2011,Eden 001A,E01019305,1620,1115,505,275,59,171
2011,Eden 001B,E01019314,955,670,285,191,25,69
2011,Eden 001C,E01019320,1104,823,281,181,26,74
2011,Eden 001D,E01019321,1163,875,288,180,40,68
2011,Eden 002A,E01019315,1273,922,351,259,24,68
2011,Eden 002B,E01019316,1150,841,309,142,129,38
2011,Eden 002C,E01019322,1028,739,289,202,27,60
2011,Eden 002D,E01019338,1144,871,273,174,40,59
2011,Eden 003A,E01019327,963,730,233,133,27,73
2011,Eden 003B,E01019332,952,661,291,156,19,116
2011,Eden 003C,E01019333,801,603,198,93,24,81
2011,Eden 003D,E01019335,1125,917,208,98,37,73
2011,Eden 003E,E01019336,1344,1097,247,96,50,101
2011,Eden 004A,E01019312,1055,709,346,269,26,51
2011,Eden 004B,E01019326,1130,838,292,225,26,41
2011,Eden 004C,E01019328,932,696,236,161,19,56
2011,Eden 004D,E01019329,804,582,222,177,17,28
2011,Eden 004E,E01019330,1067,821,246,141,27,78
2011,Eden 004F,E01019331,1126,834,292,204,28,60
2011,Eden 004G,E01019334,946,670,276,225,18,33
2011,Eden 005A,E01019308,1063,737,326,221,40,65
2011,Eden 005B,E01019311,1047,778,269,188,24,57
2011,Eden 005C,E01019313,1033,704,329,253,25,51
2011,Eden 005D,E01019339,1065,808,257,192,17,48
2011,Eden 006A,E01019306,908,600,308,223,20,65
2011,Eden 006B,E01019307,1242,927,315,200,31,84
2011,Eden 006C,E01019310,1046,751,295,210,36,49
2011,Eden 006D,E01019319,1150,865,285,177,27,81
2011,Eden 006E,E01019323,902,681,221,169,8,44
2011,Eden 006F,E01019324,971,714,257,194,16,47
2011,Eden 006G,E01019337,1027,748,279,188,21,70
2011,Eden 007A,E01019309,1727,1265,462,317,37,108
2011,Eden 007B,E01019317,941,689,252,194,20,38
2011,Eden 007C,E01019318,899,645,254,149,17,88
2011,Eden 007D,E01019325,1028,755,273,179,24,70
2011,Eden 007E,E01019340,1004,732,272,186,19,67
2011,South Lakeland 001A,E01019374,1124,893,231,121,48,62
2011,South Lakeland 001B,E01019375,1081,750,331,261,27,43
2011,South Lakeland 001C,E01019376,1139,888,251,178,18,55
2011,South Lakeland 001D,E01019395,1453,929,524,334,85,105
2011,South Lakeland 002A,E01019387,1522,1094,428,309,37,82
2011,South Lakeland 002B,E01019396,1458,1085,373,264,32,77
2011,South Lakeland 002C,E01019397,1536,1120,416,279,52,85
2011,South Lakeland 002D,E01019398,871,682,189,104,17,68
2011,South Lakeland 002E,E01019399,766,558,208,136,29,43
2011,South Lakeland 003A,E01019346,1460,1023,437,315,28,94
2011,South Lakeland 003B,E01019359,1491,1101,390,221,29,140
2011,South Lakeland 003C,E01019365,1718,1343,375,250,42,83
2011,South Lakeland 003D,E01019370,1628,1240,388,259,31,98
2011,South Lakeland 004A,E01019360,1624,1187,437,252,50,135
2011,South Lakeland 004B,E01019363,1398,1026,372,215,45,112
2011,South Lakeland 004C,E01019364,1352,1020,332,151,39,142
2011,South Lakeland 004D,E01019371,1578,1194,384,195,35,154
2011,South Lakeland 005A,E01019358,1311,945,366,280,29,57
2011,South Lakeland 005B,E01019362,1420,1022,398,309,23,66
2011,South Lakeland 005C,E01019366,1308,954,354,263,22,69
2011,South Lakeland 005D,E01019394,1738,1314,424,285,41,98
2011,South Lakeland 006A,E01019361,1364,1004,360,266,30,64
2011,South Lakeland 006B,E01019367,1810,1370,440,286,39,115
2011,South Lakeland 006C,E01019368,1566,1233,333,231,39,63
2011,South Lakeland 006D,E01019369,1308,909,399,316,22,61
2011,South Lakeland 007A,E01019356,1093,789,304,239,13,52
2011,South Lakeland 007B,E01019381,1612,1124,488,360,41,87
2011,South Lakeland 007C,E01019386,1293,908,385,287,29,69
2011,South Lakeland 008A,E01019344,797,564,233,167,14,52
2011,South Lakeland 008B,E01019345,884,612,272,206,18,48
2011,South Lakeland 008C,E01019350,1268,893,375,294,19,62
2011,South Lakeland 008D,E01019351,1374,980,394,262,50,82
2011,South Lakeland 009A,E01019372,710,507,203,149,11,43
2011,South Lakeland 009B,E01019373,1016,625,391,213,138,40
2011,South Lakeland 009C,E01019384,1850,1188,662,341,243,78
2011,South Lakeland 009D,E01019385,831,625,206,139,17,50
2011,South Lakeland 010A,E01019348,861,615,246,183,24,39
2011,South Lakeland 010B,E01019352,1703,1253,450,316,61,73
2011,South Lakeland 010C,E01019377,1248,834,414,347,16,51
2011,South Lakeland 010D,E01019383,1453,899,554,440,40,74
2011,South Lakeland 011A,E01019341,1110,669,441,377,20,44
2011,South Lakeland 011B,E01019342,680,419,261,202,24,35
2011,South Lakeland 011C,E01019343,1082,680,402,309,41,52
2011,South Lakeland 011D,E01019347,1301,962,339,230,42,67
2011,South Lakeland 011E,E01019382,1535,1089,446,271,88,87
2011,South Lakeland 012A,E01019388,1329,859,470,271,43,156
2011,South Lakeland 012B,E01019389,1724,1198,526,252,69,205
2011,South Lakeland 012C,E01019390,1469,1046,423,296,27,100
2011,South Lakeland 012D,E01019392,1352,962,390,230,36,124
2011,South Lakeland 013A,E01019349,1326,887,439,327,30,82
2011,South Lakeland 013B,E01019353,1073,702,371,273,24,74
2011,South Lakeland 013C,E01019354,823,488,335,246,28,61
2011,South Lakeland 013D,E01019355,856,402,454,400,17,37
2011,South Lakeland 013E,E01019357,1371,975,396,262,38,96
2011,South Lakeland 014A,E01019378,1183,848,335,218,36,81
2011,South Lakeland 014B,E01019379,1047,657,390,292,28,70
2011,South Lakeland 014C,E01019380,841,540,301,230,17,54
2011,South Lakeland 014D,E01019391,1270,855,415,291,39,85
2011,South Lakeland 014E,E01019393,1442,858,584,457,37,90
2011,Bolton 001A,E01004768,1173,895,278,184,49,45
2011,Bolton 001B,E01004803,1223,890,333,254,32,47
2011,Bolton 001C,E01004804,1129,818,311,231,35,45
2011,Bolton 001D,E01004807,1113,859,254,143,57,54
2011,Bolton 001E,E01004808,1253,902,351,246,49,56
2011,Bolton 002A,E01004788,1010,666,344,276,26,42
2011,Bolton 002B,E01004790,1037,721,316,228,35,53
2011,Bolton 002C,E01004805,1223,833,390,266,65,59
2011,Bolton 002D,E01004806,1060,688,372,261,56,55
2011,Bolton 002E,E01004810,1187,904,283,160,57,66
2011,Bolton 003A,E01004769,1161,865,296,214,27,55
2011,Bolton 003B,E01004770,1024,695,329,214,38,77
2011,Bolton 003C,E01004771,1159,848,311,208,45,58
2011,Bolton 003D,E01004773,1448,1107,341,145,87,109
2011,Bolton 003E,E01004809,1305,947,358,236,35,87
2011,Bolton 004A,E01004777,1110,810,300,135,33,132
2011,Bolton 004B,E01004881,961,622,339,206,22,111
2011,Bolton 004C,E01004888,1012,731,281,148,49,84
2011,Bolton 004D,E01004889,1026,720,306,152,39,115
2011,Bolton 004E,E01004890,1052,794,258,146,29,83
2011,Bolton 005A,E01004766,1147,807,340,181,57,102
2011,Bolton 005B,E01004767,1254,893,361,183,55,123
2011,Bolton 005C,E01004772,1220,825,395,130,67,198
2011,Bolton 005D,E01004774,1251,887,364,141,66,157
2011,Bolton 005E,E01004824,1186,643,543,96,103,344
2011,Bolton 006A,E01004784,970,663,307,237,25,45
2011,Bolton 006B,E01004785,1037,690,347,223,35,89
2011,Bolton 006C,E01004786,1049,691,358,245,41,72
2011,Bolton 006D,E01004789,1055,731,324,236,37,51
2011,Bolton 006E,E01004791,876,614,262,199,30,33
2011,Bolton 006F,E01004792,1070,681,389,315,30,44
2011,Bolton 007A,E01004779,1159,897,262,122,47,93
2011,Bolton 007B,E01004781,1385,1087,298,147,42,109
2011,Bolton 007C,E01004882,996,736,260,149,41,70
2011,Bolton 007D,E01004883,1120,843,277,174,34,69
2011,Bolton 007E,E01004884,1128,717,411,336,32,43
2011,Bolton 008A,E01004864,1171,854,317,166,42,109
2011,Bolton 008B,E01004867,1085,751,334,107,46,181
2011,Bolton 008C,E01004921,1145,808,337,191,43,103
2011,Bolton 008D,E01004924,1157,841,316,207,56,53
2011,Bolton 008E,E01004925,1108,798,310,164,60,86
2011,Bolton 009A,E01004778,881,574,307,237,27,43
2011,Bolton 009B,E01004780,1489,1120,369,233,54,82
2011,Bolton 009C,E01004782,810,549,261,153,22,86
2011,Bolton 009D,E01004783,1146,818,328,224,43,61
2011,Bolton 010A,E01004802,1233,740,493,151,86,256
2011,Bolton 010B,E01004926,901,533,368,104,67,197
2011,Bolton 010C,E01004927,1531,950,581,175,68,338
2011,Bolton 010D,E01004929,1427,968,459,188,67,204
2011,Bolton 011A,E01004820,1108,591,517,116,77,324
2011,Bolton 011B,E01004825,1155,624,531,111,61,359
2011,Bolton 011C,E01004826,1077,668,409,95,66,248
2011,Bolton 011D,E01004865,974,630,344,147,42,155
2011,Bolton 011E,E01004866,1189,634,555,171,80,304
2011,Bolton 012A,E01004840,1191,804,387,204,47,136
2011,Bolton 012B,E01004841,1129,694,435,88,73,274
2011,Bolton 012C,E01004842,1145,775,370,243,61,66
2011,Bolton 012D,E01004919,1089,781,308,192,50,66
2011,Bolton 012E,E01004920,1084,721,363,167,57,139
2011,Bolton 013A,E01004787,1127,692,435,129,47,259
2011,Bolton 013B,E01004793,1103,647,456,159,63,234
2011,Bolton 013C,E01004794,1180,702,478,122,67,289
2011,Bolton 013D,E01004795,1069,680,389,196,44,149
2011,Bolton 013E,E01004797,913,567,346,112,71,163
2011,Bolton 014A,E01004775,1101,766,335,235,40,60
2011,Bolton 014B,E01004885,1013,700,313,211,41,61
2011,Bolton 014C,E01004886,1011,698,313,142,41,130
2011,Bolton 014D,E01004887,1069,712,357,193,47,117
2011,Bolton 015A,E01004868,1255,869,386,109,79,198
2011,Bolton 015B,E01004869,1214,753,461,172,62,227
2011,Bolton 015C,E01004870,1373,853,520,135,132,253
2011,Bolton 015D,E01004871,1114,658,456,94,114,248
2011,Bolton 015E,E01004922,1269,876,393,153,70,170
2011,Bolton 016B,E01004822,1132,571,561,132,93,336
2011,Bolton 016C,E01004823,1268,645,623,200,92,331
2011,Bolton 016D,E01004848,1246,618,628,178,199,251
2011,Bolton 016E,E01033217,831,503,328,93,83,152
2011,Bolton 016F,E01033220,1004,575,429,89,59,281
2011,Bolton 017A,E01004818,1170,792,378,101,86,191
2011,Bolton 017B,E01004819,1153,722,431,154,163,114
2011,Bolton 017C,E01004928,1032,734,298,119,41,138
2011,Bolton 017D,E01004930,1148,782,366,214,53,99
2011,Bolton 017E,E01004931,1141,728,413,212,48,153
2011,Bolton 017F,E01004932,1189,899,290,115,52,123
2011,Bolton 018A,E01004834,1097,717,380,97,114,169
2011,Bolton 018B,E01004838,1130,720,410,115,87,208
2011,Bolton 018C,E01004843,1082,802,280,163,46,71
2011,Bolton 018D,E01004845,1258,930,328,165,77,86
2011,Bolton 018E,E01004923,1197,907,290,108,66,116
2011,Bolton 019A,E01004796,1133,820,313,183,40,90
2011,Bolton 019B,E01004798,1193,782,411,188,59,164
2011,Bolton 019C,E01004799,1017,661,356,263,30,63
2011,Bolton 019D,E01004800,1061,772,289,185,35,69
2011,Bolton 019E,E01004801,1150,698,452,126,71,255
2011,Bolton 019F,E01004917,1540,1129,411,203,63,145
2011,Bolton 020A,E01004835,1103,726,377,231,53,93
2011,Bolton 020B,E01004836,1052,659,393,261,43,89
2011,Bolton 020C,E01004837,1193,801,392,227,69,96
2011,Bolton 020D,E01004844,1192,784,408,270,63,75
2011,Bolton 020E,E01004897,842,601,241,166,32,43
2011,Bolton 021A,E01004827,1079,645,434,124,88,222
2011,Bolton 021B,E01004849,1193,666,527,96,135,296
2011,Bolton 021C,E01004850,1276,777,499,83,115,301
2011,Bolton 021D,E01004851,1111,547,564,171,101,292
2011,Bolton 021E,E01004853,1049,551,498,93,106,299
2011,Bolton 022A,E01004811,1062,642,420,93,66,261
2011,Bolton 022B,E01004812,1284,799,485,91,110,284
2011,Bolton 022C,E01004813,974,634,340,104,60,176
2011,Bolton 022D,E01004815,1068,681,387,116,63,208
2011,Bolton 022E,E01004817,1208,798,410,165,55,190
2011,Bolton 023A,E01004828,1165,694,471,109,81,281
2011,Bolton 023B,E01004829,971,569,402,71,85,246
2011,Bolton 023C,E01004832,1111,803,308,127,43,138
2011,Bolton 023D,E01004854,1063,578,485,80,119,286
2011,Bolton 023E,E01004878,1066,669,397,160,73,164
2011,Bolton 024A,E01004911,1170,786,384,177,39,168
2011,Bolton 024B,E01004912,1155,751,404,277,36,91
2011,Bolton 024C,E01004913,1390,1071,319,122,65,132
2011,Bolton 024D,E01004914,904,535,369,283,31,55
2011,Bolton 024E,E01004915,1056,724,332,221,34,77
2011,Bolton 024F,E01004916,1044,702,342,188,33,121
2011,Bolton 024G,E01004918,989,682,307,190,42,75
2011,Bolton 025A,E01004846,871,526,345,88,45,212
2011,Bolton 025B,E01004847,1272,694,578,89,143,346
2011,Bolton 025C,E01004852,1095,633,462,99,90,273
2011,Bolton 025D,E01004877,1158,597,561,135,113,313
2011,Bolton 025E,E01004879,938,558,380,88,81,211
2011,Bolton 026A,E01004830,1118,764,354,144,43,167
2011,Bolton 026B,E01004831,1205,863,342,166,56,120
2011,Bolton 026C,E01004833,1138,754,384,238,46,100
2011,Bolton 026D,E01004839,1382,818,564,223,88,253
2011,Bolton 027A,E01004814,1029,683,346,95,66,185
2011,Bolton 027B,E01004855,1095,787,308,117,50,141
2011,Bolton 027C,E01004856,1005,643,362,98,44,220
2011,Bolton 027D,E01004857,1103,690,413,124,71,218
2011,Bolton 028A,E01004891,1180,825,355,255,34,66
2011,Bolton 028B,E01004893,1180,852,328,237,31,60
2011,Bolton 028C,E01004894,1380,1014,366,198,52,116
2011,Bolton 028E,E01004901,1447,1111,336,210,67,59
2011,Bolton 028F,E01033218,1167,976,191,106,25,60
2011,Bolton 028G,E01033219,1126,856,270,182,37,51
2011,Bolton 029A,E01004816,1049,637,412,140,80,192
2011,Bolton 029B,E01004872,1125,768,357,122,74,161
2011,Bolton 029C,E01004873,1208,789,419,115,96,208
2011,Bolton 029D,E01004875,1129,798,331,184,40,107
2011,Bolton 029E,E01004880,998,699,299,160,55,84
2011,Bolton 030A,E01004892,1096,679,417,307,36,74
2011,Bolton 030B,E01004896,980,601,379,290,32,57
2011,Bolton 030C,E01004899,1131,807,324,155,47,122
2011,Bolton 030D,E01004900,1178,930,248,97,52,99
2011,Bolton 031A,E01004776,1354,1011,343,159,42,142
2011,Bolton 031B,E01004895,981,664,317,155,40,122
2011,Bolton 031C,E01004936,1601,1236,365,178,53,134
2011,Bolton 031D,E01004938,1029,669,360,149,38,173
2011,Bolton 031E,E01004939,1149,804,345,166,38,141
2011,Bolton 032A,E01004858,1187,803,384,179,46,159
2011,Bolton 032B,E01004859,1002,580,422,179,42,201
2011,Bolton 032C,E01004860,1114,745,369,179,35,155
2011,Bolton 032D,E01004902,1250,881,369,195,42,132
2011,Bolton 032E,E01004906,1225,840,385,173,44,168
2011,Bolton 033A,E01004861,1140,725,415,81,68,266
2011,Bolton 033B,E01004862,928,550,378,115,53,210
2011,Bolton 033C,E01004863,1124,696,428,133,63,232
2011,Bolton 033D,E01004874,1225,852,373,151,73,149
2011,Bolton 033E,E01004876,1340,843,497,192,75,230
2011,Bolton 034A,E01004903,1093,854,239,132,37,70
2011,Bolton 034B,E01004904,1196,928,268,136,41,91
2011,Bolton 034C,E01004905,1181,839,342,149,55,138
2011,Bolton 034D,E01004907,930,652,278,88,56,134
2011,Bolton 034E,E01004908,970,610,360,239,34,87
2011,Bolton 034F,E01004909,992,660,332,172,38,122
2011,Bolton 034G,E01004910,1664,1306,358,198,56,104
2011,Bolton 035A,E01004933,1039,822,217,115,38,64
2011,Bolton 035B,E01004934,1110,837,273,98,51,124
2011,Bolton 035C,E01004935,1294,1017,277,144,53,80
2011,Bolton 035D,E01004937,1170,899,271,132,55,84
2011,Bolton 035E,E01004940,1105,757,348,203,41,104
2011,Bury 001A,E01005014,1160,863,297,197,38,62
2011,Bury 001B,E01005015,1116,808,308,133,33,142
2011,Bury 001C,E01005016,1173,925,248,151,30,67
2011,Bury 001D,E01005017,1243,943,300,172,56,72
2011,Bury 001E,E01005018,1136,821,315,177,41,97
2011,Bury 001F,E01005021,907,547,360,156,171,33
2011,Bury 002A,E01005019,1065,757,308,201,42,65
2011,Bury 002B,E01005023,920,611,309,222,28,59
2011,Bury 002C,E01005046,1002,655,347,291,22,34
2011,Bury 002D,E01005048,1293,874,419,296,56,67
2011,Bury 003A,E01005020,1100,911,189,96,57,36
2011,Bury 003B,E01005022,1220,932,288,171,49,68
2011,Bury 003C,E01005047,1067,773,294,215,32,47
2011,Bury 003D,E01005049,1259,939,320,208,41,71
2011,Bury 003E,E01005051,1117,876,241,137,34,70
2011,Bury 004A,E01004976,1109,706,403,153,66,184
2011,Bury 004B,E01004977,1193,863,330,210,35,85
2011,Bury 004C,E01004978,1212,839,373,140,59,174
2011,Bury 004D,E01004981,1065,729,336,209,41,86
2011,Bury 004E,E01004982,1088,715,373,264,35,74
2011,Bury 005A,E01004961,1121,810,311,157,44,110
2011,Bury 005B,E01004965,935,610,325,237,33,55
2011,Bury 005C,E01004966,1253,844,409,173,58,178
2011,Bury 005D,E01004967,980,693,287,201,40,46
2011,Bury 006A,E01004963,1119,770,349,233,45,71
2011,Bury 006B,E01004968,1166,846,320,211,43,66
2011,Bury 006C,E01005050,1457,1170,287,146,50,91
2011,Bury 006D,E01005052,1121,835,286,200,39,47
2011,Bury 006E,E01005053,1168,838,330,177,39,114
2011,Bury 007A,E01004954,1084,737,347,207,29,111
2011,Bury 007B,E01004955,956,695,261,105,44,112
2011,Bury 007C,E01004956,1083,744,339,149,48,142
2011,Bury 007D,E01004957,1273,783,490,125,61,304
2011,Bury 007E,E01004960,1009,565,444,80,62,302
2011,Bury 008A,E01004958,1074,692,382,116,58,208
2011,Bury 008B,E01004959,1221,830,391,121,62,208
2011,Bury 008C,E01004979,1127,719,408,95,55,258
2011,Bury 008D,E01004980,981,733,248,74,37,137
2011,Bury 008E,E01005024,938,536,402,72,61,269
2011,Bury 008F,E01005026,1132,713,419,94,67,258
2011,Bury 009A,E01004947,1075,808,267,93,43,131
2011,Bury 009B,E01004948,1365,868,497,173,61,263
2011,Bury 009C,E01004962,1240,993,247,126,36,85
2011,Bury 009D,E01004964,1361,1070,291,133,57,101
2011,Bury 010A,E01004949,1068,702,366,263,50,53
2011,Bury 010B,E01004950,1126,775,351,257,54,40
2011,Bury 010C,E01004951,1144,769,375,281,29,65
2011,Bury 010D,E01004952,1064,611,453,363,41,49
2011,Bury 010E,E01004953,1091,797,294,193,44,57
2011,Bury 011A,E01005025,1156,835,321,160,37,124
2011,Bury 011B,E01005027,1321,907,414,111,86,217
2011,Bury 011C,E01005028,1314,817,497,151,95,251
2011,Bury 011D,E01005029,1244,821,423,136,73,214
2011,Bury 012A,E01005000,1144,902,242,130,46,66
2011,Bury 012B,E01005001,1044,835,209,116,42,51
2011,Bury 012C,E01005005,1025,703,322,216,30,76
2011,Bury 012D,E01005006,1118,778,340,203,35,102
2011,Bury 013A,E01005030,1151,737,414,159,52,203
2011,Bury 013B,E01005054,1182,839,343,201,47,95
2011,Bury 013C,E01005059,1262,870,392,159,73,160
2011,Bury 013D,E01005060,1214,867,347,210,44,93
2011,Bury 014A,E01004997,1106,798,308,156,57,95
2011,Bury 014B,E01004998,1069,674,395,277,27,91
2011,Bury 014C,E01004999,1094,811,283,155,46,82
2011,Bury 014D,E01005002,1211,857,354,197,48,109
2011,Bury 014E,E01005003,1067,774,293,142,33,118
2011,Bury 015A,E01004991,1037,747,290,134,52,104
2011,Bury 015B,E01004992,1090,793,297,134,33,130
2011,Bury 015C,E01004993,1008,721,287,130,44,113
2011,Bury 015D,E01004994,969,669,300,91,41,168
2011,Bury 016A,E01004990,1113,781,332,158,47,127
2011,Bury 016B,E01004996,1062,685,377,144,33,200
2011,Bury 016C,E01005004,1060,563,497,201,40,256
2011,Bury 016D,E01005008,1389,942,447,134,56,257
2011,Bury 016E,E01005009,1134,782,352,106,38,208
2011,Bury 017A,E01004945,1114,731,383,259,39,85
2011,Bury 017B,E01005055,1077,781,296,181,45,70
2011,Bury 017C,E01005056,951,643,308,219,31,58
2011,Bury 017D,E01005057,1111,830,281,134,49,98
2011,Bury 017E,E01005058,972,690,282,174,51,57
2011,Bury 018A,E01004995,1191,818,373,261,46,66
2011,Bury 018B,E01005010,1207,917,290,145,40,105
2011,Bury 018C,E01005012,1253,893,360,125,65,170
2011,Bury 018D,E01005013,1669,1215,454,126,88,240
2011,Bury 019A,E01004984,928,652,276,163,42,71
2011,Bury 019B,E01004985,1071,751,320,188,50,82
2011,Bury 019C,E01004989,1040,751,289,153,51,85
2011,Bury 019D,E01005007,1062,742,320,221,30,69
2011,Bury 019E,E01005011,1005,780,225,124,42,59
2011,Bury 020A,E01004983,1015,776,239,88,66,85
2011,Bury 020B,E01004986,1211,871,340,162,48,130
2011,Bury 020C,E01004987,839,483,356,164,37,155
2011,Bury 020D,E01004988,1074,770,304,151,47,106
2011,Bury 021A,E01004941,1288,911,377,155,61,161
2011,Bury 021B,E01004942,1017,644,373,95,65,213
2011,Bury 021C,E01004943,1178,853,325,134,71,120
2011,Bury 021D,E01004944,1207,917,290,165,54,71
2011,Bury 021E,E01004946,1144,713,431,190,45,196
2011,Bury 022A,E01004969,1150,767,383,181,41,161
2011,Bury 022B,E01004970,1163,844,319,183,52,84
2011,Bury 022C,E01004971,1116,780,336,218,50,68
2011,Bury 022D,E01005034,1077,776,301,152,55,94
2011,Bury 023A,E01004972,1040,701,339,86,81,172
2011,Bury 023B,E01004973,1168,834,334,161,73,100
2011,Bury 023C,E01004975,1147,870,277,119,49,109
2011,Bury 023D,E01005039,1066,707,359,155,45,159
2011,Bury 023E,E01005045,1171,872,299,126,53,120
2011,Bury 024A,E01004974,1082,812,270,145,51,74
2011,Bury 024B,E01005033,1059,823,236,94,55,87
2011,Bury 024C,E01005036,1410,1039,371,188,42,141
2011,Bury 024D,E01005037,1093,800,293,157,48,88
2011,Bury 025A,E01005031,1060,759,301,124,44,133
2011,Bury 025B,E01005032,802,532,270,123,29,118
2011,Bury 025C,E01005035,1053,788,265,126,43,96
2011,Bury 025D,E01005038,1011,766,245,128,53,64
2011,Bury 026A,E01005040,1323,938,385,125,95,165
2011,Bury 026B,E01005041,1096,775,321,102,102,117
2011,Bury 026C,E01005042,1189,818,371,145,95,131
2011,Bury 026D,E01005043,1062,767,295,90,71,134
2011,Bury 026E,E01005044,964,629,335,88,73,174
2011,Manchester 001A,E01005098,1115,635,480,177,62,241
2011,Manchester 001B,E01005099,1180,667,513,128,67,318
2011,Manchester 001C,E01005100,1150,735,415,156,51,208
2011,Manchester 001D,E01005102,1029,737,292,158,29,105
2011,Manchester 001E,E01005103,1144,667,477,191,43,243
2011,Manchester 002A,E01005101,1215,777,438,118,70,250
2011,Manchester 002B,E01005135,1131,645,486,131,79,276
2011,Manchester 002C,E01005136,1127,777,350,151,53,146
2011,Manchester 002D,E01005138,1175,661,514,129,70,315
2011,Manchester 002E,E01005140,2048,1385,663,210,104,349
2011,Manchester 003B,E01005139,1252,854,398,146,69,183
2011,Manchester 003C,E01005141,1240,682,558,166,80,312
2011,Manchester 003D,E01005251,1118,710,408,124,79,205
2011,Manchester 003E,E01005252,1306,820,486,204,75,207
2011,Manchester 003F,E01033685,1110,838,272,103,58,111
2011,Manchester 003G,E01033687,1089,660,429,153,55,221
2011,Manchester 004A,E01005104,1242,861,381,95,74,212
2011,Manchester 004B,E01005160,1258,817,441,175,84,182
2011,Manchester 004C,E01005161,1110,790,320,142,38,140
2011,Manchester 004D,E01005162,1205,763,442,160,82,200
2011,Manchester 004E,E01005163,1158,755,403,139,67,197
2011,Manchester 005A,E01005247,1087,764,323,168,55,100
2011,Manchester 005B,E01005248,1094,714,380,211,63,106
2011,Manchester 005C,E01005249,1353,945,408,140,65,203
2011,Manchester 005D,E01005250,1255,801,454,174,78,202
2011,Manchester 005E,E01005253,1088,683,405,136,69,200
2011,Manchester 005F,E01005254,1231,895,336,148,59,129
2011,Manchester 006A,E01005164,1159,686,473,92,100,281
2011,Manchester 006B,E01005205,1425,851,574,158,78,338
2011,Manchester 006C,E01005206,1286,857,429,140,55,234
2011,Manchester 006D,E01005207,1461,959,502,147,130,225
2011,Manchester 007A,E01005223,941,634,307,112,46,149
2011,Manchester 007B,E01005224,1278,893,385,80,88,217
2011,Manchester 007C,E01005225,1351,814,537,218,83,236
2011,Manchester 007D,E01005226,1126,782,344,93,68,183
2011,Manchester 007E,E01005229,1126,845,281,143,52,86
2011,Manchester 008A,E01005145,1805,971,834,118,248,468
2011,Manchester 008B,E01005146,1613,955,658,130,171,357
2011,Manchester 008C,E01005149,1163,621,542,85,146,311
2011,Manchester 008D,E01005165,1522,939,583,137,108,338
2011,Manchester 008E,E01005166,1271,731,540,126,101,313
2011,Manchester 008F,E01005167,1304,728,576,76,162,338
2011,Manchester 009A,E01005202,1240,646,594,128,80,386
2011,Manchester 009B,E01005203,1382,717,665,143,102,420
2011,Manchester 009D,E01005227,1188,740,448,103,77,268
2011,Manchester 009E,E01005228,1171,640,531,136,95,300
2011,Manchester 009F,E01033678,1107,682,425,86,67,272
2011,Manchester 009G,E01033679,1016,507,509,100,71,338
2011,Manchester 011A,E01005256,1463,868,595,157,99,339
2011,Manchester 011B,E01005257,1276,715,561,142,65,354
2011,Manchester 011C,E01005258,1233,775,458,171,79,208
2011,Manchester 011D,E01005259,1158,661,497,142,72,283
2011,Manchester 011E,E01005260,1118,766,352,158,50,144
2011,Manchester 012A,E01005093,1144,651,493,161,61,271
2011,Manchester 012B,E01005094,1011,592,419,127,79,213
2011,Manchester 012C,E01005097,1139,638,501,122,98,281
2011,Manchester 012D,E01005255,1165,605,560,165,67,328
2011,Manchester 012E,E01005261,1091,617,474,109,61,304
2011,Manchester 013B,E01005129,1054,590,464,98,73,293
2011,Manchester 013C,E01005132,1038,568,470,107,79,284
2011,Manchester 013D,E01005133,1036,592,444,114,73,257
2011,Manchester 013E,E01033663,1102,899,203,19,110,74
2011,Manchester 013F,E01033684,1180,1026,154,0,133,21
2011,Manchester 013G,E01033688,1104,628,476,115,72,289
2011,Manchester 015A,E01005092,1106,673,433,124,60,249
2011,Manchester 015C,E01005105,1462,934,528,105,142,281
2011,Manchester 015D,E01005106,1342,817,525,163,93,269
2011,Manchester 015E,E01005107,1203,719,484,98,84,302
2011,Manchester 015F,E01033668,941,727,214,38,64,112
2011,Manchester 015G,E01033669,1061,645,416,123,74,219
2011,Manchester 017A,E01005108,1745,1038,707,175,118,414
2011,Manchester 017D,E01005189,1200,664,536,186,67,283
2011,Manchester 017E,E01005190,1432,911,521,154,74,293
2011,Manchester 017F,E01033666,1935,1248,687,214,104,369
2011,Manchester 018A,E01005061,1155,667,488,106,94,288
2011,Manchester 018B,E01005062,2434,1028,1406,79,1106,221
2011,Manchester 018C,E01005063,1039,592,447,70,136,241
2011,Manchester 018D,E01005065,1599,875,724,102,261,361
2011,Manchester 018E,E01005066,1494,636,858,27,688,143
2011,Manchester 019A,E01005208,1930,1280,650,50,403,197
2011,Manchester 019B,E01005209,2350,1022,1328,69,1008,251
2011,Manchester 019C,E01005210,3016,928,2088,48,1858,182
2011,Manchester 019D,E01005214,1920,1406,514,23,318,173
2011,Manchester 020A,E01005067,940,499,441,120,71,250
2011,Manchester 020B,E01005186,1648,1043,605,156,124,325
2011,Manchester 020C,E01005232,1315,812,503,109,127,267
2011,Manchester 020D,E01005235,1231,677,554,112,108,334
2011,Manchester 020E,E01005239,1108,635,473,75,116,282
2011,Manchester 021A,E01005187,1323,888,435,95,85,255
2011,Manchester 021B,E01005188,1224,838,386,136,59,191
2011,Manchester 021C,E01005191,1214,761,453,143,66,244
2011,Manchester 021D,E01005192,1193,849,344,124,55,165
2011,Manchester 021E,E01005193,1338,948,390,125,63,202
2011,Manchester 022B,E01005230,1736,899,837,69,482,286
2011,Manchester 022C,E01005231,2457,1150,1307,31,1154,122
2011,Manchester 022D,E01005236,1624,880,744,64,404,276
2011,Manchester 022E,E01005237,1405,760,645,68,203,374
2011,Manchester 022F,E01033652,1381,569,812,30,674,108
2011,Manchester 022G,E01033657,1354,621,733,45,566,122
2011,Manchester 023A,E01005195,1320,821,499,108,98,293
2011,Manchester 023B,E01005196,1525,935,590,123,128,339
2011,Manchester 023C,E01005197,1096,668,428,116,83,229
2011,Manchester 023D,E01005198,1057,613,444,100,82,262
2011,Manchester 023E,E01005201,1352,861,491,72,124,295
2011,Manchester 024A,E01005240,1749,1074,675,95,205,375
2011,Manchester 024B,E01005243,1666,989,677,120,176,381
2011,Manchester 024C,E01005245,1504,772,732,159,222,351
2011,Manchester 024D,E01005246,1279,716,563,89,151,323
2011,Manchester 025A,E01005241,1819,1249,570,88,270,212
2011,Manchester 025B,E01005242,1824,1109,715,87,304,324
2011,Manchester 025C,E01005244,2449,1196,1253,78,931,244
2011,Manchester 025D,E01005285,993,478,515,71,216,228
2011,Manchester 025E,E01005288,1424,760,664,66,437,161
2011,Manchester 026A,E01005280,1299,699,600,92,192,316
2011,Manchester 026B,E01005281,2123,919,1204,72,1053,79
2011,Manchester 026C,E01005284,3265,1346,1919,42,1739,138
2011,Manchester 026D,E01005286,1937,1024,913,63,707,143
2011,Manchester 026E,E01005287,1486,743,743,104,216,423
2011,Manchester 027A,E01005194,1793,1039,754,115,228,411
2011,Manchester 027B,E01005199,1597,1068,529,105,122,302
2011,Manchester 027C,E01005200,1322,892,430,115,85,230
2011,Manchester 027D,E01005233,1560,909,651,71,188,392
2011,Manchester 027E,E01005234,1414,772,642,77,170,395
2011,Manchester 027F,E01005238,1408,785,623,73,191,359
2011,Manchester 028A,E01005297,1804,1261,543,96,149,298
2011,Manchester 028B,E01005298,1308,937,371,58,117,196
2011,Manchester 028C,E01005302,1492,1159,333,72,86,175
2011,Manchester 028E,E01033680,1061,826,235,26,95,114
2011,Manchester 028F,E01033686,1005,784,221,61,45,115
2011,Manchester 029A,E01005150,1644,1346,298,67,105,126
2011,Manchester 029B,E01005151,1119,853,266,93,58,115
2011,Manchester 029C,E01005152,1121,919,202,78,57,67
2011,Manchester 029D,E01005159,1271,1020,251,81,95,75
2011,Manchester 029E,E01005296,1259,933,326,103,85,138
2011,Manchester 029F,E01005299,1182,803,379,92,98,189
2011,Manchester 030A,E01005178,1478,937,541,85,210,246
2011,Manchester 030B,E01005179,1780,1291,489,99,169,221
2011,Manchester 030C,E01005180,1311,787,524,123,127,274
2011,Manchester 030D,E01005181,1507,969,538,115,169,254
2011,Manchester 030E,E01005182,1103,640,463,74,184,205
2011,Manchester 030F,E01005183,1256,682,574,113,151,310
2011,Manchester 031A,E01005219,1629,1083,546,77,203,266
2011,Manchester 031B,E01005220,1342,938,404,94,91,219
2011,Manchester 031C,E01005221,1612,1083,529,100,162,267
2011,Manchester 031D,E01005222,1520,1064,456,94,121,241
2011,Manchester 032A,E01005184,1822,1021,801,75,586,140
2011,Manchester 032B,E01005185,3945,1452,2493,17,2443,33
2011,Manchester 032C,E01005271,1953,929,1024,50,869,105
2011,Manchester 032D,E01005282,1361,722,639,86,326,227
2011,Manchester 032E,E01005283,1424,605,819,21,760,38
2011,Manchester 033A,E01005154,1311,1093,218,64,68,86
2011,Manchester 033B,E01005156,1183,993,190,90,49,51
2011,Manchester 033C,E01005158,1172,864,308,126,60,122
2011,Manchester 033D,E01005300,1109,685,424,119,137,168
2011,Manchester 033E,E01005301,1191,868,323,110,92,121
2011,Manchester 034A,E01005118,1047,682,365,127,85,153
2011,Manchester 034B,E01005120,1261,834,427,136,96,195
2011,Manchester 034C,E01005215,1411,933,478,115,129,234
2011,Manchester 034D,E01005216,1108,815,293,86,58,149
2011,Manchester 034E,E01005217,1361,909,452,157,130,165
2011,Manchester 034F,E01005218,1300,715,585,167,225,193
2011,Manchester 035A,E01005270,1301,861,440,103,127,210
2011,Manchester 035B,E01005272,1215,734,481,116,109,256
2011,Manchester 035C,E01005273,1412,697,715,46,588,81
2011,Manchester 035D,E01005278,1490,784,706,101,467,138
2011,Manchester 035E,E01005279,1465,988,477,124,121,232
2011,Manchester 036A,E01005305,1434,926,508,96,306,106
2011,Manchester 036B,E01005309,2182,1186,996,67,856,73
2011,Manchester 036C,E01005310,1626,717,909,55,736,118
2011,Manchester 036D,E01005311,1519,879,640,90,433,117
2011,Manchester 036E,E01005312,1697,758,939,79,777,83
2011,Manchester 037A,E01005082,1134,754,380,100,77,203
2011,Manchester 037B,E01005153,1325,1094,231,103,50,78
2011,Manchester 037C,E01005155,1119,949,170,75,43,52
2011,Manchester 037D,E01005157,1150,890,260,141,57,62
2011,Manchester 038A,E01005274,1426,879,547,91,295,161
2011,Manchester 038B,E01005275,1538,1231,307,43,214,50
2011,Manchester 038C,E01005276,1372,1013,359,50,232,77
2011,Manchester 038D,E01005277,1436,1170,266,77,120,69
2011,Manchester 039A,E01005076,1313,1096,217,49,88,80
2011,Manchester 039C,E01005081,1273,787,486,111,123,252
2011,Manchester 039D,E01005083,1520,1291,229,36,118,75
2011,Manchester 039E,E01033670,1124,1030,94,7,54,33
2011,Manchester 039F,E01033671,1489,1264,225,60,121,44
2011,Manchester 040A,E01005125,1173,783,390,108,97,185
2011,Manchester 040B,E01005304,1594,933,661,77,490,94
2011,Manchester 040C,E01005306,1189,899,290,136,72,82
2011,Manchester 040D,E01005307,1662,1060,602,90,430,82
2011,Manchester 040E,E01005308,1292,868,424,110,148,166
2011,Manchester 041A,E01005119,1080,658,422,128,83,211
2011,Manchester 041B,E01005121,1090,675,415,107,91,217
2011,Manchester 041C,E01005122,1163,723,440,118,81,241
2011,Manchester 041D,E01005123,1166,711,455,99,119,237
2011,Manchester 041E,E01005124,1249,811,438,119,90,229
2011,Manchester 042A,E01005077,1065,644,421,72,87,262
2011,Manchester 042B,E01005078,1222,1032,190,91,54,45
2011,Manchester 042C,E01005079,1114,804,310,107,62,141
2011,Manchester 042D,E01005084,1528,1127,401,135,83,183
2011,Manchester 043A,E01005172,1250,951,299,107,100,92
2011,Manchester 043B,E01005173,1210,935,275,125,79,71
2011,Manchester 043C,E01005174,1155,895,260,113,82,65
2011,Manchester 043D,E01005175,1221,929,292,128,59,105
2011,Manchester 043E,E01005176,1563,1339,224,79,71,74
2011,Manchester 043F,E01005177,1024,791,233,118,63,52
2011,Manchester 044A,E01005115,1317,951,366,135,57,174
2011,Manchester 044B,E01005262,1371,1016,355,86,66,203
2011,Manchester 044C,E01005264,1067,711,356,105,75,176
2011,Manchester 044D,E01005265,1187,772,415,137,92,186
2011,Manchester 044E,E01005266,1370,878,492,144,90,258
2011,Manchester 045A,E01005126,1499,1096,403,159,108,136
2011,Manchester 045B,E01005168,994,743,251,114,59,78
2011,Manchester 045C,E01005169,1044,749,295,112,120,63
2011,Manchester 045D,E01005170,1073,790,283,134,61,88
2011,Manchester 045E,E01005171,1317,984,333,122,101,110
2011,Manchester 046A,E01005263,1270,875,395,157,49,189
2011,Manchester 046B,E01005267,1154,835,319,142,51,126
2011,Manchester 046C,E01005268,1594,1291,303,150,61,92
2011,Manchester 046D,E01005269,1088,760,328,175,42,111
2011,Manchester 047A,E01005069,1163,892,271,147,40,84
2011,Manchester 047B,E01005111,966,666,300,112,45,143
2011,Manchester 047C,E01005113,1162,774,388,126,31,231
2011,Manchester 047D,E01005114,1273,882,391,240,54,97
2011,Manchester 047E,E01005116,1526,1148,378,147,49,182
2011,Manchester 048A,E01005071,1115,795,320,94,61,165
2011,Manchester 048B,E01005072,1234,869,365,124,49,192
2011,Manchester 048C,E01005073,1090,812,278,117,50,111
2011,Manchester 048D,E01005112,1155,753,402,141,57,204
2011,Manchester 048E,E01005117,1454,961,493,114,59,320
2011,Manchester 049A,E01005085,1072,740,332,76,60,196
2011,Manchester 049B,E01005086,1250,767,483,119,79,285
2011,Manchester 049C,E01005089,1268,813,455,128,69,258
2011,Manchester 049D,E01005289,1049,618,431,119,59,253
2011,Manchester 049E,E01005295,1919,1566,353,108,70,175
2011,Manchester 050A,E01005087,1438,896,542,120,109,313
2011,Manchester 050B,E01005088,1140,646,494,115,74,305
2011,Manchester 050C,E01005090,1106,641,465,133,56,276
2011,Manchester 050D,E01005091,1521,969,552,138,86,328
2011,Manchester 050E,E01005291,1053,621,432,148,55,229
2011,Manchester 051A,E01005068,1110,732,378,120,48,210
2011,Manchester 051B,E01005070,1196,765,431,143,62,226
2011,Manchester 051C,E01005074,1093,727,366,114,50,202
2011,Manchester 051D,E01005075,992,710,282,103,39,140
2011,Manchester 051E,E01005319,1534,1027,507,159,83,265
2011,Manchester 052A,E01005290,1114,716,398,123,52,223
2011,Manchester 052B,E01005292,1062,711,351,101,37,213
2011,Manchester 052C,E01005293,945,733,212,119,27,66
2011,Manchester 052D,E01005294,1116,778,338,171,48,119
2011,Manchester 052E,E01005317,1222,774,448,134,78,236
2011,Manchester 053A,E01005313,1059,716,343,91,56,196
2011,Manchester 053B,E01005314,1118,751,367,114,65,188
2011,Manchester 053C,E01005315,1092,691,401,120,56,225
2011,Manchester 053D,E01005316,1246,924,322,100,52,170
2011,Manchester 053E,E01005318,1311,907,404,148,55,201
2011,Manchester 054A,E01005130,1155,659,496,103,65,328
2011,Manchester 054B,E01033651,1092,860,232,13,155,64
2011,Manchester 054C,E01033658,1186,866,320,20,267,33
2011,Manchester 054D,E01033664,1094,943,151,7,122,22
2011,Manchester 054E,E01033667,969,812,157,17,87,53
2011,Manchester 055A,E01005128,1681,827,854,2,825,27
2011,Manchester 055B,E01033653,1531,1143,388,90,255,43
2011,Manchester 055C,E01033654,2935,1318,1617,9,1584,24
2011,Manchester 055D,E01033659,1297,1146,151,4,121,26
2011,Manchester 055E,E01033661,1103,801,302,82,163,57
2011,Manchester 056A,E01005143,1743,945,798,99,226,473
2011,Manchester 056B,E01033655,1158,1001,157,2,115,40
2011,Manchester 056C,E01033665,1118,882,236,49,98,89
2011,Manchester 056D,E01033676,1153,601,552,114,111,327
2011,Manchester 057A,E01005212,1914,1089,825,52,627,146
2011,Manchester 057B,E01033656,3469,1540,1929,5,1880,44
2011,Manchester 057C,E01033662,1312,821,491,8,426,57
2011,Manchester 058A,E01005142,1304,680,624,101,127,396
2011,Manchester 058B,E01005147,1684,974,710,102,188,420
2011,Manchester 058C,E01033674,1936,1214,722,36,115,571
2011,Manchester 058D,E01033675,1428,978,450,74,112,264
2011,Manchester 059A,E01005213,1785,1185,600,108,212,280
2011,Manchester 059B,E01033660,1153,1056,97,0,69,28
2011,Manchester 059C,E01033672,1009,686,323,39,90,194
2011,Manchester 059D,E01033673,1087,1013,74,3,57,14
2011,Manchester 060A,E01033677,1140,652,488,15,448,25
2011,Manchester 060B,E01033681,1332,1147,185,17,146,22
2011,Manchester 060C,E01033682,1234,1065,169,26,121,22
2011,Manchester 060D,E01033683,1215,894,321,2,288,31
2011,Oldham 001A,E01005357,1102,721,381,274,41,66
2011,Oldham 001B,E01005358,1214,889,325,172,45,108
2011,Oldham 001C,E01005359,1222,750,472,346,43,83
2011,Oldham 001D,E01005360,1022,621,401,275,35,91
2011,Oldham 002A,E01005441,1200,790,410,209,38,163
2011,Oldham 002B,E01005442,1120,821,299,200,40,59
2011,Oldham 002C,E01005444,1135,825,310,163,39,108
2011,Oldham 002D,E01005445,1122,816,306,127,45,134
2011,Oldham 003A,E01005361,1263,806,457,324,42,91
2011,Oldham 003B,E01005443,1077,785,292,211,28,53
2011,Oldham 003C,E01005446,1066,760,306,172,44,90
2011,Oldham 003D,E01005447,1062,666,396,173,39,184
2011,Oldham 004A,E01005390,1119,819,300,208,25,67
2011,Oldham 004B,E01005394,1151,843,308,205,40,63
2011,Oldham 004C,E01005395,1098,787,311,187,48,76
2011,Oldham 004D,E01005396,1133,760,373,230,50,93
2011,Oldham 005A,E01005355,1129,801,328,161,55,112
2011,Oldham 005B,E01005356,1035,813,222,114,35,73
2011,Oldham 005C,E01005399,1249,910,339,237,36,66
2011,Oldham 005D,E01005403,1224,981,243,115,43,85
2011,Oldham 006A,E01005410,1191,887,304,204,35,65
2011,Oldham 006B,E01005411,1112,778,334,207,65,62
2011,Oldham 006C,E01005414,1001,734,267,170,42,55
2011,Oldham 006D,E01005415,826,537,289,201,30,58
2011,Oldham 007C,E01005452,1081,816,265,157,38,70
2011,Oldham 007D,E01005453,981,737,244,166,30,48
2011,Oldham 007E,E01032558,1006,646,360,112,48,200
2011,Oldham 007F,E01032559,1962,1541,421,159,83,179
2011,Oldham 008A,E01005391,1197,870,327,201,29,97
2011,Oldham 008B,E01005392,1077,689,388,178,46,164
2011,Oldham 008C,E01005393,957,649,308,216,41,51
2011,Oldham 008D,E01005401,1202,850,352,230,45,77
2011,Oldham 009A,E01005397,1094,785,309,199,37,73
2011,Oldham 009B,E01005398,1118,805,313,191,34,88
2011,Oldham 009C,E01005400,1096,689,407,231,30,146
2011,Oldham 009D,E01005402,1089,826,263,134,45,84
2011,Oldham 010A,E01005335,1016,731,285,206,28,51
2011,Oldham 010B,E01005337,1249,847,402,102,73,227
2011,Oldham 010C,E01005339,1060,741,319,228,42,49
2011,Oldham 010D,E01005340,1004,649,355,148,60,147
2011,Oldham 011A,E01005421,1201,853,348,150,43,155
2011,Oldham 011B,E01005422,964,626,338,76,64,198
2011,Oldham 011E,E01032920,1376,948,428,186,48,194
2011,Oldham 012A,E01005448,1029,615,414,129,39,246
2011,Oldham 012B,E01005449,887,574,313,151,38,124
2011,Oldham 012C,E01005454,1089,836,253,139,38,76
2011,Oldham 012D,E01005455,1192,921,271,132,39,100
2011,Oldham 012E,E01005456,1160,777,383,124,43,216
2011,Oldham 013A,E01005407,1331,981,350,247,39,64
2011,Oldham 013B,E01005412,1295,958,337,238,38,61
2011,Oldham 013C,E01005416,1045,783,262,180,26,56
2011,Oldham 013D,E01005417,1140,799,341,252,34,55
2011,Oldham 014A,E01005348,1059,611,448,127,85,236
2011,Oldham 014B,E01005350,1389,663,726,198,85,443
2011,Oldham 014C,E01005432,1029,598,431,138,76,217
2011,Oldham 014D,E01005433,1007,599,408,100,54,254
2011,Oldham 015A,E01005329,1195,920,275,154,51,70
2011,Oldham 015B,E01005330,1202,911,291,187,35,69
2011,Oldham 015C,E01005333,1017,761,256,164,42,50
2011,Oldham 015D,E01005336,1174,818,356,238,58,60
2011,Oldham 016A,E01005349,1436,722,714,74,153,487
2011,Oldham 016B,E01005351,1181,602,579,97,127,355
2011,Oldham 016C,E01005352,924,466,458,105,71,282
2011,Oldham 016D,E01005353,1293,692,601,102,98,401
2011,Oldham 016E,E01005354,1174,760,414,82,83,249
2011,Oldham 017A,E01005327,1325,895,430,191,62,177
2011,Oldham 017B,E01005328,978,564,414,174,43,197
2011,Oldham 017C,E01005331,1128,763,365,202,50,113
2011,Oldham 017D,E01005334,1111,888,223,120,58,45
2011,Oldham 017E,E01005338,1115,639,476,169,57,250
2011,Oldham 018A,E01005387,1108,826,282,169,40,73
2011,Oldham 018B,E01005388,980,688,292,169,41,82
2011,Oldham 018C,E01005389,1166,822,344,132,45,167
2011,Oldham 018D,E01005418,1139,845,294,197,47,50
2011,Oldham 019A,E01005428,1121,650,471,66,77,328
2011,Oldham 019B,E01005431,1196,812,384,146,46,192
2011,Oldham 019C,E01005450,1108,680,428,81,64,283
2011,Oldham 019D,E01005451,959,661,298,108,54,136
2011,Oldham 020C,E01005408,1316,953,363,250,52,61
2011,Oldham 020D,E01005409,1217,890,327,202,66,59
2011,Oldham 020E,E01032922,1788,1241,547,364,82,101
2011,Oldham 021A,E01005406,1059,766,293,199,42,52
2011,Oldham 021B,E01005413,1196,911,285,190,40,55
2011,Oldham 021C,E01005419,1158,884,274,162,47,65
2011,Oldham 021D,E01005420,1210,849,361,208,51,102
2011,Oldham 022A,E01005321,1086,632,454,99,90,265
2011,Oldham 022B,E01005326,1848,894,954,126,238,590
2011,Oldham 022C,E01005427,1230,590,640,58,129,453
2011,Oldham 022D,E01005429,1147,572,575,41,127,407
2011,Oldham 022E,E01005430,1526,867,659,92,138,429
2011,Oldham 024A,E01005320,1233,703,530,116,113,301
2011,Oldham 024B,E01005434,978,611,367,78,58,231
2011,Oldham 024C,E01005437,1263,776,487,76,123,288
2011,Oldham 024D,E01005459,841,378,463,97,88,278
2011,Oldham 026A,E01005383,1286,828,458,123,58,277
2011,Oldham 026D,E01005386,964,579,385,122,52,211
2011,Oldham 026E,E01032556,1084,795,289,176,34,79
2011,Oldham 026F,E01032557,1124,598,526,152,51,323
2011,Oldham 027A,E01005342,934,575,359,166,37,156
2011,Oldham 027B,E01005343,971,658,313,136,48,129
2011,Oldham 027C,E01005344,1073,749,324,130,35,159
2011,Oldham 027D,E01005381,1016,558,458,131,71,256
2011,Oldham 028A,E01005332,1625,1122,503,219,91,193
2011,Oldham 028B,E01005341,1080,811,269,139,44,86
2011,Oldham 028C,E01005345,1107,821,286,146,45,95
2011,Oldham 028D,E01005346,1084,760,324,202,30,92
2011,Oldham 028E,E01005347,980,718,262,115,37,110
2011,Oldham 029A,E01005322,888,492,396,73,70,253
2011,Oldham 029B,E01005323,1005,659,346,130,48,168
2011,Oldham 029C,E01005324,997,607,390,124,57,209
2011,Oldham 029D,E01005325,668,384,284,88,37,159
2011,Oldham 029E,E01005438,1628,1156,472,159,84,229
2011,Oldham 030A,E01005377,943,531,412,94,66,252
2011,Oldham 030B,E01005379,808,506,302,79,49,174
2011,Oldham 030C,E01005380,1017,658,359,74,72,213
2011,Oldham 030D,E01005382,1041,672,369,132,50,187
2011,Oldham 030E,E01005439,1089,758,331,174,49,108
2011,Oldham 031A,E01005362,1119,783,336,197,34,105
2011,Oldham 031B,E01005364,1227,885,342,228,52,62
2011,Oldham 031C,E01005368,1140,845,295,130,46,119
2011,Oldham 031D,E01005376,888,594,294,103,48,143
2011,Oldham 031E,E01005378,1119,788,331,157,42,132
2011,Oldham 032A,E01005363,1132,802,330,144,53,133
2011,Oldham 032B,E01005369,1077,737,340,146,51,143
2011,Oldham 032C,E01005370,1010,603,407,197,46,164
2011,Oldham 032D,E01005371,974,713,261,88,40,133
2011,Oldham 033A,E01005365,1122,834,288,181,46,61
2011,Oldham 033B,E01005366,1069,718,351,187,41,123
2011,Oldham 033C,E01005367,1076,779,297,201,34,62
2011,Oldham 033D,E01005440,1034,731,303,145,35,123
2011,Oldham 034A,E01005372,854,604,250,118,45,87
2011,Oldham 034B,E01005373,887,586,301,219,23,59
2011,Oldham 034C,E01005374,1031,709,322,189,35,98
2011,Oldham 034D,E01005375,1054,718,336,241,40,55
2011,Oldham 035A,E01005435,1232,754,478,54,109,315
2011,Oldham 035B,E01005436,1131,708,423,106,102,215
2011,Oldham 035C,E01005460,1538,871,667,165,117,385
2011,Oldham 035D,E01005461,1531,812,719,77,174,468
2011,Oldham 035E,E01005462,1251,728,523,102,151,270
2011,Oldham 035F,E01005463,746,398,348,51,42,255
2011,Oldham 035G,E01032921,1730,888,842,121,147,574
2011,Rochdale 001A,E01005518,1055,719,336,165,50,121
2011,Rochdale 001B,E01005520,1285,904,381,202,46,133
2011,Rochdale 001C,E01005522,973,703,270,123,44,103
2011,Rochdale 001D,E01005523,1416,1048,368,188,60,120
2011,Rochdale 002A,E01005519,1131,841,290,144,47,99
2011,Rochdale 002B,E01005594,1100,791,309,165,52,92
2011,Rochdale 002C,E01005597,1182,875,307,186,43,78
2011,Rochdale 002D,E01005598,1208,837,371,260,51,60
2011,Rochdale 003A,E01005516,1051,765,286,177,41,68
2011,Rochdale 003B,E01005517,1133,721,412,286,47,79
2011,Rochdale 003C,E01005521,1077,788,289,173,29,87
2011,Rochdale 003D,E01005596,1417,1053,364,191,63,110
2011,Rochdale 004A,E01005578,930,503,427,100,84,243
2011,Rochdale 004B,E01005579,1036,526,510,79,88,343
2011,Rochdale 004C,E01005586,1039,514,525,209,57,259
2011,Rochdale 004D,E01005593,1064,730,334,95,65,174
2011,Rochdale 004E,E01005595,1004,564,440,175,40,225
2011,Rochdale 005A,E01005489,875,592,283,176,38,69
2011,Rochdale 005B,E01005490,1168,558,610,95,56,459
2011,Rochdale 005C,E01005491,1080,743,337,178,40,119
2011,Rochdale 005D,E01005493,1240,901,339,217,52,70
2011,Rochdale 005E,E01005494,1265,937,328,149,64,115
2011,Rochdale 005F,E01005495,1176,765,411,189,75,147
2011,Rochdale 006A,E01005488,1118,901,217,107,48,62
2011,Rochdale 006B,E01005492,1174,826,348,216,51,81
2011,Rochdale 006C,E01005499,1153,859,294,175,41,78
2011,Rochdale 006D,E01005571,1218,906,312,190,50,72
2011,Rochdale 007A,E01005570,943,639,304,203,40,61
2011,Rochdale 007B,E01005572,1212,883,329,187,58,84
2011,Rochdale 007C,E01005573,1090,801,289,169,53,67
2011,Rochdale 007D,E01005574,1273,874,399,235,73,91
2011,Rochdale 007E,E01005587,1086,845,241,99,78,64
2011,Rochdale 007F,E01005588,944,569,375,198,55,122
2011,Rochdale 008A,E01005580,1081,706,375,97,72,206
2011,Rochdale 008B,E01005581,1030,566,464,125,67,272
2011,Rochdale 008D,E01005583,1141,561,580,121,117,342
2011,Rochdale 008F,E01005585,982,591,391,76,74,241
2011,Rochdale 008G,E01033258,1979,1019,960,117,199,644
2011,Rochdale 009A,E01005496,977,619,358,112,66,180
2011,Rochdale 009B,E01005589,1149,831,318,134,54,130
2011,Rochdale 009C,E01005590,1115,630,485,99,100,286
2011,Rochdale 009D,E01005591,1014,719,295,168,40,87
2011,Rochdale 009E,E01005592,1060,636,424,119,83,222
2011,Rochdale 010A,E01005472,1048,663,385,125,50,210
2011,Rochdale 010B,E01005473,1030,592,438,83,99,256
2011,Rochdale 010C,E01005482,1630,890,740,141,88,511
2011,Rochdale 010D,E01005483,1370,772,598,113,111,374
2011,Rochdale 010E,E01005484,1499,813,686,135,128,423
2011,Rochdale 010F,E01005486,1044,628,416,73,63,280
2011,Rochdale 010G,E01005487,1161,723,438,104,80,254
2011,Rochdale 011A,E01005474,891,585,306,173,25,108
2011,Rochdale 011B,E01005575,1188,782,406,265,53,88
2011,Rochdale 011C,E01005576,1106,695,411,275,56,80
2011,Rochdale 011D,E01005577,1072,783,289,181,46,62
2011,Rochdale 012A,E01005469,1299,927,372,185,68,119
2011,Rochdale 012B,E01005563,1210,719,491,121,118,252
2011,Rochdale 012C,E01005565,1095,695,400,95,80,225
2011,Rochdale 012D,E01005566,1440,968,472,103,99,270
2011,Rochdale 012E,E01005568,1129,538,591,104,93,394
2011,Rochdale 012F,E01005569,1123,664,459,139,82,238
2011,Rochdale 013A,E01005556,1190,900,290,169,47,74
2011,Rochdale 013B,E01005559,1101,677,424,157,57,210
2011,Rochdale 013C,E01005560,1148,771,377,233,57,87
2011,Rochdale 013D,E01005567,1110,788,322,144,51,127
2011,Rochdale 014A,E01005555,1043,769,274,160,58,56
2011,Rochdale 014B,E01005557,933,600,333,230,38,65
2011,Rochdale 014C,E01005558,1240,883,357,192,41,124
2011,Rochdale 014D,E01005561,1034,749,285,176,35,74
2011,Rochdale 014E,E01005562,1116,797,319,151,46,122
2011,Rochdale 015A,E01005470,1141,619,522,76,115,331
2011,Rochdale 015B,E01005471,1096,635,461,99,93,269
2011,Rochdale 015C,E01005475,1140,637,503,123,93,287
2011,Rochdale 015D,E01005485,1524,748,776,125,180,471
2011,Rochdale 015E,E01005564,1292,721,571,93,121,357
2011,Rochdale 016A,E01005464,1161,703,458,110,77,271
2011,Rochdale 016B,E01005465,1234,885,349,157,57,135
2011,Rochdale 016C,E01005466,1630,938,692,156,101,435
2011,Rochdale 016D,E01005467,1215,708,507,176,51,280
2011,Rochdale 016E,E01005468,1167,851,316,191,47,78
2011,Rochdale 017A,E01005476,1210,875,335,177,41,117
2011,Rochdale 017B,E01005477,1231,848,383,150,60,173
2011,Rochdale 017C,E01005478,1186,792,394,220,47,127
2011,Rochdale 017D,E01005479,1299,878,421,205,59,157
2011,Rochdale 017E,E01005480,1188,724,464,250,55,159
2011,Rochdale 017F,E01005481,1158,747,411,155,72,184
2011,Rochdale 018A,E01005497,1126,732,394,135,73,186
2011,Rochdale 018B,E01005501,1099,661,438,209,26,203
2011,Rochdale 018C,E01005502,1127,781,346,181,24,141
2011,Rochdale 018D,E01005504,1084,739,345,146,56,143
2011,Rochdale 018E,E01005505,1272,896,376,167,48,161
2011,Rochdale 018F,E01005509,1370,889,481,150,55,276
2011,Rochdale 019A,E01005510,886,632,254,165,30,59
2011,Rochdale 019B,E01005511,953,710,243,133,30,80
2011,Rochdale 019C,E01005512,1155,814,341,163,42,136
2011,Rochdale 019D,E01005513,954,600,354,116,39,199
2011,Rochdale 019E,E01005514,1102,732,370,138,52,180
2011,Rochdale 019F,E01005515,1154,694,460,139,69,252
2011,Rochdale 020A,E01005498,1078,754,324,126,59,139
2011,Rochdale 020B,E01005500,1178,866,312,157,48,107
2011,Rochdale 020C,E01005503,1017,733,284,194,40,50
2011,Rochdale 020D,E01005506,1124,747,377,190,39,148
2011,Rochdale 020E,E01005507,1187,887,300,137,50,113
2011,Rochdale 020F,E01005508,1412,1036,376,223,63,90
2011,Rochdale 021A,E01005524,1132,830,302,146,46,110
2011,Rochdale 021B,E01005525,1150,742,408,137,48,223
2011,Rochdale 021C,E01005526,1167,809,358,124,57,177
2011,Rochdale 021D,E01005528,1073,717,356,152,48,156
2011,Rochdale 021E,E01005536,1166,842,324,115,60,149
2011,Rochdale 021F,E01005543,970,694,276,147,45,84
2011,Rochdale 022A,E01005527,1058,594,464,145,78,241
2011,Rochdale 022B,E01005529,1176,723,453,175,54,224
2011,Rochdale 022C,E01005551,1206,712,494,163,49,282
2011,Rochdale 022D,E01005552,1360,766,594,146,75,373
2011,Rochdale 022E,E01005553,1326,832,494,174,73,247
2011,Rochdale 022F,E01005554,1007,705,302,134,42,126
2011,Rochdale 023A,E01005534,1094,799,295,107,71,117
2011,Rochdale 023B,E01005535,1243,880,363,159,69,135
2011,Rochdale 023C,E01005537,1097,829,268,160,43,65
2011,Rochdale 023D,E01005538,1034,713,321,102,60,159
2011,Rochdale 023E,E01005540,1048,784,264,126,35,103
2011,Rochdale 023F,E01005541,1231,926,305,106,50,149
2011,Rochdale 023G,E01005542,928,617,311,141,29,141
2011,Rochdale 024A,E01005533,1273,913,360,189,39,132
2011,Rochdale 024B,E01005539,1044,701,343,150,30,163
2011,Rochdale 024C,E01005546,948,645,303,169,29,105
2011,Rochdale 024D,E01005547,1087,778,309,132,38,139
2011,Rochdale 024E,E01005548,964,657,307,119,38,150
2011,Rochdale 025A,E01005530,996,699,297,216,29,52
2011,Rochdale 025B,E01005531,866,640,226,109,35,82
2011,Rochdale 025C,E01005532,1028,674,354,133,50,171
2011,Rochdale 025D,E01005544,1054,759,295,187,50,58
2011,Rochdale 025E,E01005545,865,620,245,143,32,70
2011,Rochdale 025F,E01005549,1124,805,319,199,57,63
2011,Rochdale 025G,E01005550,983,656,327,220,34,73
2011,Salford 001A,E01005659,1024,684,340,142,55,143
2011,Salford 001B,E01005660,949,565,384,122,43,219
2011,Salford 001C,E01005663,988,662,326,124,38,164
2011,Salford 001D,E01005664,987,564,423,117,61,245
2011,Salford 001E,E01005665,969,539,430,126,61,243
2011,Salford 002A,E01005703,1096,678,418,139,61,218
2011,Salford 002B,E01005704,1039,702,337,149,52,136
2011,Salford 002C,E01005706,996,635,361,137,35,189
2011,Salford 002D,E01005708,1076,714,362,157,47,158
2011,Salford 003A,E01005702,1566,1123,443,185,68,190
2011,Salford 003B,E01005705,1371,1007,364,175,47,142
2011,Salford 003C,E01005707,1194,805,389,131,41,217
2011,Salford 004A,E01005661,1226,827,399,128,51,220
2011,Salford 004B,E01005662,977,571,406,114,36,256
2011,Salford 004C,E01005709,975,555,420,140,46,234
2011,Salford 004D,E01005710,1123,695,428,245,47,136
2011,Salford 005A,E01005670,1202,832,370,154,57,159
2011,Salford 005B,E01005672,1057,821,236,98,40,98
2011,Salford 005C,E01005676,990,697,293,221,23,49
2011,Salford 005D,E01005677,1129,808,321,169,37,115
2011,Salford 006A,E01005686,1081,750,331,152,50,129
2011,Salford 006B,E01005688,1127,778,349,200,41,108
2011,Salford 006C,E01005691,1091,689,402,288,35,79
2011,Salford 006D,E01005692,980,592,388,160,29,199
2011,Salford 007A,E01005711,1143,825,318,186,42,90
2011,Salford 007B,E01005712,1224,893,331,147,48,136
2011,Salford 007C,E01005713,1079,692,387,292,37,58
2011,Salford 007D,E01005714,1028,701,327,155,37,135
2011,Salford 007E,E01005715,1208,894,314,205,46,63
2011,Salford 007F,E01005718,1291,910,381,209,44,128
2011,Salford 008A,E01005673,1102,818,284,127,28,129
2011,Salford 008B,E01005675,2119,1207,912,108,49,755
2011,Salford 008C,E01005678,1095,736,359,99,52,208
2011,Salford 008D,E01005679,1077,673,404,136,44,224
2011,Salford 009A,E01005687,1274,978,296,146,36,114
2011,Salford 009B,E01005689,935,566,369,95,56,218
2011,Salford 009C,E01005690,1180,799,381,222,38,121
2011,Salford 009D,E01005693,1056,772,284,185,29,70
2011,Salford 010A,E01005646,894,607,287,58,83,146
2011,Salford 010B,E01005649,1035,698,337,108,81,148
2011,Salford 010C,E01005650,954,551,403,111,86,206
2011,Salford 010D,E01005651,1146,633,513,65,169,279
2011,Salford 011A,E01005647,1156,702,454,124,214,116
2011,Salford 011B,E01005648,1396,1008,388,178,63,147
2011,Salford 011C,E01005652,980,672,308,97,36,175
2011,Salford 011D,E01005653,1073,642,431,94,74,263
2011,Salford 012A,E01005671,1069,704,365,160,37,168
2011,Salford 012B,E01005674,1051,746,305,125,41,139
2011,Salford 012C,E01005694,1240,953,287,149,39,99
2011,Salford 012D,E01005696,1132,829,303,147,46,110
2011,Salford 012E,E01005698,1147,716,431,163,52,216
2011,Salford 012F,E01005700,1158,829,329,170,39,120
2011,Salford 013A,E01005716,1351,1028,323,186,53,84
2011,Salford 013B,E01005717,1124,914,210,98,43,69
2011,Salford 013C,E01005734,994,737,257,148,31,78
2011,Salford 013D,E01005735,1035,768,267,186,32,49
2011,Salford 013E,E01005736,1115,805,310,223,28,59
2011,Salford 013F,E01005737,1101,786,315,207,33,75
2011,Salford 013G,E01005739,1132,864,268,157,46,65
2011,Salford 014A,E01005695,1119,838,281,183,42,56
2011,Salford 014B,E01005697,1128,824,304,203,40,61
2011,Salford 014C,E01005738,1250,925,325,234,35,56
2011,Salford 014D,E01005740,1125,853,272,203,29,40
2011,Salford 014E,E01005741,1188,858,330,224,43,63
2011,Salford 014F,E01005742,1158,870,288,190,34,64
2011,Salford 015A,E01005625,979,719,260,157,28,75
2011,Salford 015B,E01005627,871,674,197,111,32,54
2011,Salford 015C,E01005699,1097,800,297,201,39,57
2011,Salford 015D,E01005701,1179,846,333,203,48,82
2011,Salford 016A,E01005609,1366,931,435,103,100,232
2011,Salford 016B,E01005611,1500,909,591,139,139,313
2011,Salford 016C,E01005612,1348,709,639,206,67,366
2011,Salford 016D,E01005613,1568,883,685,111,129,445
2011,Salford 016E,E01005614,985,593,392,60,95,237
2011,Salford 016F,E01005615,1334,807,527,149,92,286
2011,Salford 017A,E01005624,1170,712,458,148,51,259
2011,Salford 017B,E01005680,1095,634,461,106,66,289
2011,Salford 017C,E01005683,1144,574,570,145,71,354
2011,Salford 017F,E01032919,3110,1710,1400,148,921,331
2011,Salford 018A,E01005622,1059,807,252,103,44,105
2011,Salford 018B,E01005623,981,745,236,129,45,62
2011,Salford 018C,E01005626,980,718,262,150,39,73
2011,Salford 018D,E01005628,1272,899,373,140,102,131
2011,Salford 019A,E01005725,931,540,391,112,58,221
2011,Salford 019B,E01005726,1088,793,295,115,52,128
2011,Salford 019C,E01005727,1057,814,243,77,49,117
2011,Salford 019D,E01005728,991,721,270,181,32,57
2011,Salford 019E,E01005733,946,583,363,112,54,197
2011,Salford 020A,E01005631,1177,650,527,222,24,281
2011,Salford 020B,E01005632,1528,1132,396,114,72,210
2011,Salford 020C,E01005633,1005,676,329,133,45,151
2011,Salford 020D,E01005634,1124,871,253,163,26,64
2011,Salford 020E,E01005635,1177,878,299,149,41,109
2011,Salford 020F,E01005636,1158,847,311,165,52,94
2011,Salford 020G,E01005637,1011,725,286,142,34,110
2011,Salford 021A,E01005629,967,669,298,163,39,96
2011,Salford 021B,E01005630,1069,796,273,133,45,95
2011,Salford 021C,E01005719,1377,923,454,186,84,184
2011,Salford 021D,E01005720,1824,1314,510,156,91,263
2011,Salford 021E,E01005722,1257,808,449,131,86,232
2011,Salford 021F,E01005723,1045,706,339,106,57,176
2011,Salford 021G,E01005724,1076,779,297,201,42,54
2011,Salford 022D,E01005610,923,414,509,109,184,216
2011,Salford 022E,E01032684,1651,1077,574,36,426,112
2011,Salford 022F,E01032687,1241,1025,216,27,128,61
2011,Salford 022G,E01032906,1141,855,286,36,112,138
2011,Salford 022H,E01032907,1043,752,291,36,107,148
2011,Salford 022I,E01032909,1295,1090,205,9,156,40
2011,Salford 022J,E01032911,1081,920,161,7,97,57
2011,Salford 022K,E01033330,1154,735,419,108,62,249
2011,Salford 023A,E01005654,1171,915,256,74,40,142
2011,Salford 023B,E01005656,1101,739,362,104,65,193
2011,Salford 023C,E01005657,1074,712,362,139,55,168
2011,Salford 023D,E01005721,1096,670,426,179,92,155
2011,Salford 024A,E01005655,1078,644,434,58,118,258
2011,Salford 024B,E01005658,999,523,476,139,58,279
2011,Salford 024C,E01005681,1404,658,746,119,415,212
2011,Salford 024D,E01005682,1229,694,535,134,45,356
2011,Salford 025A,E01005729,987,562,425,98,41,286
2011,Salford 025B,E01005730,1208,909,299,127,53,119
2011,Salford 025C,E01005731,1062,669,393,112,72,209
2011,Salford 025D,E01005732,869,526,343,138,35,170
2011,Salford 026A,E01005599,1230,781,449,154,42,253
2011,Salford 026B,E01005600,1074,757,317,96,50,171
2011,Salford 026C,E01005601,1077,685,392,124,62,206
2011,Salford 026D,E01005602,1058,682,376,134,33,209
2011,Salford 027A,E01005603,1140,842,298,84,63,151
2011,Salford 027B,E01005604,1136,801,335,181,24,130
2011,Salford 027C,E01005605,1065,758,307,137,35,135
2011,Salford 027D,E01005638,1169,830,339,104,26,209
2011,Salford 028B,E01005667,1369,839,530,149,84,297
2011,Salford 028E,E01032685,1425,1213,212,39,96,77
2011,Salford 028F,E01032686,1357,1203,154,18,95,41
2011,Salford 028G,E01032912,1144,679,465,138,69,258
2011,Salford 028H,E01032914,1476,1259,217,22,86,109
2011,Salford 028I,E01032915,1126,722,404,85,85,234
2011,Salford 028J,E01032917,937,750,187,37,62,88
2011,Salford 029A,E01005639,980,567,413,109,46,258
2011,Salford 029B,E01005640,978,658,320,119,52,149
2011,Salford 029C,E01005641,1014,708,306,173,28,105
2011,Salford 029D,E01005642,910,705,205,116,31,58
2011,Salford 029E,E01005643,1009,657,352,260,27,65
2011,Salford 029F,E01005644,1184,936,248,132,28,88
2011,Salford 029G,E01005645,1118,767,351,265,32,54
2011,Salford 030A,E01005616,1044,685,359,157,41,161
2011,Salford 030B,E01005617,1131,816,315,173,39,103
2011,Salford 030C,E01005618,1028,703,325,156,33,136
2011,Salford 030D,E01005619,959,666,293,124,37,132
2011,Salford 030E,E01005620,1840,1469,371,160,60,151
2011,Salford 030F,E01005621,1211,891,320,169,39,112
2011,Stockport 001A,E01005886,1124,824,300,110,47,143
2011,Stockport 001B,E01005888,1098,810,288,130,48,110
2011,Stockport 001C,E01005889,1030,721,309,162,38,109
2011,Stockport 001D,E01005891,1041,728,313,214,36,63
2011,Stockport 001E,E01005894,1044,769,275,154,30,91
2011,Stockport 002A,E01005887,1040,701,339,100,49,190
2011,Stockport 002B,E01005890,1022,684,338,117,53,168
2011,Stockport 002C,E01005893,1288,997,291,140,41,110
2011,Stockport 002D,E01005896,1269,986,283,115,44,124
2011,Stockport 002E,E01005919,1084,747,337,114,58,165
2011,Stockport 003A,E01005862,1160,863,297,162,55,80
2011,Stockport 003B,E01005892,987,701,286,154,38,94
2011,Stockport 003C,E01005895,828,583,245,120,35,90
2011,Stockport 003D,E01005920,1163,886,277,136,60,81
2011,Stockport 003E,E01005921,1057,776,281,120,44,117
2011,Stockport 003F,E01005922,1065,777,288,170,39,79
2011,Stockport 004A,E01005753,1082,616,466,127,59,280
2011,Stockport 004B,E01005754,1313,791,522,122,44,356
2011,Stockport 004C,E01005755,1105,713,392,97,46,249
2011,Stockport 004D,E01005756,1080,637,443,83,51,309
2011,Stockport 005A,E01005745,1113,821,292,145,55,92
2011,Stockport 005B,E01005746,1028,583,445,241,33,171
2011,Stockport 005C,E01005747,1112,825,287,187,38,62
2011,Stockport 005D,E01005748,1109,735,374,270,44,60
2011,Stockport 006A,E01005863,1285,990,295,140,57,98
2011,Stockport 006B,E01005864,1086,863,223,118,39,66
2011,Stockport 006C,E01005866,1343,1041,302,126,51,125
2011,Stockport 006D,E01005869,1099,786,313,172,54,87
2011,Stockport 007A,E01005914,1058,761,297,160,36,101
2011,Stockport 007B,E01005915,1103,832,271,112,29,130
2011,Stockport 007C,E01005916,1204,892,312,153,39,120
2011,Stockport 007D,E01005917,1256,944,312,139,34,139
2011,Stockport 008A,E01005859,1049,804,245,119,53,73
2011,Stockport 008B,E01005865,1056,735,321,179,70,72
2011,Stockport 008C,E01005867,1004,734,270,169,43,58
2011,Stockport 008D,E01005868,1041,741,300,153,80,67
2011,Stockport 009A,E01005743,1030,705,325,223,30,72
2011,Stockport 009B,E01005744,1024,693,331,181,33,117
2011,Stockport 009C,E01005749,1256,962,294,165,37,92
2011,Stockport 009D,E01005750,1256,971,285,155,32,98
2011,Stockport 009E,E01005751,996,758,238,122,24,92
2011,Stockport 010A,E01005897,1059,762,297,138,36,123
2011,Stockport 010B,E01005898,1186,782,404,249,47,108
2011,Stockport 010C,E01005900,1124,733,391,223,46,122
2011,Stockport 010D,E01005903,1027,687,340,245,38,57
2011,Stockport 010E,E01005904,1020,745,275,177,46,52
2011,Stockport 011A,E01005853,1130,807,323,116,57,150
2011,Stockport 011B,E01005856,1193,894,299,143,66,90
2011,Stockport 011C,E01005860,1040,783,257,158,47,52
2011,Stockport 011D,E01005861,1134,802,332,195,40,97
2011,Stockport 012A,E01005752,1005,693,312,120,54,138
2011,Stockport 012B,E01005899,1099,695,404,271,39,94
2011,Stockport 012C,E01005901,1051,673,378,278,34,66
2011,Stockport 012D,E01005902,1136,764,372,161,35,176
2011,Stockport 012E,E01005905,966,663,303,93,40,170
2011,Stockport 013A,E01005852,1187,880,307,146,76,85
2011,Stockport 013B,E01005854,1202,940,262,159,44,59
2011,Stockport 013C,E01005855,1105,821,284,139,86,59
2011,Stockport 013D,E01005857,1145,828,317,133,84,100
2011,Stockport 013E,E01005858,1205,942,263,165,37,61
2011,Stockport 014A,E01005757,1163,901,262,106,39,117
2011,Stockport 014B,E01005758,1522,902,620,215,40,365
2011,Stockport 014C,E01005766,1145,779,366,135,48,183
2011,Stockport 014D,E01005918,1158,648,510,148,25,337
2011,Stockport 015A,E01005870,1009,775,234,101,40,93
2011,Stockport 015B,E01005871,1011,786,225,122,26,77
2011,Stockport 015C,E01005873,1084,825,259,143,46,70
2011,Stockport 015D,E01005875,1185,910,275,175,36,64
2011,Stockport 016A,E01005764,1200,934,266,119,28,119
2011,Stockport 016B,E01005816,1177,947,230,79,50,101
2011,Stockport 016C,E01005817,1035,814,221,103,29,89
2011,Stockport 016D,E01005822,1192,818,374,114,40,220
2011,Stockport 017A,E01005880,1080,791,289,189,33,67
2011,Stockport 017B,E01005881,934,635,299,210,42,47
2011,Stockport 017C,E01005883,1121,751,370,271,37,62
2011,Stockport 017D,E01005908,1117,780,337,228,54,55
2011,Stockport 018A,E01005765,1027,813,214,112,32,70
2011,Stockport 018B,E01005818,994,733,261,80,41,140
2011,Stockport 018C,E01005819,1190,910,280,139,47,94
2011,Stockport 018D,E01005820,1059,818,241,111,35,95
2011,Stockport 018E,E01005821,1113,827,286,131,44,111
2011,Stockport 018F,E01005823,1212,931,281,102,51,128
2011,Stockport 019A,E01005825,1159,916,243,109,38,96
2011,Stockport 019B,E01005872,1282,953,329,162,33,134
2011,Stockport 019C,E01005874,1287,888,399,130,45,224
2011,Stockport 019D,E01005876,1122,840,282,153,40,89
2011,Stockport 019E,E01005877,1028,755,273,148,30,95
2011,Stockport 020A,E01005878,960,652,308,162,28,118
2011,Stockport 020B,E01005879,947,648,299,167,33,99
2011,Stockport 020C,E01005882,981,658,323,224,32,67
2011,Stockport 020D,E01005884,1073,747,326,212,60,54
2011,Stockport 020E,E01005885,925,669,256,137,24,95
2011,Stockport 021A,E01005832,1069,805,264,141,39,84
2011,Stockport 021B,E01005833,757,531,226,139,23,64
2011,Stockport 021C,E01005835,1057,765,292,199,43,50
2011,Stockport 021D,E01005837,1204,931,273,152,37,84
2011,Stockport 021E,E01005843,1164,880,284,176,40,68
2011,Stockport 022A,E01005769,1079,847,232,113,48,71
2011,Stockport 022B,E01005778,1107,865,242,138,37,67
2011,Stockport 022C,E01005779,1057,809,248,140,46,62
2011,Stockport 022D,E01005780,1065,837,228,81,45,102
2011,Stockport 022E,E01005781,1104,694,410,194,35,181
2011,Stockport 023A,E01005759,1271,997,274,118,42,114
2011,Stockport 023B,E01005760,1360,1037,323,119,54,150
2011,Stockport 023C,E01005797,1080,817,263,99,53,111
2011,Stockport 023D,E01005800,1186,877,309,173,59,77
2011,Stockport 023E,E01005804,812,575,237,100,45,92
2011,Stockport 024A,E01005824,1080,797,283,153,46,84
2011,Stockport 024B,E01005826,949,568,381,169,39,173
2011,Stockport 024C,E01005827,1053,727,326,220,32,74
2011,Stockport 024D,E01005828,889,567,322,107,27,188
2011,Stockport 024E,E01005829,890,600,290,125,35,130
2011,Stockport 025A,E01005768,1127,762,365,190,80,95
2011,Stockport 025B,E01005770,973,686,287,166,54,67
2011,Stockport 025C,E01005771,961,749,212,111,38,63
2011,Stockport 025D,E01005775,1057,776,281,161,52,68
2011,Stockport 026A,E01005761,988,684,304,94,51,159
2011,Stockport 026B,E01005762,1050,601,449,131,52,266
2011,Stockport 026C,E01005763,1149,790,359,120,48,191
2011,Stockport 026D,E01005799,1201,822,379,61,66,252
2011,Stockport 027A,E01005798,1090,749,341,187,55,99
2011,Stockport 027B,E01005801,1093,816,277,130,42,105
2011,Stockport 027C,E01005802,1136,868,268,135,63,70
2011,Stockport 027D,E01005803,1076,798,278,176,50,52
2011,Stockport 027E,E01005830,1090,791,299,183,47,69
2011,Stockport 027F,E01005831,1143,884,259,130,45,84
2011,Stockport 028A,E01005767,1057,625,432,286,69,77
2011,Stockport 028B,E01005772,1003,653,350,168,78,104
2011,Stockport 028C,E01005773,1052,759,293,156,65,72
2011,Stockport 028D,E01005774,975,595,380,174,51,155
2011,Stockport 028E,E01005776,1110,752,358,163,93,102
2011,Stockport 029A,E01005909,1127,744,383,256,67,60
2011,Stockport 029B,E01005910,1087,748,339,170,40,129
2011,Stockport 029C,E01005911,962,651,311,225,38,48
2011,Stockport 029D,E01005912,1035,713,322,243,25,54
2011,Stockport 030A,E01005782,922,656,266,186,27,53
2011,Stockport 030B,E01005783,1114,768,346,224,41,81
2011,Stockport 030C,E01005784,969,655,314,181,50,83
2011,Stockport 030D,E01005785,1108,842,266,161,46,59
2011,Stockport 030E,E01005786,1109,838,271,171,51,49
2011,Stockport 031A,E01005834,1106,807,299,130,51,118
2011,Stockport 031B,E01005836,1308,900,408,274,35,99
2011,Stockport 031C,E01005838,1252,976,276,129,39,108
2011,Stockport 031D,E01005840,1087,836,251,118,33,100
2011,Stockport 032A,E01005927,973,713,260,146,58,56
2011,Stockport 032B,E01005928,1108,807,301,154,47,100
2011,Stockport 032C,E01005929,958,642,316,216,50,50
2011,Stockport 032D,E01005930,1098,722,376,244,70,62
2011,Stockport 033A,E01005806,858,618,240,184,31,25
2011,Stockport 033B,E01005813,1113,794,319,205,50,64
2011,Stockport 033C,E01005814,970,639,331,228,47,56
2011,Stockport 033D,E01005815,1028,719,309,213,39,57
2011,Stockport 034A,E01005777,1088,767,321,184,46,91
2011,Stockport 034B,E01005787,991,688,303,201,56,46
2011,Stockport 034C,E01005788,1084,825,259,163,33,63
2011,Stockport 034D,E01005790,899,656,243,100,52,91
2011,Stockport 035A,E01005805,1092,839,253,159,47,47
2011,Stockport 035B,E01005807,1126,794,332,222,44,66
2011,Stockport 035C,E01005839,1003,666,337,250,37,50
2011,Stockport 035D,E01005841,1061,754,307,204,42,61
2011,Stockport 036A,E01005844,1060,654,406,188,62,156
2011,Stockport 036B,E01005845,1162,790,372,193,69,110
2011,Stockport 036C,E01005849,1139,805,334,195,60,79
2011,Stockport 036D,E01005851,1060,719,341,192,58,91
2011,Stockport 037A,E01005808,954,647,307,189,55,63
2011,Stockport 037B,E01005809,916,651,265,175,41,49
2011,Stockport 037C,E01005810,1070,699,371,234,46,91
2011,Stockport 037D,E01005811,1060,800,260,157,49,54
2011,Stockport 037E,E01005812,917,628,289,180,52,57
2011,Stockport 038A,E01005842,1135,817,318,226,32,60
2011,Stockport 038B,E01005906,1035,652,383,291,36,56
2011,Stockport 038C,E01005907,874,555,319,249,22,48
2011,Stockport 038D,E01005913,1039,701,338,248,36,54
2011,Stockport 039A,E01005789,1116,813,303,175,50,78
2011,Stockport 039B,E01005791,1104,816,288,184,35,69
2011,Stockport 039C,E01005793,1037,758,279,174,30,75
2011,Stockport 039D,E01005795,943,668,275,195,35,45
2011,Stockport 039E,E01005796,939,682,257,160,43,54
2011,Stockport 040A,E01005846,1164,809,355,192,62,101
2011,Stockport 040B,E01005847,1161,841,320,163,65,92
2011,Stockport 040C,E01005848,1358,923,435,230,109,96
2011,Stockport 040D,E01005850,1260,900,360,181,49,130
2011,Stockport 041A,E01005792,1032,761,271,202,29,40
2011,Stockport 041B,E01005794,915,647,268,174,46,48
2011,Stockport 041C,E01005923,1064,707,357,249,45,63
2011,Stockport 041D,E01005931,976,687,289,205,41,43
2011,Stockport 042A,E01005924,885,631,254,168,46,40
2011,Stockport 042B,E01005925,934,613,321,202,50,69
2011,Stockport 042C,E01005926,899,652,247,146,51,50
2011,Stockport 042D,E01005932,1008,673,335,237,50,48
2011,Tameside 001A,E01006053,1466,1124,342,222,51,69
2011,Tameside 001B,E01006054,1148,728,420,223,36,161
2011,Tameside 001C,E01006055,1108,890,218,129,22,67
2011,Tameside 001D,E01006057,1135,886,249,136,47,66
2011,Tameside 001E,E01006058,1515,1167,348,168,38,142
2011,Tameside 001F,E01006059,1077,822,255,151,38,66
2011,Tameside 002A,E01005938,1192,779,413,197,63,153
2011,Tameside 002B,E01005939,1036,643,393,247,64,82
2011,Tameside 002C,E01005940,1124,716,408,258,45,105
2011,Tameside 002D,E01005955,1278,963,315,177,60,78
2011,Tameside 003A,E01006056,824,531,293,92,40,161
2011,Tameside 003B,E01006061,1718,1199,519,209,78,232
2011,Tameside 003C,E01006062,1589,1207,382,258,48,76
2011,Tameside 003D,E01006063,1158,852,306,176,49,81
2011,Tameside 004A,E01005936,1140,774,366,208,52,106
2011,Tameside 004B,E01005937,1095,686,409,200,47,162
2011,Tameside 004C,E01005945,1323,820,503,157,73,273
2011,Tameside 004D,E01005946,1216,857,359,150,59,150
2011,Tameside 004E,E01005947,1173,765,408,135,56,217
2011,Tameside 005A,E01005954,1098,693,405,226,30,149
2011,Tameside 005B,E01005956,1087,782,305,179,35,91
2011,Tameside 005C,E01005957,1059,749,310,144,51,115
2011,Tameside 005D,E01005958,1052,680,372,148,54,170
2011,Tameside 005E,E01005959,1189,742,447,146,80,221
2011,Tameside 006A,E01005933,1028,618,410,108,66,236
2011,Tameside 006B,E01005934,1080,750,330,162,52,116
2011,Tameside 006C,E01005935,1033,602,431,154,59,218
2011,Tameside 006D,E01005949,1182,787,395,185,57,153
2011,Tameside 006E,E01005960,1167,799,368,127,53,188
2011,Tameside 007A,E01005941,1230,762,468,151,55,262
2011,Tameside 007B,E01005942,1231,900,331,172,61,98
2011,Tameside 007C,E01005943,1359,1027,332,163,49,120
2011,Tameside 007D,E01005944,1110,775,335,152,45,138
2011,Tameside 008A,E01006060,1052,697,355,108,40,207
2011,Tameside 008B,E01006064,1106,630,476,198,47,231
2011,Tameside 008C,E01006065,935,607,328,104,47,177
2011,Tameside 008D,E01006066,1023,744,279,111,52,116
2011,Tameside 009A,E01006067,1418,1124,294,140,61,93
2011,Tameside 009B,E01006068,1177,867,310,151,41,118
2011,Tameside 009C,E01006069,1168,772,396,124,75,197
2011,Tameside 009D,E01006073,1214,852,362,91,61,210
2011,Tameside 010A,E01005993,1044,706,338,190,46,102
2011,Tameside 010B,E01005995,1114,843,271,128,76,67
2011,Tameside 010C,E01005996,1428,1045,383,184,50,149
2011,Tameside 010D,E01005997,1099,801,298,172,35,91
2011,Tameside 010E,E01006000,1139,644,495,234,68,193
2011,Tameside 011A,E01005994,1078,783,295,122,61,112
2011,Tameside 011B,E01005999,1367,898,469,172,69,228
2011,Tameside 011C,E01006002,984,680,304,146,51,107
2011,Tameside 011D,E01006004,1152,835,317,181,44,92
2011,Tameside 011E,E01006005,955,641,314,138,39,137
2011,Tameside 011F,E01006007,1130,828,302,151,39,112
2011,Tameside 012A,E01005998,1272,931,341,157,51,133
2011,Tameside 012B,E01006001,1156,805,351,171,65,115
2011,Tameside 012C,E01006003,1082,766,316,150,47,119
2011,Tameside 012D,E01006006,1135,800,335,177,41,117
2011,Tameside 013A,E01005948,1401,905,496,112,49,335
2011,Tameside 013B,E01005950,1261,719,542,92,112,338
2011,Tameside 013C,E01005951,1143,818,325,111,40,174
2011,Tameside 013D,E01005952,1712,1005,707,169,76,462
2011,Tameside 013E,E01005953,1397,851,546,181,80,285
2011,Tameside 014A,E01005961,1060,792,268,159,38,71
2011,Tameside 014B,E01005962,1069,749,320,195,52,73
2011,Tameside 014C,E01005968,1116,807,309,199,35,75
2011,Tameside 014D,E01005969,1031,759,272,161,48,63
2011,Tameside 015A,E01006022,1242,929,313,166,41,106
2011,Tameside 015B,E01006023,1191,816,375,150,32,193
2011,Tameside 015C,E01006070,1069,808,261,150,42,69
2011,Tameside 015D,E01006071,1230,821,409,302,47,60
2011,Tameside 015E,E01006072,1334,963,371,247,60,64
2011,Tameside 016A,E01006009,1065,748,317,186,39,92
2011,Tameside 016B,E01006017,1061,767,294,215,25,54
2011,Tameside 016C,E01006018,1061,719,342,256,31,55
2011,Tameside 016D,E01006021,991,707,284,168,34,82
2011,Tameside 017A,E01006008,1098,879,219,94,44,81
2011,Tameside 017B,E01006010,958,650,308,137,27,144
2011,Tameside 017C,E01006012,1357,968,389,189,57,143
2011,Tameside 017D,E01006015,1089,837,252,121,56,75
2011,Tameside 017E,E01006016,1356,873,483,173,37,273
2011,Tameside 018A,E01006011,1151,738,413,171,53,189
2011,Tameside 018B,E01006013,948,642,306,197,32,77
2011,Tameside 018C,E01006014,923,654,269,98,46,125
2011,Tameside 018D,E01006019,1120,681,439,188,31,220
2011,Tameside 018E,E01006020,1046,717,329,155,49,125
2011,Tameside 019A,E01005963,906,671,235,136,32,67
2011,Tameside 019B,E01005964,1158,849,309,165,49,95
2011,Tameside 019C,E01005965,1026,670,356,147,40,169
2011,Tameside 019D,E01005966,1007,741,266,81,63,122
2011,Tameside 019E,E01005967,1037,678,359,149,35,175
2011,Tameside 020A,E01006031,1091,664,427,139,39,249
2011,Tameside 020B,E01006032,961,658,303,93,40,170
2011,Tameside 020C,E01006033,1043,717,326,130,38,158
2011,Tameside 020D,E01006034,1531,1086,445,160,66,219
2011,Tameside 020E,E01006035,1486,1059,427,176,59,192
2011,Tameside 020F,E01006036,1381,976,405,111,66,228
2011,Tameside 021A,E01005970,1148,777,371,226,53,92
2011,Tameside 021B,E01005972,1242,902,340,125,56,159
2011,Tameside 021C,E01005974,1172,821,351,156,48,147
2011,Tameside 021D,E01005975,1180,812,368,172,43,153
2011,Tameside 022A,E01006024,1367,1048,319,196,57,66
2011,Tameside 022B,E01006026,1176,850,326,167,38,121
2011,Tameside 022C,E01006037,1150,871,279,204,36,39
2011,Tameside 022D,E01006038,1194,816,378,225,45,108
2011,Tameside 023A,E01006047,1000,702,298,147,38,113
2011,Tameside 023B,E01006048,1121,747,374,264,33,77
2011,Tameside 023C,E01006049,1182,800,382,211,40,131
2011,Tameside 023D,E01006051,1253,875,378,209,51,118
2011,Tameside 024A,E01005985,1029,702,327,244,21,62
2011,Tameside 024B,E01005987,1099,765,334,220,31,83
2011,Tameside 024C,E01005988,1151,886,265,172,39,54
2011,Tameside 024D,E01005990,960,691,269,163,35,71
2011,Tameside 024E,E01005991,1064,781,283,156,45,82
2011,Tameside 025A,E01005971,1036,773,263,133,33,97
2011,Tameside 025B,E01005986,907,678,229,118,29,82
2011,Tameside 025C,E01005989,959,680,279,187,37,55
2011,Tameside 025D,E01005992,942,679,263,121,38,104
2011,Tameside 026A,E01005973,1102,753,349,214,52,83
2011,Tameside 026B,E01005976,1097,744,353,156,65,132
2011,Tameside 026C,E01005977,1135,802,333,195,30,108
2011,Tameside 026D,E01005978,1005,664,341,144,55,142
2011,Tameside 027A,E01006025,988,553,435,155,46,234
2011,Tameside 027B,E01006027,986,562,424,147,36,241
2011,Tameside 027C,E01006050,1203,658,545,202,65,278
2011,Tameside 027D,E01006052,1085,671,414,159,54,201
2011,Tameside 028A,E01006028,1240,754,486,219,45,222
2011,Tameside 028B,E01006029,1287,867,420,100,76,244
2011,Tameside 028C,E01006030,1309,919,390,140,57,193
2011,Tameside 028D,E01006039,958,520,438,128,103,207
2011,Tameside 028E,E01006040,1165,701,464,90,98,276
2011,Tameside 028F,E01006041,1122,840,282,110,42,130
2011,Tameside 029A,E01005979,1197,744,453,271,37,145
2011,Tameside 029B,E01005980,1017,666,351,169,46,136
2011,Tameside 029C,E01005981,1037,605,432,234,40,158
2011,Tameside 029D,E01005982,1002,592,410,218,47,145
2011,Tameside 029E,E01005983,1209,864,345,234,36,75
2011,Tameside 029F,E01005984,1108,674,434,164,52,218
2011,Tameside 030A,E01006042,1241,905,336,203,41,92
2011,Tameside 030B,E01006043,1056,731,325,169,46,110
2011,Tameside 030C,E01006044,1008,670,338,214,27,97
2011,Tameside 030D,E01006045,954,657,297,195,41,61
2011,Tameside 030E,E01006046,1061,779,282,197,23,62
2011,Trafford 001A,E01006109,1091,706,385,66,60,259
2011,Trafford 001B,E01006110,1240,813,427,94,83,250
2011,Trafford 001C,E01006111,1148,703,445,70,118,257
2011,Trafford 001D,E01006112,1183,706,477,77,115,285
2011,Trafford 001E,E01006185,1547,1070,477,96,102,279
2011,Trafford 001F,E01006188,1119,779,340,70,76,194
2011,Trafford 002A,E01006116,970,720,250,154,43,53
2011,Trafford 002B,E01006117,1214,873,341,218,50,73
2011,Trafford 002C,E01006118,1022,694,328,184,47,97
2011,Trafford 002D,E01006119,1204,894,310,200,44,66
2011,Trafford 002E,E01006121,1161,862,299,173,36,90
2011,Trafford 003A,E01006141,1131,786,345,129,49,167
2011,Trafford 003B,E01006186,1374,1026,348,118,61,169
2011,Trafford 003C,E01006187,1948,1509,439,129,90,220
2011,Trafford 003D,E01006189,1596,1188,408,147,74,187
2011,Trafford 004A,E01006113,1064,666,398,96,124,178
2011,Trafford 004B,E01006114,1143,680,463,114,103,246
2011,Trafford 004C,E01006115,1130,734,396,86,101,209
2011,Trafford 004D,E01006145,1243,814,429,127,93,209
2011,Trafford 004E,E01006146,1317,957,360,138,88,134
2011,Trafford 005A,E01006122,1124,753,371,273,27,71
2011,Trafford 005B,E01006123,1210,875,335,199,56,80
2011,Trafford 005C,E01006124,1090,777,313,231,38,44
2011,Trafford 005D,E01006128,1261,954,307,175,39,93
2011,Trafford 005E,E01006131,1123,843,280,160,34,86
2011,Trafford 006A,E01006155,1204,934,270,147,47,76
2011,Trafford 006B,E01006157,1153,868,285,121,55,109
2011,Trafford 006C,E01006159,1217,882,335,113,54,168
2011,Trafford 006D,E01006182,1119,825,294,142,60,92
2011,Trafford 006E,E01006183,1220,902,318,170,44,104
2011,Trafford 007A,E01006125,1091,769,322,187,42,93
2011,Trafford 007B,E01006126,1175,795,380,165,51,164
2011,Trafford 007C,E01006127,1199,917,282,148,44,90
2011,Trafford 007D,E01006130,1310,992,318,200,37,81
2011,Trafford 007E,E01006132,1129,833,296,164,37,95
2011,Trafford 008A,E01006156,1144,835,309,160,45,104
2011,Trafford 008B,E01006158,1206,866,340,140,34,166
2011,Trafford 008C,E01006179,1314,925,389,155,57,177
2011,Trafford 008D,E01006184,1208,818,390,182,62,146
2011,Trafford 009A,E01006198,1125,848,277,123,48,106
2011,Trafford 009B,E01006199,1201,880,321,148,40,133
2011,Trafford 009C,E01006200,980,644,336,209,41,86
2011,Trafford 009D,E01006201,1085,855,230,92,39,99
2011,Trafford 009E,E01006202,1015,771,244,112,31,101
2011,Trafford 010A,E01006120,1061,738,323,227,43,53
2011,Trafford 010B,E01006129,940,622,318,198,27,93
2011,Trafford 010C,E01006133,1092,750,342,258,31,53
2011,Trafford 010D,E01006197,1070,834,236,133,40,63
2011,Trafford 010E,E01006203,1012,781,231,133,44,54
2011,Trafford 011A,E01006142,1173,839,334,144,48,142
2011,Trafford 011B,E01006143,1206,886,320,167,67,86
2011,Trafford 011C,E01006144,1022,679,343,124,43,176
2011,Trafford 011D,E01006180,1410,1108,302,114,63,125
2011,Trafford 011E,E01006181,1187,841,346,131,54,161
2011,Trafford 012A,E01006147,987,740,247,159,39,49
2011,Trafford 012B,E01006149,1036,765,271,167,26,78
2011,Trafford 012C,E01006150,1119,838,281,158,46,77
2011,Trafford 012D,E01006154,1139,919,220,110,35,75
2011,Trafford 012E,E01006165,1496,1194,302,129,43,130
2011,Trafford 013A,E01006166,1187,869,318,156,47,115
2011,Trafford 013B,E01006169,1182,850,332,202,40,90
2011,Trafford 013C,E01006170,1108,832,276,169,35,72
2011,Trafford 013D,E01006171,1275,857,418,157,60,201
2011,Trafford 014A,E01006098,897,626,271,187,36,48
2011,Trafford 014B,E01006099,993,746,247,138,38,71
2011,Trafford 014C,E01006164,1184,875,309,202,41,66
2011,Trafford 014D,E01006174,1276,964,312,200,34,78
2011,Trafford 014E,E01006178,1357,1036,321,192,48,81
2011,Trafford 015A,E01006097,1239,917,322,201,46,75
2011,Trafford 015B,E01006160,1315,1003,312,133,42,137
2011,Trafford 015C,E01006161,1442,1133,309,154,44,111
2011,Trafford 015D,E01006162,1239,976,263,146,56,61
2011,Trafford 015E,E01006163,1399,1152,247,122,47,78
2011,Trafford 016A,E01006148,1176,811,365,186,66,113
2011,Trafford 016B,E01006151,1075,775,300,174,46,80
2011,Trafford 016C,E01006152,1157,797,360,219,71,70
2011,Trafford 016D,E01006153,1105,784,321,222,38,61
2011,Trafford 016E,E01006172,1095,733,362,252,34,76
2011,Trafford 017A,E01006104,1232,828,404,200,41,163
2011,Trafford 017B,E01006105,1227,782,445,120,37,288
2011,Trafford 017C,E01006106,1082,715,367,146,54,167
2011,Trafford 017D,E01006107,1129,749,380,171,35,174
2011,Trafford 017E,E01006108,1101,692,409,72,51,286
2011,Trafford 018A,E01006102,940,705,235,148,31,56
2011,Trafford 018B,E01006173,1097,835,262,163,41,58
2011,Trafford 018C,E01006175,1079,686,393,151,51,191
2011,Trafford 018D,E01006176,1304,950,354,204,55,95
2011,Trafford 018E,E01006177,1134,800,334,106,61,167
2011,Trafford 019A,E01006091,1772,1475,297,118,52,127
2011,Trafford 019B,E01006092,947,660,287,72,54,161
2011,Trafford 019C,E01006095,1257,966,291,190,31,70
2011,Trafford 019D,E01006167,1181,731,450,156,61,233
2011,Trafford 019E,E01006168,1313,826,487,124,82,281
2011,Trafford 020A,E01006090,1549,1219,330,190,43,97
2011,Trafford 020B,E01006094,1056,776,280,171,46,63
2011,Trafford 020C,E01006096,1092,858,234,133,45,56
2011,Trafford 020D,E01006100,1093,806,287,155,43,89
2011,Trafford 020E,E01006103,1162,904,258,138,59,61
2011,Trafford 021A,E01006101,1071,803,268,153,45,70
2011,Trafford 021B,E01006190,1223,914,309,189,42,78
2011,Trafford 021C,E01006195,1306,984,322,216,42,64
2011,Trafford 021D,E01006196,1311,1020,291,173,55,63
2011,Trafford 021E,E01006210,1181,866,315,171,44,100
2011,Trafford 022A,E01006204,1149,810,339,202,61,76
2011,Trafford 022B,E01006206,1280,910,370,175,66,129
2011,Trafford 022C,E01006207,1201,747,454,148,65,241
2011,Trafford 022D,E01006208,1154,828,326,168,51,107
2011,Trafford 022E,E01006211,1070,738,332,169,43,120
2011,Trafford 023A,E01006093,1156,882,274,165,48,61
2011,Trafford 023B,E01006191,1185,873,312,197,58,57
2011,Trafford 023C,E01006192,1072,786,286,178,45,63
2011,Trafford 023D,E01006205,934,653,281,171,35,75
2011,Trafford 023E,E01006209,1060,745,315,214,36,65
2011,Trafford 024A,E01006078,1471,1236,235,119,35,81
2011,Trafford 024B,E01006080,1352,1082,270,140,49,81
2011,Trafford 024C,E01006089,1144,914,230,126,28,76
2011,Trafford 024D,E01006193,1096,813,283,189,35,59
2011,Trafford 024E,E01006194,1709,1408,301,117,63,121
2011,Trafford 025A,E01006074,1083,739,344,156,56,132
2011,Trafford 025B,E01006075,1333,984,349,188,51,110
2011,Trafford 025C,E01006076,1068,730,338,192,47,99
2011,Trafford 025D,E01006079,1507,1193,314,167,53,94
2011,Trafford 025E,E01006087,1113,789,324,177,67,80
2011,Trafford 026A,E01006083,953,682,271,133,64,74
2011,Trafford 026B,E01006084,1189,884,305,147,74,84
2011,Trafford 026C,E01006088,1126,914,212,88,40,84
2011,Trafford 026D,E01006139,1175,937,238,119,43,76
2011,Trafford 026E,E01006140,1161,894,267,131,56,80
2011,Trafford 027A,E01006077,1175,913,262,123,43,96
2011,Trafford 027B,E01006081,959,662,297,160,58,79
2011,Trafford 027C,E01006082,1142,803,339,184,61,94
2011,Trafford 027D,E01006085,1047,769,278,153,39,86
2011,Trafford 027E,E01006086,1154,803,351,186,61,104
2011,Trafford 028A,E01006134,1089,748,341,140,87,114
2011,Trafford 028B,E01006135,1058,688,370,230,50,90
2011,Trafford 028C,E01006136,1054,728,326,187,49,90
2011,Trafford 028D,E01006137,967,649,318,134,92,92
2011,Trafford 028E,E01006138,1182,769,413,260,53,100
2011,Wigan 001A,E01006315,932,646,286,209,28,49
2011,Wigan 001B,E01006316,1172,850,322,219,46,57
2011,Wigan 001C,E01006317,1147,777,370,251,41,78
2011,Wigan 001D,E01006319,991,813,178,79,42,57
2011,Wigan 002A,E01006229,1140,714,426,309,38,79
2011,Wigan 002B,E01006230,1067,775,292,195,47,50
2011,Wigan 002C,E01006233,1106,789,317,200,51,66
2011,Wigan 002D,E01006237,1134,894,240,143,35,62
2011,Wigan 002E,E01006238,1090,702,388,187,38,163
2011,Wigan 003A,E01006259,1009,727,282,162,35,85
2011,Wigan 003B,E01006312,1130,759,371,268,34,69
2011,Wigan 003C,E01006313,788,524,264,134,30,100
2011,Wigan 003D,E01006314,1260,854,406,296,34,76
2011,Wigan 003E,E01006318,1115,752,363,289,33,41
2011,Wigan 003F,E01006320,1087,778,309,215,34,60
2011,Wigan 003G,E01006321,1298,977,321,200,44,77
2011,Wigan 004A,E01006231,1138,774,364,238,43,83
2011,Wigan 004B,E01006232,1413,1044,369,222,62,85
2011,Wigan 004C,E01006234,952,583,369,262,25,82
2011,Wigan 004D,E01006235,1035,687,348,157,35,156
2011,Wigan 005A,E01006253,1132,705,427,240,37,150
2011,Wigan 005B,E01006254,1094,687,407,134,59,214
2011,Wigan 005C,E01006255,1141,808,333,226,28,79
2011,Wigan 005D,E01006256,1083,802,281,146,35,100
2011,Wigan 005E,E01006260,1085,726,359,162,48,149
2011,Wigan 006A,E01006370,1272,968,304,146,38,120
2011,Wigan 006B,E01006372,1230,833,397,266,66,65
2011,Wigan 006C,E01006373,1133,887,246,163,28,55
2011,Wigan 006D,E01006374,1125,823,302,217,32,53
2011,Wigan 006E,E01006390,1130,731,399,262,37,100
2011,Wigan 007A,E01006236,1156,787,369,275,26,68
2011,Wigan 007B,E01006388,1267,855,412,222,34,156
2011,Wigan 007C,E01006389,1059,833,226,97,36,93
2011,Wigan 007D,E01006391,1219,764,455,295,37,123
2011,Wigan 008A,E01006257,970,731,239,133,33,73
2011,Wigan 008B,E01006258,1227,892,335,194,36,105
2011,Wigan 008C,E01006369,1337,909,428,146,62,220
2011,Wigan 008D,E01006371,1156,855,301,154,44,103
2011,Wigan 008E,E01006375,1193,896,297,157,58,82
2011,Wigan 009A,E01006306,1191,729,462,159,33,270
2011,Wigan 009B,E01006307,1075,722,353,139,49,165
2011,Wigan 009C,E01006386,1204,650,554,229,28,297
2011,Wigan 009D,E01006387,937,648,289,153,32,104
2011,Wigan 009E,E01006392,1057,673,384,123,46,215
2011,Wigan 010A,E01006350,1274,733,541,161,62,318
2011,Wigan 010B,E01006351,1470,883,587,170,69,348
2011,Wigan 010C,E01006357,1160,655,505,155,53,297
2011,Wigan 010D,E01006360,1183,703,480,109,65,306
2011,Wigan 010E,E01006361,1140,677,463,105,41,317
2011,Wigan 011A,E01006356,1075,668,407,151,50,206
2011,Wigan 011B,E01006396,1116,844,272,160,31,81
2011,Wigan 011C,E01006397,835,525,310,169,17,124
2011,Wigan 011D,E01006398,834,552,282,111,27,144
2011,Wigan 011E,E01006399,1150,770,380,186,53,141
2011,Wigan 012A,E01006305,1254,769,485,139,70,276
2011,Wigan 012B,E01006308,1175,773,402,132,44,226
2011,Wigan 012C,E01006309,1160,785,375,117,54,204
2011,Wigan 012D,E01006310,1072,653,419,142,47,230
2011,Wigan 012E,E01006311,1145,763,382,138,43,201
2011,Wigan 013A,E01006269,1204,800,404,214,44,146
2011,Wigan 013B,E01006271,1342,968,374,200,47,127
2011,Wigan 013C,E01006272,1195,892,303,138,26,139
2011,Wigan 013D,E01006273,1130,725,405,193,48,164
2011,Wigan 013E,E01006276,1659,1267,392,180,52,160
2011,Wigan 014A,E01006353,1192,790,402,239,47,116
2011,Wigan 014B,E01006354,1104,748,356,167,38,151
2011,Wigan 014C,E01006355,1191,807,384,233,35,116
2011,Wigan 014D,E01006358,1295,857,438,220,33,185
2011,Wigan 014E,E01006359,1097,737,360,167,35,158
2011,Wigan 015A,E01006349,1393,1110,283,128,35,120
2011,Wigan 015B,E01006352,1252,891,361,162,25,174
2011,Wigan 015C,E01006404,1170,828,342,134,49,159
2011,Wigan 015D,E01006405,1061,651,410,195,40,175
2011,Wigan 015E,E01006411,1193,713,480,164,42,274
2011,Wigan 016A,E01006270,1127,615,512,260,44,208
2011,Wigan 016B,E01006274,1053,695,358,157,42,159
2011,Wigan 016C,E01006275,1062,636,426,149,39,238
2011,Wigan 016D,E01006277,1325,1082,243,94,65,84
2011,Wigan 016E,E01006286,1199,701,498,345,26,127
2011,Wigan 017A,E01006239,1472,878,594,210,56,328
2011,Wigan 017B,E01006240,1100,661,439,113,56,270
2011,Wigan 017C,E01006241,1436,915,521,163,61,297
2011,Wigan 017D,E01006287,971,710,261,166,35,60
2011,Wigan 017E,E01006289,1271,811,460,135,53,272
2011,Wigan 018A,E01006362,1312,901,411,277,60,74
2011,Wigan 018B,E01006363,1099,646,453,335,38,80
2011,Wigan 018C,E01006364,1310,939,371,207,45,119
2011,Wigan 018D,E01006365,1604,1214,390,210,77,103
2011,Wigan 018E,E01006366,1272,845,427,277,37,113
2011,Wigan 018F,E01006367,1189,819,370,265,35,70
2011,Wigan 018G,E01006368,1197,789,408,294,30,84
2011,Wigan 019A,E01006278,1200,771,429,285,25,119
2011,Wigan 019B,E01006279,1241,895,346,200,47,99
2011,Wigan 019C,E01006280,1037,667,370,218,20,132
2011,Wigan 019D,E01006281,1364,1007,357,223,31,103
2011,Wigan 019E,E01006285,1449,1010,439,282,43,114
2011,Wigan 020A,E01006406,1173,727,446,305,25,116
2011,Wigan 020B,E01006407,1201,904,297,158,44,95
2011,Wigan 020C,E01006408,1139,743,396,155,59,182
2011,Wigan 020D,E01006409,1080,715,365,257,29,79
2011,Wigan 020E,E01006410,1104,809,295,183,39,73
2011,Wigan 021A,E01006393,1165,874,291,180,35,76
2011,Wigan 021B,E01006394,1206,858,348,262,33,53
2011,Wigan 021C,E01006395,1822,1535,287,131,64,92
2011,Wigan 021D,E01006400,1034,841,193,115,30,48
2011,Wigan 021E,E01006401,1125,809,316,211,39,66
2011,Wigan 021F,E01006402,950,697,253,192,18,43
2011,Wigan 021G,E01006403,1318,920,398,274,23,101
2011,Wigan 022A,E01006290,1070,730,340,234,33,73
2011,Wigan 022B,E01006291,1083,766,317,165,33,119
2011,Wigan 022C,E01006292,1197,805,392,254,33,105
2011,Wigan 022D,E01006293,1145,805,340,160,34,146
2011,Wigan 023A,E01006242,1239,849,390,225,38,127
2011,Wigan 023B,E01006243,1527,1187,340,204,42,94
2011,Wigan 023C,E01006244,1130,782,348,183,29,136
2011,Wigan 023D,E01006245,1868,1410,458,242,52,164
2011,Wigan 024A,E01006213,1176,726,450,154,44,252
2011,Wigan 024B,E01006215,1177,690,487,178,42,267
2011,Wigan 024C,E01006217,1666,1162,504,202,68,234
2011,Wigan 024D,E01006218,1527,1079,448,170,56,222
2011,Wigan 024E,E01006219,1014,719,295,159,24,112
2011,Wigan 025A,E01006288,1285,785,500,174,58,268
2011,Wigan 025B,E01006294,1481,1164,317,111,50,156
2011,Wigan 025C,E01006295,1232,873,359,178,42,139
2011,Wigan 025D,E01006377,1247,898,349,202,45,102
2011,Wigan 025E,E01006378,1019,688,331,254,19,58
2011,Wigan 026A,E01006212,1065,704,361,219,31,111
2011,Wigan 026B,E01006214,998,702,296,106,24,166
2011,Wigan 026C,E01006216,1633,1254,379,172,43,164
2011,Wigan 026D,E01006322,1152,798,354,142,51,161
2011,Wigan 026E,E01006329,1024,595,429,106,76,247
2011,Wigan 027A,E01006282,1256,823,433,208,48,177
2011,Wigan 027B,E01006283,1093,718,375,131,49,195
2011,Wigan 027C,E01006284,1134,752,382,139,38,205
2011,Wigan 027D,E01006336,1115,641,474,135,40,299
2011,Wigan 027E,E01006337,1140,793,347,199,34,114
2011,Wigan 028A,E01006376,1175,783,392,173,52,167
2011,Wigan 028B,E01006381,1436,1166,270,117,63,90
2011,Wigan 028C,E01006382,1127,830,297,201,36,60
2011,Wigan 028D,E01006383,1269,971,298,135,58,105
2011,Wigan 028E,E01006384,1136,862,274,171,36,67
2011,Wigan 029A,E01006250,1199,869,330,228,36,66
2011,Wigan 029B,E01006251,1127,841,286,176,40,70
2011,Wigan 029C,E01006379,1179,821,358,239,24,95
2011,Wigan 029D,E01006380,1176,747,429,192,57,180
2011,Wigan 029E,E01006385,1158,852,306,205,38,63
2011,Wigan 030A,E01006328,1084,782,302,116,40,146
2011,Wigan 030B,E01006333,1342,968,374,144,42,188
2011,Wigan 030C,E01006334,1306,902,404,151,46,207
2011,Wigan 030D,E01006338,1167,858,309,153,33,123
2011,Wigan 031A,E01006248,1151,681,470,164,37,269
2011,Wigan 031B,E01006249,1150,698,452,159,63,230
2011,Wigan 031C,E01006330,1261,879,382,238,42,102
2011,Wigan 031D,E01006331,1231,912,319,208,37,74
2011,Wigan 031E,E01006332,1447,1082,365,198,56,111
2011,Wigan 032A,E01006262,1134,766,368,147,43,178
2011,Wigan 032B,E01006263,1188,770,418,317,34,67
2011,Wigan 032C,E01006266,1081,693,388,289,29,70
2011,Wigan 032D,E01006267,1155,702,453,189,46,218
2011,Wigan 032E,E01006268,1304,937,367,173,47,147
2011,Wigan 033A,E01006323,1108,722,386,180,41,165
2011,Wigan 033B,E01006324,994,640,354,170,36,148
2011,Wigan 033C,E01006325,1212,859,353,154,48,151
2011,Wigan 033D,E01006326,1084,772,312,119,46,147
2011,Wigan 033E,E01006327,1045,604,441,170,45,226
2011,Wigan 034A,E01006246,1184,750,434,218,39,177
2011,Wigan 034B,E01006247,1003,697,306,200,37,69
2011,Wigan 034C,E01006252,1102,772,330,230,28,72
2011,Wigan 034D,E01006297,1160,766,394,151,52,191
2011,Wigan 034E,E01006335,1283,940,343,149,51,143
2011,Wigan 035A,E01006220,1292,850,442,210,36,196
2011,Wigan 035B,E01006221,1232,887,345,213,32,100
2011,Wigan 035C,E01006222,1173,829,344,243,43,58
2011,Wigan 035D,E01006224,1111,949,162,63,45,54
2011,Wigan 035E,E01006226,1339,942,397,242,38,117
2011,Wigan 036A,E01006223,1193,876,317,171,41,105
2011,Wigan 036B,E01006225,1096,723,373,241,40,92
2011,Wigan 036C,E01006261,1125,724,401,250,35,116
2011,Wigan 036D,E01006264,1103,776,327,240,29,58
2011,Wigan 036E,E01006265,1082,755,327,183,38,106
2011,Wigan 037A,E01006296,1114,712,402,146,51,205
2011,Wigan 037B,E01006298,1008,666,342,136,44,162
2011,Wigan 037C,E01006299,1439,1060,379,246,43,90
2011,Wigan 037D,E01006300,993,617,376,306,26,44
2011,Wigan 037E,E01006301,1032,732,300,211,42,47
2011,Wigan 038A,E01006227,1166,862,304,181,43,80
2011,Wigan 038B,E01006228,1270,919,351,157,47,147
2011,Wigan 038C,E01006342,1127,732,395,165,51,179
2011,Wigan 038D,E01006344,1019,634,385,176,33,176
2011,Wigan 038E,E01006346,1584,1176,408,209,47,152
2011,Wigan 039A,E01006339,1088,726,362,251,39,72
2011,Wigan 039B,E01006340,1046,712,334,153,33,148
2011,Wigan 039C,E01006343,1279,995,284,155,58,71
2011,Wigan 039D,E01006345,1139,797,342,227,27,88
2011,Wigan 039E,E01006348,1207,835,372,258,37,77
2011,Wigan 040A,E01006302,1243,942,301,169,44,88
2011,Wigan 040B,E01006303,1090,734,356,246,36,74
2011,Wigan 040C,E01006304,1079,707,372,232,38,102
2011,Wigan 040D,E01006341,1213,822,391,202,33,156
2011,Wigan 040E,E01006347,1157,789,368,259,48,61
2011,Burnley 001A,E01024859,1170,927,243,124,36,83
2011,Burnley 001B,E01024861,1016,733,283,187,38,58
2011,Burnley 001C,E01024862,1205,901,304,211,29,64
2011,Burnley 001D,E01024891,1115,664,451,234,61,156
2011,Burnley 001E,E01024892,1022,612,410,247,47,116
2011,Burnley 001F,E01024894,1026,711,315,145,49,121
2011,Burnley 002A,E01024893,1014,629,385,161,54,170
2011,Burnley 002B,E01024896,1020,710,310,169,31,110
2011,Burnley 002C,E01024897,905,557,348,191,43,114
2011,Burnley 002D,E01024898,1155,748,407,131,46,230
2011,Burnley 003A,E01024856,1063,622,441,111,52,278
2011,Burnley 003B,E01024875,898,450,448,51,78,319
2011,Burnley 003C,E01024876,945,500,445,79,73,293
2011,Burnley 003D,E01024877,1021,495,526,86,96,344
2011,Burnley 003E,E01024878,975,473,502,75,92,335
2011,Burnley 003F,E01024895,967,570,397,83,54,260
2011,Burnley 004A,E01024883,1065,716,349,160,45,144
2011,Burnley 004B,E01024884,1132,718,414,230,43,141
2011,Burnley 004C,E01024885,1269,925,344,126,35,183
2011,Burnley 004D,E01024886,1019,718,301,113,40,148
2011,Burnley 004E,E01024889,947,662,285,162,34,89
2011,Burnley 004F,E01024890,1027,674,353,140,55,158
2011,Burnley 005A,E01024879,954,702,252,125,36,91
2011,Burnley 005B,E01024880,1022,664,358,200,44,114
2011,Burnley 005C,E01024912,1032,727,305,220,33,52
2011,Burnley 005D,E01024913,1007,808,199,95,43,61
2011,Burnley 005E,E01024914,1157,848,309,218,36,55
2011,Burnley 006A,E01024881,1059,730,329,139,62,128
2011,Burnley 006B,E01024882,1090,777,313,122,44,147
2011,Burnley 006C,E01024902,1101,802,299,148,38,113
2011,Burnley 006D,E01024911,1301,854,447,226,46,175
2011,Burnley 007A,E01024855,1031,580,451,204,43,204
2011,Burnley 007B,E01024857,1025,648,377,151,45,181
2011,Burnley 007C,E01024858,955,587,368,85,42,241
2011,Burnley 007D,E01024864,1218,856,362,202,46,114
2011,Burnley 008A,E01024863,1047,661,386,162,49,175
2011,Burnley 008B,E01024865,1061,649,412,209,37,166
2011,Burnley 008C,E01024866,1303,863,440,233,46,161
2011,Burnley 008D,E01024867,1076,745,331,251,26,54
2011,Burnley 009A,E01024860,983,730,253,179,26,48
2011,Burnley 009B,E01024868,896,677,219,140,34,45
2011,Burnley 009C,E01024869,1068,700,368,294,30,44
2011,Burnley 009D,E01024870,887,584,303,215,31,57
2011,Burnley 010A,E01024872,969,546,423,148,49,226
2011,Burnley 010B,E01024899,1160,708,452,170,51,231
2011,Burnley 010C,E01024900,1127,647,480,158,54,268
2011,Burnley 010D,E01024907,917,591,326,113,46,167
2011,Burnley 010E,E01024908,807,466,341,105,34,202
2011,Burnley 010F,E01024909,1139,725,414,139,56,219
2011,Burnley 011A,E01024874,838,616,222,144,30,48
2011,Burnley 011B,E01024887,1134,782,352,155,40,157
2011,Burnley 011C,E01024888,1252,866,386,261,26,99
2011,Burnley 011D,E01024901,1425,1144,281,166,47,68
2011,Burnley 014D,E01024871,988,677,311,193,36,82
2011,Burnley 014E,E01024873,1012,680,332,204,40,88
2011,Burnley 014F,E01024903,886,597,289,85,63,141
2011,Burnley 014A,E01024904,1299,855,444,194,77,173
2011,Burnley 014G,E01024905,922,682,240,162,35,43
2011,Burnley 014B,E01024906,1174,662,512,179,52,281
2011,Burnley 014C,E01024910,1078,728,350,135,45,170
2011,Chorley 001A,E01024951,884,586,298,85,62,151
2011,Chorley 001B,E01024952,971,690,281,132,30,119
2011,Chorley 001C,E01024953,1046,671,375,143,30,202
2011,Chorley 001D,E01024954,1108,789,319,188,26,105
2011,Chorley 002A,E01024921,1644,1147,497,322,55,120
2011,Chorley 002B,E01024978,999,761,238,134,20,84
2011,Chorley 002C,E01024979,1045,780,265,168,40,57
2011,Chorley 002D,E01024980,1009,705,304,204,41,59
2011,Chorley 003A,E01024946,891,630,261,181,27,53
2011,Chorley 003B,E01024947,985,796,189,99,37,53
2011,Chorley 003C,E01024955,1193,877,316,187,43,86
2011,Chorley 003D,E01024956,1115,809,306,232,28,46
2011,Chorley 003E,E01024957,1096,735,361,244,38,79
2011,Chorley 003F,E01024958,1003,736,267,122,36,109
2011,Chorley 004A,E01024948,1087,792,295,192,35,68
2011,Chorley 004B,E01024949,1743,1448,295,132,39,124
2011,Chorley 004C,E01024950,999,773,226,150,35,41
2011,Chorley 004D,E01024977,1656,1279,377,241,48,88
2011,Chorley 005A,E01024967,1010,701,309,229,30,50
2011,Chorley 005B,E01024968,1303,1022,281,165,47,69
2011,Chorley 005C,E01024969,999,680,319,190,26,103
2011,Chorley 005D,E01024970,1035,799,236,171,18,47
2011,Chorley 005E,E01024971,952,645,307,211,32,64
2011,Chorley 005F,E01024972,989,750,239,163,31,45
2011,Chorley 006A,E01024929,919,616,303,99,44,160
2011,Chorley 006B,E01024930,1062,811,251,125,43,83
2011,Chorley 006C,E01024931,1086,776,310,154,40,116
2011,Chorley 006D,E01024932,792,539,253,172,26,55
2011,Chorley 006E,E01024933,1029,629,400,239,44,117
2011,Chorley 006F,E01024937,1104,752,352,243,43,66
2011,Chorley 007A,E01024964,1084,745,339,235,42,62
2011,Chorley 007B,E01024974,1159,835,324,229,45,50
2011,Chorley 007C,E01024975,2785,1229,1556,166,70,1320
2011,Chorley 007D,E01024976,1131,811,320,204,43,73
2011,Chorley 008A,E01024919,1882,1457,425,157,71,197
2011,Chorley 008B,E01024920,1521,982,539,409,36,94
2011,Chorley 008C,E01024934,1063,750,313,242,26,45
2011,Chorley 008D,E01024935,1056,642,414,329,21,64
2011,Chorley 009A,E01024925,1165,738,427,146,48,233
2011,Chorley 009B,E01024926,1404,950,454,156,51,247
2011,Chorley 009C,E01024927,1244,902,342,210,33,99
2011,Chorley 009D,E01024928,1142,830,312,174,26,112
2011,Chorley 010A,E01024936,1171,888,283,140,46,97
2011,Chorley 010B,E01024938,1208,866,342,229,32,81
2011,Chorley 010C,E01024939,1281,888,393,297,41,55
2011,Chorley 010D,E01024940,1334,963,371,162,54,155
2011,Chorley 010E,E01024941,1170,788,382,166,30,186
2011,Chorley 011A,E01024923,939,641,298,198,26,74
2011,Chorley 011B,E01024924,1088,780,308,225,34,49
2011,Chorley 011C,E01024963,1134,796,338,245,34,59
2011,Chorley 011D,E01024965,1059,757,302,209,44,49
2011,Chorley 011E,E01024966,1192,874,318,219,39,60
2011,Chorley 012A,E01024942,1158,748,410,160,46,204
2011,Chorley 012B,E01024943,1645,1253,392,124,47,221
2011,Chorley 012C,E01024944,1299,1040,259,113,53,93
2011,Chorley 012D,E01024945,2021,1547,474,169,79,226
2011,Chorley 013A,E01024922,1053,765,288,191,28,69
2011,Chorley 013B,E01024959,1254,870,384,156,50,178
2011,Chorley 013C,E01024960,1172,872,300,153,39,108
2011,Chorley 013D,E01024961,1230,905,325,205,36,84
2011,Chorley 013E,E01024962,1158,806,352,254,21,77
2011,Chorley 014A,E01024915,1562,1111,451,268,56,127
2011,Chorley 014B,E01024916,1251,876,375,283,28,64
2011,Chorley 014C,E01024917,1304,982,322,150,47,125
2011,Chorley 014D,E01024918,1292,939,353,266,32,55
2011,Chorley 014E,E01024973,1586,1095,491,343,42,106
2011,Fylde 001A,E01024993,1110,782,328,245,27,56
2011,Fylde 001B,E01025026,973,658,315,215,34,66
2011,Fylde 001C,E01025027,1287,953,334,154,41,139
2011,Fylde 001D,E01025028,1024,715,309,180,43,86
2011,Fylde 001E,E01025031,884,537,347,276,23,48
2011,Fylde 002A,E01025007,984,715,269,148,64,57
2011,Fylde 002B,E01025008,850,576,274,191,30,53
2011,Fylde 002C,E01025009,1078,702,376,226,35,115
2011,Fylde 002D,E01025011,1046,737,309,151,35,123
2011,Fylde 002E,E01025012,1478,1115,363,216,57,90
2011,Fylde 002F,E01025013,1199,880,319,139,54,126
2011,Fylde 002G,E01025019,1011,650,361,272,35,54
2011,Fylde 003A,E01024998,1253,824,429,215,50,164
2011,Fylde 003B,E01025010,1485,769,716,201,36,479
2011,Fylde 003C,E01025014,1280,910,370,220,42,108
2011,Fylde 003D,E01025015,1171,838,333,230,32,71
2011,Fylde 004A,E01025004,931,660,271,160,32,79
2011,Fylde 004B,E01025006,952,602,350,140,34,176
2011,Fylde 004C,E01025023,985,653,332,239,34,59
2011,Fylde 004D,E01025024,932,552,380,254,30,96
2011,Fylde 004E,E01025025,1108,821,287,139,33,115
2011,Fylde 005A,E01025001,1046,599,447,290,31,126
2011,Fylde 005B,E01025002,1056,775,281,146,37,98
2011,Fylde 005C,E01025005,1007,596,411,317,13,81
2011,Fylde 005D,E01025016,1648,1120,528,370,53,105
2011,Fylde 005E,E01025018,861,534,327,248,24,55
2011,Fylde 006A,E01024984,987,657,330,222,34,74
2011,Fylde 006B,E01024985,975,658,317,221,28,68
2011,Fylde 006C,E01024986,1035,697,338,189,23,126
2011,Fylde 006D,E01024987,1037,712,325,94,32,199
2011,Fylde 006E,E01024988,1047,651,396,228,25,143
2011,Fylde 006F,E01024989,1046,743,303,160,36,107
2011,Fylde 006G,E01024996,874,575,299,142,35,122
2011,Fylde 007A,E01024997,1045,733,312,213,46,53
2011,Fylde 007B,E01024999,1108,772,336,232,34,70
2011,Fylde 007C,E01025000,993,649,344,256,27,61
2011,Fylde 007D,E01025029,1475,940,535,415,31,89
2011,Fylde 007E,E01025030,1186,849,337,148,49,140
2011,Fylde 008A,E01024981,948,559,389,293,26,70
2011,Fylde 008B,E01024982,829,517,312,181,31,100
2011,Fylde 008C,E01024983,1061,806,255,151,43,61
2011,Fylde 008D,E01024994,1114,723,391,293,37,61
2011,Fylde 008E,E01024995,1017,645,372,275,30,67
2011,Fylde 008F,E01025003,1123,695,428,307,40,81
2011,Fylde 008G,E01025017,971,546,425,322,25,78
2011,Fylde 009A,E01024990,1135,775,360,248,39,73
2011,Fylde 009B,E01024991,638,409,229,163,25,41
2011,Fylde 009C,E01024992,897,457,440,370,13,57
2011,Fylde 009D,E01025020,931,657,274,126,34,114
2011,Fylde 009E,E01025021,1053,717,336,237,32,67
2011,Fylde 009F,E01025022,1380,1032,348,194,51,103
2011,Hyndburn 001A,E01025060,1062,750,312,110,50,152
2011,Hyndburn 001B,E01025061,1027,623,404,287,33,84
2011,Hyndburn 001C,E01025062,1103,702,401,132,61,208
2011,Hyndburn 001D,E01025063,1133,742,391,225,46,120
2011,Hyndburn 001E,E01025064,1204,814,390,287,37,66
2011,Hyndburn 001F,E01025065,1218,899,319,133,44,142
2011,Hyndburn 001G,E01025066,1172,882,290,155,43,92
2011,Hyndburn 002A,E01025032,1028,658,370,163,48,159
2011,Hyndburn 002B,E01025033,1652,1384,268,120,65,83
2011,Hyndburn 002C,E01025034,1267,886,381,190,45,146
2011,Hyndburn 002D,E01025048,1180,821,359,232,45,82
2011,Hyndburn 002E,E01025049,1194,755,439,179,56,204
2011,Hyndburn 002F,E01025050,1133,835,298,163,44,91
2011,Hyndburn 002G,E01025053,1143,851,292,149,37,106
2011,Hyndburn 003A,E01025070,832,544,288,116,49,123
2011,Hyndburn 003B,E01025071,1067,761,306,147,49,110
2011,Hyndburn 003C,E01025072,997,682,315,138,37,140
2011,Hyndburn 003D,E01025073,987,689,298,187,34,77
2011,Hyndburn 003E,E01025074,1064,711,353,267,44,42
2011,Hyndburn 004A,E01025051,1019,631,388,162,37,189
2011,Hyndburn 004B,E01025052,1145,829,316,202,43,71
2011,Hyndburn 004C,E01025057,1137,780,357,185,62,110
2011,Hyndburn 004D,E01025058,969,585,384,223,34,127
2011,Hyndburn 004E,E01025059,1008,604,404,194,49,161
2011,Hyndburn 004F,E01025067,1113,763,350,116,50,184
2011,Hyndburn 004G,E01025068,1055,701,354,114,42,198
2011,Hyndburn 004H,E01025069,1051,796,255,94,37,124
2011,Hyndburn 005A,E01025044,876,597,279,120,39,120
2011,Hyndburn 005B,E01025045,829,477,352,107,53,192
2011,Hyndburn 005C,E01025046,882,555,327,144,26,157
2011,Hyndburn 005D,E01025081,1275,959,316,191,51,74
2011,Hyndburn 006A,E01025041,1101,542,559,128,79,352
2011,Hyndburn 006B,E01025042,1356,704,652,111,118,423
2011,Hyndburn 006E,E01025082,1170,663,507,144,76,287
2011,Hyndburn 006F,E01025083,1328,814,514,125,71,318
2011,Hyndburn 006G,E01025084,1091,596,495,105,74,316
2011,Hyndburn 006H,E01033231,1861,1031,830,133,147,550
2011,Hyndburn 007A,E01025055,1054,725,329,147,39,143
2011,Hyndburn 007B,E01025075,1281,937,344,145,46,153
2011,Hyndburn 007C,E01025076,926,664,262,144,34,84
2011,Hyndburn 007D,E01025077,1005,624,381,214,31,136
2011,Hyndburn 007E,E01025078,1172,866,306,206,22,78
2011,Hyndburn 008A,E01025035,1130,768,362,174,51,137
2011,Hyndburn 008B,E01025036,1146,712,434,118,43,273
2011,Hyndburn 008C,E01025037,1046,692,354,158,42,154
2011,Hyndburn 008D,E01025038,986,666,320,233,29,58
2011,Hyndburn 008E,E01025039,939,723,216,133,42,41
2011,Hyndburn 008F,E01025040,1128,836,292,194,38,60
2011,Hyndburn 009A,E01025054,1324,881,443,250,42,151
2011,Hyndburn 009B,E01025056,1010,652,358,261,25,72
2011,Hyndburn 009C,E01025079,1252,859,393,270,27,96
2011,Hyndburn 009D,E01025080,1228,897,331,178,47,106
2011,Lancaster 001A,E01025088,828,626,202,133,24,45
2011,Lancaster 001B,E01025096,1181,919,262,153,41,68
2011,Lancaster 001C,E01025097,1049,704,345,165,47,133
2011,Lancaster 001D,E01025098,984,678,306,205,30,71
2011,Lancaster 001E,E01025148,1460,881,579,440,64,75
2011,Lancaster 001F,E01025168,813,580,233,162,21,50
2011,Lancaster 001G,E01025169,920,604,316,238,26,52
2011,Lancaster 002A,E01025130,1583,1070,513,377,45,91
2011,Lancaster 002B,E01025132,1126,799,327,197,39,91
2011,Lancaster 002C,E01025166,827,529,298,210,32,56
2011,Lancaster 002D,E01025167,884,643,241,167,27,47
2011,Lancaster 003A,E01025089,1006,714,292,204,32,56
2011,Lancaster 003B,E01025090,1234,850,384,280,33,71
2011,Lancaster 003C,E01025158,934,611,323,257,25,41
2011,Lancaster 003D,E01025159,1081,681,400,240,91,69
2011,Lancaster 003E,E01025160,910,568,342,275,31,36
2011,Lancaster 004A,E01025085,968,619,349,215,33,101
2011,Lancaster 004B,E01025086,924,575,349,289,28,32
2011,Lancaster 004C,E01025087,776,495,281,183,24,74
2011,Lancaster 004D,E01025161,733,385,348,286,19,43
2011,Lancaster 005A,E01025108,888,600,288,200,27,61
2011,Lancaster 005B,E01025109,744,527,217,162,15,40
2011,Lancaster 005C,E01025131,1128,817,311,186,45,80
2011,Lancaster 005D,E01025133,984,679,305,244,22,39
2011,Lancaster 006A,E01025112,1207,775,432,193,60,179
2011,Lancaster 006B,E01025136,1070,712,358,136,51,171
2011,Lancaster 006C,E01025138,1021,753,268,98,53,117
2011,Lancaster 006D,E01025139,1255,836,419,141,76,202
2011,Lancaster 006E,E01025140,1068,668,400,166,47,187
2011,Lancaster 008A,E01025111,1283,896,387,179,53,155
2011,Lancaster 008B,E01025113,1180,834,346,182,60,104
2011,Lancaster 008C,E01025118,796,543,253,114,32,107
2011,Lancaster 008D,E01025119,945,672,273,152,34,87
2011,Lancaster 009A,E01025110,1105,700,405,110,57,238
2011,Lancaster 009B,E01025116,1041,649,392,205,34,153
2011,Lancaster 009C,E01025117,1072,675,397,93,68,236
2011,Lancaster 009D,E01025120,1015,699,316,125,55,136
2011,Lancaster 010A,E01025170,1196,762,434,286,37,111
2011,Lancaster 010B,E01025171,1173,646,527,259,65,203
2011,Lancaster 010C,E01025172,1135,789,346,194,44,108
2011,Lancaster 010D,E01025173,1163,710,453,252,36,165
2011,Lancaster 011A,E01025149,1605,1237,368,150,54,164
2011,Lancaster 011B,E01025150,1092,801,291,139,51,101
2011,Lancaster 011C,E01025151,1194,794,400,121,75,204
2011,Lancaster 011D,E01025152,1077,769,308,125,59,124
2011,Lancaster 011E,E01025154,890,522,368,141,40,187
2011,Lancaster 013A,E01025091,1034,678,356,162,54,140
2011,Lancaster 013B,E01025092,841,569,272,98,46,128
2011,Lancaster 013C,E01025095,1210,731,479,72,96,311
2011,Lancaster 013D,E01025126,1486,1106,380,159,147,74
2011,Lancaster 014A,E01025093,1484,869,615,65,459,91
2011,Lancaster 014B,E01025094,1078,714,364,102,160,102
2011,Lancaster 014C,E01025099,1268,920,348,81,167,100
2011,Lancaster 014E,E01033071,1058,699,359,47,243,69
2011,Lancaster 014F,E01033073,1434,827,607,115,387,105
2011,Lancaster 015A,E01025125,1235,644,591,56,502,33
2011,Lancaster 015B,E01025128,1129,777,352,64,219,69
2011,Lancaster 015C,E01025129,1061,674,387,34,295,58
2011,Lancaster 015D,E01025147,1110,763,347,104,182,61
2011,Lancaster 016A,E01025114,1065,685,380,256,31,93
2011,Lancaster 016B,E01025115,1085,694,391,196,55,140
2011,Lancaster 016C,E01025121,1273,951,322,192,38,92
2011,Lancaster 016D,E01025122,1242,787,455,304,37,114
2011,Lancaster 016E,E01025123,1667,1302,365,187,60,118
2011,Lancaster 016F,E01025124,1064,689,375,174,36,165
2011,Lancaster 016I,E01033072,1791,1147,644,412,60,172
2011,Lancaster 017A,E01025100,1128,857,271,118,60,93
2011,Lancaster 017B,E01025101,1012,657,355,119,85,151
2011,Lancaster 017C,E01025102,1142,711,431,109,219,103
2011,Lancaster 017D,E01025103,1017,706,311,175,86,50
2011,Lancaster 017E,E01025144,1560,913,647,145,391,111
2011,Lancaster 017F,E01025146,1449,1011,438,269,98,71
2011,Lancaster 018A,E01025127,1013,698,315,197,55,63
2011,Lancaster 018B,E01025141,1053,753,300,154,75,71
2011,Lancaster 018C,E01025143,1012,626,386,159,96,131
2011,Lancaster 018D,E01025145,1089,780,309,105,129,75
2011,Lancaster 019A,E01025105,5809,1913,3896,148,3681,67
2011,Lancaster 019B,E01025106,2006,1164,842,167,610,65
2011,Lancaster 019C,E01025107,1237,929,308,190,48,70
2011,Lancaster 019D,E01025142,1120,754,366,266,56,44
2011,Lancaster 020A,E01025137,1021,740,281,161,37,83
2011,Lancaster 020F,E01025153,934,723,211,118,29,64
2011,Lancaster 020G,E01025155,929,704,225,139,22,64
2011,Lancaster 020H,E01025156,761,451,310,65,52,193
2011,Lancaster 020I,E01025157,829,529,300,156,33,111
2011,Lancaster 020B,E01025162,928,578,350,291,19,40
2011,Lancaster 020C,E01025163,1016,667,349,258,40,51
2011,Lancaster 020D,E01025164,969,699,270,181,19,70
2011,Lancaster 020E,E01025165,1099,877,222,119,43,60
2011,Pendle 001A,E01025191,924,686,238,155,30,53
2011,Pendle 001B,E01025192,1021,784,237,113,31,93
2011,Pendle 001C,E01025193,1006,672,334,231,26,77
2011,Pendle 001D,E01025194,1014,763,251,119,40,92
2011,Pendle 002A,E01025195,937,684,253,167,29,57
2011,Pendle 002B,E01025196,1261,930,331,154,35,142
2011,Pendle 002C,E01025197,1003,699,304,204,26,74
2011,Pendle 002D,E01025198,996,683,313,163,38,112
2011,Pendle 003A,E01025199,1287,930,357,239,38,80
2011,Pendle 003B,E01025200,1114,792,322,178,29,115
2011,Pendle 003C,E01025201,1153,812,341,190,38,113
2011,Pendle 003D,E01025202,1031,740,291,180,36,75
2011,Pendle 004A,E01025205,1021,771,250,97,31,122
2011,Pendle 004B,E01025206,853,582,271,175,25,71
2011,Pendle 004C,E01025207,983,679,304,140,22,142
2011,Pendle 004D,E01025208,865,555,310,157,23,130
2011,Pendle 005A,E01025220,1059,656,403,129,43,231
2011,Pendle 005B,E01025221,948,638,310,119,54,137
2011,Pendle 005C,E01025222,1079,797,282,163,44,75
2011,Pendle 005D,E01025223,997,697,300,155,32,113
2011,Pendle 006A,E01025178,1357,1009,348,245,34,69
2011,Pendle 006B,E01025179,1190,876,314,188,43,83
2011,Pendle 006C,E01025180,1432,1068,364,231,45,88
2011,Pendle 006D,E01025203,1307,974,333,243,27,63
2011,Pendle 007A,E01025226,1190,772,418,143,36,239
2011,Pendle 007B,E01025227,1512,941,571,198,69,304
2011,Pendle 007C,E01025228,1181,894,287,141,42,104
2011,Pendle 008A,E01025174,1073,711,362,242,34,86
2011,Pendle 008B,E01025175,1175,828,347,238,42,67
2011,Pendle 008C,E01025176,1494,1177,317,187,36,94
2011,Pendle 008D,E01025177,1327,946,381,290,19,72
2011,Pendle 008E,E01025204,1284,920,364,259,52,53
2011,Pendle 008F,E01025211,1074,746,328,255,31,42
2011,Pendle 009A,E01025181,990,544,446,139,64,243
2011,Pendle 009B,E01025182,1142,620,522,160,69,293
2011,Pendle 009C,E01025183,1179,718,461,131,52,278
2011,Pendle 009D,E01025184,1101,616,485,68,98,319
2011,Pendle 010A,E01025188,1339,774,565,184,50,331
2011,Pendle 010B,E01025189,1209,776,433,117,71,245
2011,Pendle 010C,E01025210,1302,892,410,175,48,187
2011,Pendle 010D,E01025217,1069,662,407,118,44,245
2011,Pendle 010E,E01025218,860,406,454,109,35,310
2011,Pendle 010F,E01025219,816,526,290,78,27,185
2011,Pendle 011A,E01025224,1394,788,606,127,78,401
2011,Pendle 011B,E01025225,1139,761,378,168,57,153
2011,Pendle 011C,E01025229,1510,789,721,140,113,468
2011,Pendle 011D,E01025230,1127,621,506,87,76,343
2011,Pendle 012A,E01025187,1021,603,418,211,53,154
2011,Pendle 012B,E01025190,1234,800,434,230,53,151
2011,Pendle 012C,E01025209,1204,771,433,228,61,144
2011,Pendle 012D,E01025216,1439,958,481,179,89,213
2011,Pendle 013A,E01025185,1345,743,602,205,78,319
2011,Pendle 013B,E01025186,1066,647,419,128,48,243
2011,Pendle 013C,E01025212,1003,592,411,237,48,126
2011,Pendle 013D,E01025213,782,484,298,126,32,140
2011,Pendle 013E,E01025214,1046,737,309,195,47,67
2011,Pendle 013F,E01025215,975,525,450,125,79,246
2011,Preston 001A,E01025278,1818,1381,437,306,46,85
2011,Preston 001B,E01025279,1452,1055,397,253,52,92
2011,Preston 001C,E01025282,1003,717,286,199,33,54
2011,Preston 002A,E01025257,1040,730,310,207,56,47
2011,Preston 002B,E01025277,1226,860,366,263,39,64
2011,Preston 002C,E01025280,1353,1035,318,183,56,79
2011,Preston 002D,E01025281,1098,794,304,220,36,48
2011,Preston 003A,E01025256,1031,724,307,204,48,55
2011,Preston 003B,E01025258,1057,702,355,263,39,53
2011,Preston 003C,E01025259,1498,1066,432,303,58,71
2011,Preston 003D,E01025299,1046,735,311,210,49,52
2011,Preston 003E,E01025301,853,694,159,82,30,47
2011,Preston 003F,E01025302,901,659,242,149,34,59
2011,Preston 004A,E01025253,1344,1166,178,69,43,66
2011,Preston 004B,E01025254,853,644,209,135,25,49
2011,Preston 004C,E01025255,1152,968,184,94,43,47
2011,Preston 004D,E01025300,768,471,297,149,57,91
2011,Preston 004E,E01025303,1040,819,221,137,35,49
2011,Preston 005A,E01025260,1056,667,389,156,32,201
2011,Preston 005B,E01025262,1116,734,382,224,42,116
2011,Preston 005C,E01025263,1037,692,345,153,42,150
2011,Preston 005D,E01025264,1104,756,348,149,49,150
2011,Preston 006A,E01025239,991,678,313,213,22,78
2011,Preston 006B,E01025241,1133,799,334,184,54,96
2011,Preston 006C,E01025242,1114,729,385,268,39,78
2011,Preston 006D,E01025243,1443,986,457,191,95,171
2011,Preston 006E,E01025251,1020,668,352,140,94,118
2011,Preston 007A,E01025234,1051,731,320,110,39,171
2011,Preston 007B,E01025235,1195,804,391,249,36,106
2011,Preston 007C,E01025237,1069,736,333,151,54,128
2011,Preston 007D,E01025238,1064,734,330,102,42,186
2011,Preston 007E,E01025245,1771,1115,656,178,103,375
2011,Preston 007F,E01025252,1036,728,308,159,43,106
2011,Preston 008A,E01025233,982,762,220,125,48,47
2011,Preston 008B,E01025240,1150,835,315,216,41,58
2011,Preston 008C,E01025261,1040,722,318,215,34,69
2011,Preston 008D,E01025266,922,642,280,203,36,41
2011,Preston 008E,E01025309,832,605,227,144,27,56
2011,Preston 009A,E01025236,970,610,360,86,50,224
2011,Preston 009B,E01025283,1065,661,404,97,52,255
2011,Preston 009C,E01025284,1244,857,387,144,53,190
2011,Preston 009D,E01025285,975,637,338,114,70,154
2011,Preston 009E,E01025286,1192,735,457,114,58,285
2011,Preston 009F,E01025287,1428,907,521,140,70,311
2011,Preston 010A,E01025270,1192,928,264,135,42,87
2011,Preston 010B,E01025272,1175,949,226,113,47,66
2011,Preston 010C,E01025273,1051,887,164,84,40,40
2011,Preston 010D,E01025288,1308,1010,298,131,47,120
2011,Preston 011A,E01025246,1178,693,485,96,83,306
2011,Preston 011B,E01025274,1590,1052,538,72,269,197
2011,Preston 011C,E01025275,1252,812,440,117,143,180
2011,Preston 011D,E01025294,1365,892,473,78,172,223
2011,Preston 012A,E01025276,1286,900,386,120,111,155
2011,Preston 012B,E01025308,1346,1016,330,71,165,94
2011,Preston 012C,E01025310,1225,886,339,116,126,97
2011,Preston 012D,E01025311,1030,800,230,113,43,74
2011,Preston 012E,E01025312,1305,1020,285,81,83,121
2011,Preston 012F,E01025313,1738,946,792,104,527,161
2011,Preston 012G,E01025314,2422,1474,948,105,746,97
2011,Preston 013A,E01025231,1007,720,287,184,44,59
2011,Preston 013B,E01025232,1298,994,304,71,124,109
2011,Preston 013C,E01025265,1131,871,260,131,32,97
2011,Preston 013D,E01025267,1023,686,337,162,44,131
2011,Preston 013E,E01025268,1192,812,380,180,30,170
2011,Preston 013F,E01025269,1114,786,328,126,42,160
2011,Preston 013G,E01025271,1095,731,364,169,61,134
2011,Preston 014A,E01025295,2042,1021,1021,168,95,758
2011,Preston 014B,E01025296,1332,869,463,85,81,297
2011,Preston 014C,E01025297,1422,925,497,88,94,315
2011,Preston 014D,E01025298,1093,710,383,78,58,247
2011,Preston 015A,E01025244,1158,668,490,77,104,309
2011,Preston 015B,E01025292,2955,1444,1511,69,1219,223
2011,Preston 015C,E01025293,1544,814,730,163,164,403
2011,Preston 016A,E01025247,1212,788,424,92,72,260
2011,Preston 016B,E01025248,873,539,334,90,44,200
2011,Preston 016C,E01025249,733,487,246,128,29,89
2011,Preston 016D,E01025250,1163,773,390,73,66,251
2011,Preston 016E,E01025304,1252,812,440,156,76,208
2011,Preston 016F,E01025305,1213,719,494,123,81,290
2011,Preston 017A,E01025289,1400,923,477,81,236,160
2011,Preston 017B,E01025290,1434,961,473,61,221,191
2011,Preston 017C,E01025291,1036,735,301,119,73,109
2011,Preston 017D,E01025306,1506,1055,451,75,184,192
2011,Preston 017F,E01033223,1166,629,537,50,368,119
2011,Preston 017G,E01033224,834,510,324,73,91,160
2011,Preston 017H,E01033226,861,512,349,88,57,204
2011,Ribble Valley 001A,E01025315,1214,799,415,159,200,56
2011,Ribble Valley 001B,E01025320,999,734,265,177,35,53
2011,Ribble Valley 001C,E01025331,1061,775,286,162,29,95
2011,Ribble Valley 001D,E01025348,1142,734,408,332,22,54
2011,Ribble Valley 001E,E01025349,1037,785,252,164,17,71
2011,Ribble Valley 002A,E01025334,1098,774,324,210,34,80
2011,Ribble Valley 002B,E01025344,927,682,245,164,32,49
2011,Ribble Valley 002C,E01025345,1007,708,299,215,31,53
2011,Ribble Valley 002D,E01025346,1119,858,261,136,36,89
2011,Ribble Valley 002E,E01025347,1183,883,300,165,55,80
2011,Ribble Valley 003A,E01025329,1019,681,338,211,40,87
2011,Ribble Valley 003B,E01025330,952,670,282,184,24,74
2011,Ribble Valley 003C,E01025335,930,603,327,173,27,127
2011,Ribble Valley 003D,E01025338,1197,918,279,123,36,120
2011,Ribble Valley 003E,E01025339,1103,806,297,195,26,76
2011,Ribble Valley 004A,E01025322,1032,783,249,174,36,39
2011,Ribble Valley 004B,E01025326,1099,772,327,219,29,79
2011,Ribble Valley 004C,E01025327,974,712,262,183,25,54
2011,Ribble Valley 004D,E01025342,1169,888,281,191,29,61
2011,Ribble Valley 005A,E01025321,957,699,258,178,20,60
2011,Ribble Valley 005B,E01025340,1021,752,269,174,47,48
2011,Ribble Valley 005C,E01025341,847,599,248,195,19,34
2011,Ribble Valley 005D,E01025343,1047,752,295,181,48,66
2011,Ribble Valley 005E,E01025354,963,699,264,186,25,53
2011,Ribble Valley 006A,E01025316,1119,866,253,165,40,48
2011,Ribble Valley 006B,E01025317,797,599,198,111,22,65
2011,Ribble Valley 006C,E01025325,1090,851,239,139,33,67
2011,Ribble Valley 006D,E01025328,837,577,260,194,19,47
2011,Ribble Valley 007A,E01025318,770,564,206,133,28,45
2011,Ribble Valley 007B,E01025319,1526,1149,377,237,60,80
2011,Ribble Valley 007C,E01025333,914,656,258,185,28,45
2011,Ribble Valley 007D,E01025350,886,629,257,179,31,47
2011,Ribble Valley 007E,E01025351,1872,1260,612,269,84,259
2011,Ribble Valley 008A,E01025323,800,565,235,163,30,42
2011,Ribble Valley 008B,E01025324,987,721,266,189,40,37
2011,Ribble Valley 008C,E01025332,753,493,260,200,29,31
2011,Ribble Valley 008D,E01025336,828,608,220,164,28,28
2011,Ribble Valley 008E,E01025337,1131,800,331,243,40,48
2011,Ribble Valley 008F,E01025352,1101,702,399,249,51,99
2011,Ribble Valley 008G,E01025353,777,566,211,160,19,32
2011,Rossendale 001A,E01025355,1692,1301,391,224,57,110
2011,Rossendale 001B,E01025361,1572,1230,342,171,58,113
2011,Rossendale 001C,E01025362,1449,1100,349,208,51,90
2011,Rossendale 001D,E01025393,1135,829,306,150,47,109
2011,Rossendale 002A,E01025363,909,616,293,175,52,66
2011,Rossendale 002B,E01025364,1015,725,290,176,47,67
2011,Rossendale 002C,E01025366,1089,732,357,90,77,190
2011,Rossendale 002D,E01025395,1192,847,345,202,45,98
2011,Rossendale 002E,E01025396,975,565,410,125,56,229
2011,Rossendale 002F,E01025397,1180,805,375,88,77,210
2011,Rossendale 002G,E01025398,962,687,275,87,58,130
2011,Rossendale 003A,E01025367,1330,1009,321,145,65,111
2011,Rossendale 003B,E01025368,1169,780,389,186,49,154
2011,Rossendale 003C,E01025369,860,591,269,95,30,144
2011,Rossendale 003D,E01025381,1060,668,392,168,41,183
2011,Rossendale 003E,E01025382,1267,772,495,210,44,241
2011,Rossendale 003F,E01025383,1712,1288,424,194,69,161
2011,Rossendale 004A,E01025356,1055,703,352,154,54,144
2011,Rossendale 004C,E01025373,1155,818,337,198,44,95
2011,Rossendale 004D,E01025385,906,579,327,137,34,156
2011,Rossendale 004F,E01025387,975,652,323,140,64,119
2011,Rossendale 004G,E01033281,1906,1297,609,259,107,243
2011,Rossendale 007A,E01025377,1093,846,247,152,44,51
2011,Rossendale 007B,E01025378,1183,885,298,197,44,57
2011,Rossendale 007C,E01025379,894,571,323,190,24,109
2011,Rossendale 007D,E01025380,1104,795,309,227,29,53
2011,Rossendale 008A,E01025357,1004,731,273,145,41,87
2011,Rossendale 008B,E01025358,1684,1303,381,247,55,79
2011,Rossendale 008C,E01025365,1149,845,304,188,52,64
2011,Rossendale 008D,E01025384,901,601,300,204,20,76
2011,Rossendale 009A,E01025359,1284,850,434,265,57,112
2011,Rossendale 009B,E01025360,1444,1028,416,226,59,131
2011,Rossendale 009C,E01025375,1311,973,338,197,69,72
2011,Rossendale 009D,E01025376,1553,1045,508,211,71,226
2011,Rossendale 010F,E01025370,933,678,255,160,29,66
2011,Rossendale 010A,E01025371,991,684,307,130,43,134
2011,Rossendale 010B,E01025374,1094,742,352,191,43,118
2011,Rossendale 010G,E01025388,1076,725,351,157,44,150
2011,Rossendale 010H,E01025389,900,596,304,123,34,147
2011,Rossendale 010I,E01025390,779,485,294,132,37,125
2011,Rossendale 010C,E01025391,1062,739,323,148,43,132
2011,Rossendale 010D,E01025392,931,664,267,147,34,86
2011,Rossendale 010E,E01025394,1140,806,334,153,50,131
2011,South Ribble 001A,E01025424,942,694,248,175,36,37
2011,South Ribble 001B,E01025425,962,751,211,125,39,47
2011,South Ribble 001C,E01025426,900,640,260,186,42,32
2011,South Ribble 001D,E01025466,1040,766,274,185,41,48
2011,South Ribble 002A,E01025413,1321,930,391,281,46,64
2011,South Ribble 002B,E01025414,1200,832,368,296,36,36
2011,South Ribble 002C,E01025456,913,651,262,138,29,95
2011,South Ribble 002D,E01025458,1130,833,297,159,35,103
2011,South Ribble 003A,E01025408,1101,746,355,262,40,53
2011,South Ribble 003B,E01025409,1018,725,293,173,53,67
2011,South Ribble 003C,E01025410,1035,786,249,144,57,48
2011,South Ribble 003D,E01025467,1470,987,483,362,54,67
2011,South Ribble 004A,E01025403,1479,1244,235,123,46,66
2011,South Ribble 004B,E01025457,1067,798,269,160,27,82
2011,South Ribble 004C,E01025463,1026,810,216,125,32,59
2011,South Ribble 004D,E01025464,990,739,251,186,37,28
2011,South Ribble 004E,E01025465,830,616,214,131,25,58
2011,South Ribble 005A,E01025411,1540,1139,401,263,43,95
2011,South Ribble 005B,E01025448,1236,932,304,193,48,63
2011,South Ribble 005C,E01025449,735,519,216,149,29,38
2011,South Ribble 005D,E01025450,736,525,211,86,46,79
2011,South Ribble 006A,E01025412,1077,731,346,217,33,96
2011,South Ribble 006B,E01025427,1084,744,340,160,45,135
2011,South Ribble 006C,E01025428,1087,792,295,131,62,102
2011,South Ribble 006D,E01025429,962,685,277,92,36,149
2011,South Ribble 007A,E01025404,886,578,308,240,30,38
2011,South Ribble 007B,E01025405,870,576,294,195,25,74
2011,South Ribble 007C,E01025406,929,645,284,209,19,56
2011,South Ribble 007D,E01025407,1431,1082,349,151,41,157
2011,South Ribble 008A,E01025399,1115,794,321,131,46,144
2011,South Ribble 008B,E01025400,1324,947,377,234,45,98
2011,South Ribble 008C,E01025401,1140,825,315,202,29,84
2011,South Ribble 008D,E01025402,1055,810,245,111,37,97
2011,South Ribble 009A,E01025442,811,608,203,102,13,88
2011,South Ribble 009B,E01025443,1040,748,292,215,19,58
2011,South Ribble 009C,E01025444,1008,767,241,134,33,74
2011,South Ribble 009D,E01025461,1448,1136,312,204,44,64
2011,South Ribble 009E,E01025462,1268,937,331,212,33,86
2011,South Ribble 010A,E01025439,948,634,314,228,32,54
2011,South Ribble 010B,E01025453,1231,836,395,273,59,63
2011,South Ribble 010C,E01025454,911,633,278,198,33,47
2011,South Ribble 010D,E01025455,1065,701,364,264,36,64
2011,South Ribble 011A,E01025436,1744,1300,444,305,47,92
2011,South Ribble 011B,E01025437,1339,971,368,249,38,81
2011,South Ribble 011C,E01025438,989,708,281,209,35,37
2011,South Ribble 011D,E01025440,1026,693,333,246,33,54
2011,South Ribble 011E,E01025441,996,683,313,244,29,40
2011,South Ribble 012A,E01025417,1074,791,283,184,26,73
2011,South Ribble 012B,E01025418,1057,792,265,180,30,55
2011,South Ribble 012C,E01025419,1148,869,279,156,34,89
2011,South Ribble 012D,E01025420,2075,1555,520,301,71,148
2011,South Ribble 013A,E01025421,1663,1349,314,119,46,149
2011,South Ribble 013B,E01025422,952,700,252,131,42,79
2011,South Ribble 013C,E01025431,1315,1074,241,90,45,106
2011,South Ribble 013D,E01025433,1393,1034,359,216,37,106
2011,South Ribble 014A,E01025416,1165,847,318,207,37,74
2011,South Ribble 014B,E01025451,1485,1175,310,182,46,82
2011,South Ribble 014C,E01025452,1272,907,365,167,39,159
2011,South Ribble 015A,E01025415,1549,1124,425,222,52,151
2011,South Ribble 015B,E01025423,929,597,332,125,30,177
2011,South Ribble 015C,E01025435,1056,767,289,166,23,100
2011,South Ribble 015D,E01025446,1101,784,317,224,37,56
2011,South Ribble 016A,E01025430,1458,1110,348,214,50,84
2011,South Ribble 016C,E01025434,1485,938,547,439,41,67
2011,South Ribble 016D,E01032928,1452,1253,199,76,41,82
2011,South Ribble 016E,E01032929,801,552,249,159,22,68
2011,South Ribble 017A,E01025445,951,642,309,88,48,173
2011,South Ribble 017B,E01025447,812,486,326,132,39,155
2011,South Ribble 017C,E01025459,1261,899,362,227,25,110
2011,South Ribble 017D,E01025460,1549,1105,444,223,43,178
2011,West Lancashire 001A,E01025496,896,684,212,127,22,63
2011,West Lancashire 001B,E01025497,1138,891,247,138,37,72
2011,West Lancashire 001C,E01025498,947,686,261,163,34,64
2011,West Lancashire 001D,E01025530,1104,810,294,223,21,50
2011,West Lancashire 001E,E01025532,1095,785,310,219,32,59
2011,West Lancashire 001F,E01025533,1154,813,341,231,46,64
2011,West Lancashire 002A,E01025507,1183,804,379,249,43,87
2011,West Lancashire 002B,E01025508,1034,688,346,192,38,116
2011,West Lancashire 002C,E01025509,898,606,292,165,33,94
2011,West Lancashire 002D,E01025513,1480,1016,464,307,56,101
2011,West Lancashire 002E,E01025531,871,594,277,202,24,51
2011,West Lancashire 003A,E01025474,853,613,240,153,25,62
2011,West Lancashire 003B,E01025495,1507,1073,434,292,49,93
2011,West Lancashire 003C,E01025514,1718,1212,506,315,55,136
2011,West Lancashire 003D,E01025515,1214,772,442,307,46,89
2011,West Lancashire 004A,E01025483,1583,1071,512,295,56,161
2011,West Lancashire 004B,E01025484,1411,1021,390,272,36,82
2011,West Lancashire 004C,E01025485,1271,938,333,195,45,93
2011,West Lancashire 004D,E01025486,1230,900,330,181,53,96
2011,West Lancashire 004E,E01025487,1164,839,325,192,43,90
2011,West Lancashire 005A,E01025510,972,617,355,252,40,63
2011,West Lancashire 005B,E01025511,847,575,272,189,28,55
2011,West Lancashire 005C,E01025512,925,685,240,150,33,57
2011,West Lancashire 005D,E01025538,1158,805,353,256,31,66
2011,West Lancashire 005E,E01025539,979,689,290,185,42,63
2011,West Lancashire 006A,E01025499,1036,707,329,167,86,76
2011,West Lancashire 006B,E01025501,794,502,292,223,30,39
2011,West Lancashire 006C,E01025502,1122,768,354,226,62,66
2011,West Lancashire 006D,E01025516,1114,790,324,203,54,67
2011,West Lancashire 006E,E01025517,1110,742,368,152,82,134
2011,West Lancashire 006F,E01025519,899,605,294,214,32,48
2011,West Lancashire 007A,E01025488,1646,985,661,192,389,80
2011,West Lancashire 007B,E01025489,990,702,288,139,97,52
2011,West Lancashire 007C,E01025490,1492,867,625,140,440,45
2011,West Lancashire 007D,E01025500,1105,720,385,200,134,51
2011,West Lancashire 007E,E01025518,1132,691,441,139,223,79
2011,West Lancashire 008A,E01025479,1489,1087,402,258,61,83
2011,West Lancashire 008B,E01025491,1299,794,505,271,178,56
2011,West Lancashire 008C,E01025506,1502,987,515,359,58,98
2011,West Lancashire 009A,E01025468,1288,1044,244,111,67,66
2011,West Lancashire 009B,E01025469,1188,785,403,188,58,157
2011,West Lancashire 009C,E01025470,1162,897,265,128,63,74
2011,West Lancashire 009D,E01025522,868,590,278,180,24,74
2011,West Lancashire 010A,E01025471,1094,732,362,111,65,186
2011,West Lancashire 010B,E01025480,1006,708,298,79,65,154
2011,West Lancashire 010C,E01025481,1093,711,382,145,48,189
2011,West Lancashire 010D,E01025482,998,581,417,107,67,243
2011,West Lancashire 010E,E01025520,860,568,292,148,38,106
2011,West Lancashire 010F,E01025521,1198,810,388,145,62,181
2011,West Lancashire 011A,E01025523,1201,894,307,150,44,113
2011,West Lancashire 011B,E01025524,1129,762,367,152,53,162
2011,West Lancashire 011C,E01025525,1190,834,356,196,56,104
2011,West Lancashire 011D,E01025526,1269,889,380,205,63,112
2011,West Lancashire 012A,E01025472,1020,659,361,246,41,74
2011,West Lancashire 012B,E01025473,1025,678,347,222,56,69
2011,West Lancashire 012C,E01025475,1059,688,371,252,44,75
2011,West Lancashire 012D,E01025476,900,583,317,217,41,59
2011,West Lancashire 012E,E01025477,904,647,257,163,41,53
2011,West Lancashire 012F,E01025478,861,546,315,220,54,41
2011,West Lancashire 013A,E01025492,969,659,310,146,56,108
2011,West Lancashire 013B,E01025527,1004,612,392,172,51,169
2011,West Lancashire 013C,E01025528,1200,797,403,99,67,237
2011,West Lancashire 013D,E01025529,1273,877,396,173,65,158
2011,West Lancashire 014A,E01025493,1110,689,421,87,65,269
2011,West Lancashire 014B,E01025494,1124,671,453,154,63,236
2011,West Lancashire 014C,E01025503,951,651,300,80,62,158
2011,West Lancashire 014D,E01025504,786,468,318,111,44,163
2011,West Lancashire 014E,E01025505,1074,720,354,175,51,128
2011,West Lancashire 015A,E01025534,1232,895,337,241,34,62
2011,West Lancashire 015B,E01025535,1114,794,320,173,54,93
2011,West Lancashire 015C,E01025536,1064,753,311,128,50,133
2011,West Lancashire 015D,E01025537,1131,755,376,254,31,91
2011,West Lancashire 015E,E01025540,894,599,295,197,31,67
2011,Wyre 001A,E01025573,1017,729,288,175,34,79
2011,Wyre 001B,E01025574,1089,679,410,214,32,164
2011,Wyre 001C,E01025581,1045,736,309,147,42,120
2011,Wyre 001D,E01025582,940,633,307,116,28,163
2011,Wyre 001E,E01025583,948,652,296,124,26,146
2011,Wyre 001F,E01025584,1166,693,473,207,50,216
2011,Wyre 002A,E01025605,969,703,266,169,26,71
2011,Wyre 002B,E01025606,859,528,331,115,38,178
2011,Wyre 002C,E01025607,1136,800,336,206,36,94
2011,Wyre 002D,E01025608,1154,836,318,193,39,86
2011,Wyre 003A,E01025590,1012,610,402,138,44,220
2011,Wyre 003B,E01025591,1131,657,474,360,20,94
2011,Wyre 003C,E01025592,1021,569,452,135,52,265
2011,Wyre 003D,E01025593,1308,599,709,362,268,79
2011,Wyre 004A,E01025563,824,509,315,252,13,50
2011,Wyre 004B,E01025564,1181,774,407,281,46,80
2011,Wyre 004C,E01025565,1097,718,379,274,41,64
2011,Wyre 004D,E01025586,1110,637,473,349,32,92
2011,Wyre 004E,E01025587,1078,683,395,293,32,70
2011,Wyre 004F,E01025588,932,480,452,348,15,89
2011,Wyre 004G,E01025589,934,660,274,143,46,85
2011,Wyre 005A,E01025557,1143,784,359,235,38,86
2011,Wyre 005B,E01025575,772,427,345,142,34,169
2011,Wyre 005C,E01025578,1100,712,388,180,42,166
2011,Wyre 005D,E01025579,944,644,300,95,38,167
2011,Wyre 005E,E01025580,979,611,368,246,59,63
2011,Wyre 006A,E01025547,1522,1034,488,198,210,80
2011,Wyre 006B,E01025549,1547,1150,397,261,47,89
2011,Wyre 006C,E01025609,1501,1070,431,285,64,82
2011,Wyre 007A,E01025548,1096,632,464,361,30,73
2011,Wyre 007B,E01025553,1954,1491,463,286,76,101
2011,Wyre 007C,E01025558,1156,681,475,363,40,72
2011,Wyre 007D,E01025559,1357,990,367,234,40,93
2011,Wyre 007E,E01025560,933,563,370,299,20,51
2011,Wyre 008A,E01025554,1036,569,467,305,41,121
2011,Wyre 008B,E01025556,1047,664,383,215,54,114
2011,Wyre 008C,E01025570,835,476,359,229,23,107
2011,Wyre 008D,E01025571,1006,614,392,205,45,142
2011,Wyre 008E,E01025572,940,542,398,297,18,83
2011,Wyre 008F,E01025604,1088,749,339,197,42,100
2011,Wyre 009A,E01025561,1110,826,284,196,29,59
2011,Wyre 009B,E01025562,1547,1088,459,298,48,113
2011,Wyre 009C,E01025585,1700,1187,513,341,57,115
2011,Wyre 010A,E01025542,1243,880,363,225,53,85
2011,Wyre 010B,E01025555,925,528,397,288,24,85
2011,Wyre 010C,E01025601,1019,626,393,299,29,65
2011,Wyre 010D,E01025602,1168,877,291,173,46,72
2011,Wyre 010E,E01025603,1043,665,378,293,26,59
2011,Wyre 011A,E01025541,1211,910,301,154,46,101
2011,Wyre 011B,E01025543,1271,931,340,164,51,125
2011,Wyre 011C,E01025544,1117,686,431,292,33,106
2011,Wyre 011D,E01025576,1662,1138,524,360,52,112
2011,Wyre 011E,E01025577,1023,700,323,175,40,108
2011,Wyre 012A,E01025550,1050,697,353,264,27,62
2011,Wyre 012B,E01025552,976,711,265,180,36,49
2011,Wyre 012C,E01025594,1076,658,418,309,25,84
2011,Wyre 012D,E01025595,1048,666,382,304,27,51
2011,Wyre 012E,E01025596,1488,1114,374,242,52,80
2011,Wyre 012F,E01025597,763,498,265,183,20,62
2011,Wyre 013A,E01025545,1287,884,403,286,52,65
2011,Wyre 013B,E01025546,1084,800,284,182,31,71
2011,Wyre 013C,E01025551,1016,728,288,199,40,49
2011,Wyre 013D,E01025567,1129,721,408,260,36,112
2011,Wyre 013E,E01025598,1045,711,334,246,28,60
2011,Wyre 014A,E01025566,1375,919,456,318,60,78
2011,Wyre 014B,E01025568,1220,826,394,272,36,86
2011,Wyre 014C,E01025569,1307,866,441,361,30,50
2011,Wyre 014D,E01025599,739,516,223,155,11,57
2011,Wyre 014E,E01025600,1114,805,309,214,44,51
2011,Knowsley 001A,E01006448,1128,649,479,108,69,302
2011,Knowsley 001B,E01006492,1069,738,331,116,50,165
2011,Knowsley 001C,E01006493,789,413,376,101,46,229
2011,Knowsley 001D,E01006494,988,527,461,81,66,314
2011,Knowsley 001E,E01006495,1304,841,463,118,67,278
2011,Knowsley 002A,E01006454,949,645,304,179,39,86
2011,Knowsley 002B,E01006456,1201,824,377,160,51,166
2011,Knowsley 002C,E01006457,897,530,367,242,24,101
2011,Knowsley 002D,E01006458,1074,643,431,202,41,188
2011,Knowsley 002E,E01006490,1984,1667,317,90,70,157
2011,Knowsley 002F,E01006491,1463,1192,271,94,47,130
2011,Knowsley 003A,E01006415,1478,995,483,143,87,253
2011,Knowsley 003B,E01006417,992,543,449,118,49,282
2011,Knowsley 003C,E01006436,1097,641,456,103,69,284
2011,Knowsley 003D,E01006437,1014,607,407,107,47,253
2011,Knowsley 003E,E01006447,997,646,351,84,51,216
2011,Knowsley 004A,E01006455,1165,694,471,132,63,276
2011,Knowsley 004B,E01006506,1042,785,257,80,45,132
2011,Knowsley 004C,E01006507,1014,660,354,85,49,220
2011,Knowsley 004D,E01006508,1000,735,265,73,38,154
2011,Knowsley 004E,E01006509,1159,708,451,124,63,264
2011,Knowsley 004F,E01006510,934,643,291,151,46,94
2011,Knowsley 005A,E01006416,1050,616,434,124,64,246
2011,Knowsley 005B,E01006418,969,581,388,111,56,221
2011,Knowsley 005C,E01006434,1089,709,380,110,55,215
2011,Knowsley 005D,E01006435,1120,664,456,129,69,258
2011,Knowsley 005E,E01006438,872,524,348,211,49,88
2011,Knowsley 005F,E01006439,1208,735,473,207,61,205
2011,Knowsley 005G,E01006446,977,589,388,112,49,227
2011,Knowsley 006A,E01006412,1084,581,503,202,55,246
2011,Knowsley 006B,E01006413,1082,606,476,132,36,308
2011,Knowsley 006C,E01006414,1023,561,462,229,42,191
2011,Knowsley 006D,E01006441,1742,1178,564,251,55,258
2011,Knowsley 007A,E01006460,1110,618,492,140,72,280
2011,Knowsley 007B,E01006461,1106,674,432,115,76,241
2011,Knowsley 007C,E01006463,1391,911,480,154,51,275
2011,Knowsley 007D,E01006464,1143,686,457,278,46,133
2011,Knowsley 007E,E01006466,1119,788,331,154,49,128
2011,Knowsley 008A,E01006453,833,477,356,99,53,204
2011,Knowsley 008B,E01006467,927,461,466,109,68,289
2011,Knowsley 008E,E01006470,1017,553,464,133,65,266
2011,Knowsley 008F,E01033228,1335,712,623,178,76,369
2011,Knowsley 009A,E01006459,1215,898,317,149,68,100
2011,Knowsley 009B,E01006462,1068,741,327,177,50,100
2011,Knowsley 009C,E01006496,988,648,340,160,45,135
2011,Knowsley 009D,E01006498,1160,876,284,129,57,98
2011,Knowsley 009E,E01006499,1176,850,326,173,42,111
2011,Knowsley 010A,E01006440,1025,594,431,120,56,255
2011,Knowsley 010B,E01006442,944,496,448,117,61,270
2011,Knowsley 010C,E01006443,982,513,469,174,47,248
2011,Knowsley 010D,E01006444,964,508,456,120,55,281
2011,Knowsley 010E,E01006445,967,571,396,116,47,233
2011,Knowsley 011A,E01006465,1256,929,327,153,74,100
2011,Knowsley 011B,E01006482,1089,718,371,128,68,175
2011,Knowsley 011C,E01006483,924,588,336,143,42,151
2011,Knowsley 011D,E01006484,1022,671,351,125,60,166
2011,Knowsley 012A,E01006449,1081,693,388,205,44,139
2011,Knowsley 012B,E01006450,976,605,371,125,50,196
2011,Knowsley 012C,E01006451,1067,689,378,159,52,167
2011,Knowsley 012D,E01006452,1107,808,299,123,41,135
2011,Knowsley 013A,E01006497,833,568,265,138,28,99
2011,Knowsley 013B,E01006500,811,478,333,136,39,158
2011,Knowsley 013C,E01006501,1001,734,267,145,36,86
2011,Knowsley 013D,E01006504,1013,621,392,117,59,216
2011,Knowsley 013E,E01006505,1235,726,509,196,68,245
2011,Knowsley 014A,E01006472,1134,798,336,199,52,85
2011,Knowsley 014B,E01006485,1099,770,329,158,54,117
2011,Knowsley 014C,E01006486,878,647,231,140,28,63
2011,Knowsley 014D,E01006487,1145,818,327,197,49,81
2011,Knowsley 014E,E01006488,1303,945,358,185,54,119
2011,Knowsley 014F,E01006489,1053,780,273,152,47,74
2011,Knowsley 015A,E01006477,1027,667,360,143,51,166
2011,Knowsley 015B,E01006478,982,638,344,119,58,167
2011,Knowsley 015C,E01006479,989,687,302,112,54,136
2011,Knowsley 015D,E01006480,966,548,418,134,50,234
2011,Knowsley 015E,E01006481,933,569,364,159,32,173
2011,Knowsley 016A,E01006471,1059,759,300,162,48,90
2011,Knowsley 016B,E01006473,951,667,284,166,57,61
2011,Knowsley 016C,E01006474,1044,692,352,223,42,87
2011,Knowsley 016D,E01006475,1077,743,334,202,45,87
2011,Knowsley 016E,E01006476,1085,776,309,165,72,72
2011,Knowsley 017A,E01006420,1527,1197,330,149,71,110
2011,Knowsley 017B,E01006424,1601,1217,384,184,85,115
2011,Knowsley 017C,E01006502,1323,879,444,269,46,129
2011,Knowsley 017D,E01006503,917,559,358,235,41,82
2011,Knowsley 018A,E01006421,917,732,185,70,53,62
2011,Knowsley 018B,E01006425,1012,760,252,98,51,103
2011,Knowsley 018C,E01006430,880,519,361,168,38,155
2011,Knowsley 018D,E01006433,1028,690,338,146,37,155
2011,Knowsley 019A,E01006419,1138,907,231,112,46,73
2011,Knowsley 019B,E01006422,949,638,311,195,47,69
2011,Knowsley 019C,E01006423,1116,858,258,134,47,77
2011,Knowsley 019D,E01006427,1040,725,315,199,36,80
2011,Knowsley 020A,E01006426,907,568,339,97,44,198
2011,Knowsley 020B,E01006428,1087,773,314,108,35,171
2011,Knowsley 020C,E01006429,830,470,360,119,41,200
2011,Knowsley 020D,E01006431,1236,833,403,189,52,162
2011,Knowsley 020E,E01006432,1083,715,368,130,51,187
2011,Liverpool 001A,E01006651,1214,984,230,80,59,91
2011,Liverpool 001B,E01006653,1100,690,410,140,45,225
2011,Liverpool 001C,E01006655,1272,866,406,153,59,194
2011,Liverpool 001D,E01006658,971,579,392,147,39,206
2011,Liverpool 001E,E01006660,1008,651,357,141,54,162
2011,Liverpool 002A,E01006652,1118,802,316,133,50,133
2011,Liverpool 002B,E01006656,1135,820,315,137,52,126
2011,Liverpool 002C,E01006657,905,618,287,127,32,128
2011,Liverpool 002D,E01006780,1085,782,303,158,46,99
2011,Liverpool 002E,E01006783,1138,813,325,138,56,131
2011,Liverpool 003A,E01006781,1160,875,285,144,41,100
2011,Liverpool 003B,E01006782,1189,866,323,137,48,138
2011,Liverpool 003C,E01006784,1028,787,241,107,37,97
2011,Liverpool 003D,E01006785,1310,933,377,150,62,165
2011,Liverpool 003E,E01006786,1337,1002,335,154,41,140
2011,Liverpool 004A,E01006661,1176,663,513,166,49,298
2011,Liverpool 004B,E01006662,1165,680,485,195,50,240
2011,Liverpool 004C,E01006663,820,568,252,71,27,154
2011,Liverpool 004D,E01006664,1264,799,465,152,44,269
2011,Liverpool 004E,E01006669,1109,845,264,102,65,97
2011,Liverpool 005A,E01006654,1080,803,277,125,38,114
2011,Liverpool 005B,E01006659,1476,680,796,90,40,666
2011,Liverpool 005C,E01006734,968,584,384,123,54,207
2011,Liverpool 005D,E01006735,948,548,400,126,50,224
2011,Liverpool 005E,E01006736,1073,673,400,124,67,209
2011,Liverpool 005F,E01006737,1048,651,397,115,74,208
2011,Liverpool 006A,E01006787,1987,1093,894,108,109,677
2011,Liverpool 006B,E01006788,1299,929,370,149,65,156
2011,Liverpool 006C,E01006790,1183,725,458,116,82,260
2011,Liverpool 006D,E01006791,1280,761,519,183,56,280
2011,Liverpool 007A,E01006665,1172,922,250,99,56,95
2011,Liverpool 007B,E01006666,1107,891,216,66,66,84
2011,Liverpool 007C,E01006667,1079,728,351,150,44,157
2011,Liverpool 007D,E01006668,1118,893,225,78,60,87
2011,Liverpool 007E,E01006670,1150,856,294,138,49,107
2011,Liverpool 008A,E01006607,1084,663,421,128,70,223
2011,Liverpool 008B,E01006612,1073,649,424,138,47,239
2011,Liverpool 008C,E01006729,923,574,349,92,67,190
2011,Liverpool 008F,E01032510,1358,977,381,140,50,191
2011,Liverpool 008G,E01032511,1079,716,363,160,48,155
2011,Liverpool 009A,E01006608,926,642,284,129,30,125
2011,Liverpool 009B,E01006609,975,643,332,118,64,150
2011,Liverpool 009C,E01006610,1015,628,387,126,64,197
2011,Liverpool 009D,E01006613,1016,585,431,159,53,219
2011,Liverpool 009E,E01006705,1106,767,339,112,50,177
2011,Liverpool 010A,E01006598,927,486,441,136,63,242
2011,Liverpool 010B,E01006599,778,486,292,85,45,162
2011,Liverpool 010E,E01006672,1353,835,518,158,70,290
2011,Liverpool 010F,E01033759,810,543,267,99,27,141
2011,Liverpool 011A,E01006600,1030,646,384,129,55,200
2011,Liverpool 011B,E01006603,1025,624,401,170,52,179
2011,Liverpool 011C,E01006730,943,561,382,116,53,213
2011,Liverpool 011D,E01006731,859,517,342,108,44,190
2011,Liverpool 011E,E01006732,1083,589,494,125,84,285
2011,Liverpool 012A,E01006611,994,604,390,125,31,234
2011,Liverpool 012B,E01006614,989,652,337,114,37,186
2011,Liverpool 012C,E01006615,998,662,336,104,44,188
2011,Liverpool 012D,E01006698,1244,855,389,143,58,188
2011,Liverpool 012E,E01006700,1085,646,439,141,61,237
2011,Liverpool 013A,E01006623,1150,825,325,182,63,80
2011,Liverpool 013B,E01006624,1174,755,419,157,59,203
2011,Liverpool 013C,E01006627,1033,739,294,146,32,116
2011,Liverpool 013D,E01006671,1046,704,342,139,70,133
2011,Liverpool 014A,E01006699,1186,657,529,147,67,315
2011,Liverpool 014B,E01006701,1111,687,424,169,53,202
2011,Liverpool 014C,E01006702,1179,656,523,159,72,292
2011,Liverpool 014D,E01006703,1210,638,572,193,59,320
2011,Liverpool 014E,E01006778,1758,1004,754,212,111,431
2011,Liverpool 015A,E01006541,1211,811,400,171,47,182
2011,Liverpool 015B,E01006543,966,672,294,155,47,92
2011,Liverpool 015C,E01006544,1190,676,514,154,87,273
2011,Liverpool 015D,E01006616,1068,678,390,148,49,193
2011,Liverpool 015E,E01006762,1231,767,464,170,57,237
2011,Liverpool 016A,E01006604,1019,676,343,134,49,160
2011,Liverpool 016B,E01006605,1121,699,422,144,56,222
2011,Liverpool 016C,E01006618,1205,739,466,214,79,173
2011,Liverpool 016D,E01006625,1010,707,303,160,49,94
2011,Liverpool 016E,E01006626,1116,763,353,180,65,108
2011,Liverpool 017A,E01006637,1109,683,426,109,71,246
2011,Liverpool 017B,E01006638,872,480,392,130,52,210
2011,Liverpool 017C,E01006639,1097,770,327,128,59,140
2011,Liverpool 017D,E01006644,1507,978,529,170,74,285
2011,Liverpool 017E,E01006645,993,555,438,153,56,229
2011,Liverpool 018A,E01006542,1025,638,387,92,59,236
2011,Liverpool 018B,E01006558,1057,612,445,132,45,268
2011,Liverpool 018E,E01006562,1109,593,516,136,70,310
2011,Liverpool 018F,E01033747,729,340,389,100,52,237
2011,Liverpool 019A,E01006545,1083,741,342,136,62,144
2011,Liverpool 019B,E01006546,942,646,296,75,46,175
2011,Liverpool 019C,E01006547,1125,680,445,127,80,238
2011,Liverpool 019D,E01006548,1177,702,475,159,101,215
2011,Liverpool 019E,E01006766,916,586,330,84,51,195
2011,Liverpool 019F,E01006767,1316,888,428,103,110,215
2011,Liverpool 020A,E01006606,1155,759,396,168,39,189
2011,Liverpool 020B,E01006761,1219,784,435,144,57,234
2011,Liverpool 020C,E01006763,1061,722,339,121,63,155
2011,Liverpool 020D,E01006764,1153,747,406,132,78,196
2011,Liverpool 020E,E01006765,1076,718,358,117,62,179
2011,Liverpool 020F,E01006768,1104,760,344,109,80,155
2011,Liverpool 021A,E01006617,1093,825,268,141,49,78
2011,Liverpool 021B,E01006619,1196,834,362,185,58,119
2011,Liverpool 021C,E01006620,1021,673,348,207,44,97
2011,Liverpool 021D,E01006621,1123,736,387,209,83,95
2011,Liverpool 021E,E01006622,1097,809,288,182,48,58
2011,Liverpool 021F,E01006640,1358,958,400,183,59,158
2011,Liverpool 022B,E01006776,1271,768,503,182,69,252
2011,Liverpool 022D,E01006779,1417,714,703,210,85,408
2011,Liverpool 022E,E01033764,1661,836,825,260,81,484
2011,Liverpool 023A,E01006560,1419,718,701,223,66,412
2011,Liverpool 023B,E01006564,1354,793,561,281,56,224
2011,Liverpool 023C,E01006646,1543,900,643,150,149,344
2011,Liverpool 023D,E01006648,1780,1083,697,186,173,338
2011,Liverpool 024A,E01006540,1139,671,468,103,79,286
2011,Liverpool 024B,E01006563,1224,581,643,256,58,329
2011,Liverpool 024C,E01006647,1000,458,542,154,66,322
2011,Liverpool 024D,E01006693,1190,618,572,241,57,274
2011,Liverpool 025A,E01006572,834,481,353,114,41,198
2011,Liverpool 025B,E01006574,966,606,360,144,48,168
2011,Liverpool 025C,E01006641,1187,956,231,70,38,123
2011,Liverpool 025D,E01006642,900,542,358,88,67,203
2011,Liverpool 025E,E01006643,1275,788,487,125,94,268
2011,Liverpool 026A,E01006567,1237,781,456,177,48,231
2011,Liverpool 026B,E01006568,1145,818,327,127,52,148
2011,Liverpool 026C,E01006570,1082,783,299,154,58,87
2011,Liverpool 026D,E01006571,1050,659,391,137,61,193
2011,Liverpool 027A,E01006711,1138,734,404,121,69,214
2011,Liverpool 027D,E01006717,1057,783,274,109,55,110
2011,Liverpool 027E,E01006718,1207,809,398,165,65,168
2011,Liverpool 027F,E01006719,1109,783,326,130,76,120
2011,Liverpool 027G,E01032508,1296,802,494,141,77,276
2011,Liverpool 027H,E01032509,1053,719,334,106,54,174
2011,Liverpool 028A,E01006690,1227,790,437,107,94,236
2011,Liverpool 028B,E01006692,1644,1014,630,178,126,326
2011,Liverpool 028C,E01006695,1496,962,534,81,131,322
2011,Liverpool 028D,E01006759,848,574,274,75,51,148
2011,Liverpool 028E,E01006760,1365,841,524,118,117,289
2011,Liverpool 029A,E01006565,1119,750,369,169,47,153
2011,Liverpool 029B,E01006569,1035,609,426,182,48,196
2011,Liverpool 029C,E01006573,1055,702,353,134,51,168
2011,Liverpool 029D,E01006712,949,656,293,116,39,138
2011,Liverpool 029E,E01006713,994,715,279,122,32,125
2011,Liverpool 030A,E01006691,1110,674,436,101,101,234
2011,Liverpool 030B,E01006694,1392,911,481,90,110,281
2011,Liverpool 030C,E01006696,1286,743,543,132,145,266
2011,Liverpool 030D,E01006697,1365,843,522,115,115,292
2011,Liverpool 030E,E01006746,1209,583,626,167,229,230
2011,Liverpool 031A,E01006512,1666,645,1021,32,822,167
2011,Liverpool 031B,E01006747,3367,1372,1995,95,1729,171
2011,Liverpool 031C,E01006748,1701,820,881,109,642,130
2011,Liverpool 031F,E01006751,2116,841,1275,207,772,296
2011,Liverpool 031G,E01033763,1279,642,637,191,185,261
2011,Liverpool 032A,E01006566,1078,763,315,155,60,100
2011,Liverpool 032B,E01006585,1005,592,413,158,49,206
2011,Liverpool 032C,E01006586,1460,989,471,174,90,207
2011,Liverpool 032D,E01006587,1280,877,403,185,54,164
2011,Liverpool 032E,E01006716,1117,724,393,99,46,248
2011,Liverpool 034A,E01006575,956,631,325,154,60,111
2011,Liverpool 034B,E01006576,1264,945,319,178,56,85
2011,Liverpool 034C,E01006577,1106,811,295,160,62,73
2011,Liverpool 034D,E01006579,1177,857,320,197,49,74
2011,Liverpool 034E,E01006584,1042,744,298,165,43,90
2011,Liverpool 035A,E01006720,1604,967,637,85,283,269
2011,Liverpool 035B,E01006725,1199,789,410,143,74,193
2011,Liverpool 035C,E01006726,1262,779,483,77,245,161
2011,Liverpool 035D,E01006727,1157,832,325,102,92,131
2011,Liverpool 035E,E01006728,1229,770,459,104,113,242
2011,Liverpool 035F,E01006752,801,472,329,99,87,143
2011,Liverpool 036A,E01006578,1020,760,260,137,45,78
2011,Liverpool 036B,E01006580,1015,749,266,152,57,57
2011,Liverpool 036C,E01006581,1152,818,334,187,71,76
2011,Liverpool 036D,E01006773,1049,747,302,171,52,79
2011,Liverpool 036E,E01006774,1082,799,283,127,70,86
2011,Liverpool 037A,E01006514,1955,1129,826,95,525,206
2011,Liverpool 037B,E01006515,921,557,364,104,75,185
2011,Liverpool 037D,E01006673,1425,833,592,117,188,287
2011,Liverpool 037E,E01033757,960,429,531,21,428,82
2011,Liverpool 037F,E01033768,1102,700,402,45,155,202
2011,Liverpool 038A,E01006550,1466,687,779,51,672,56
2011,Liverpool 038B,E01006557,1874,895,979,55,839,85
2011,Liverpool 038C,E01006721,1265,775,490,96,170,224
2011,Liverpool 038D,E01006722,1541,882,659,60,485,114
2011,Liverpool 038E,E01006723,1639,849,790,122,509,159
2011,Liverpool 038F,E01006724,1610,805,805,81,643,81
2011,Liverpool 039A,E01006552,1403,848,555,83,168,304
2011,Liverpool 039B,E01006556,1510,835,675,102,186,387
2011,Liverpool 039C,E01006674,1277,622,655,142,138,375
2011,Liverpool 039D,E01006679,1460,720,740,131,197,412
2011,Liverpool 040A,E01006709,1064,685,379,126,66,187
2011,Liverpool 040B,E01006769,894,482,412,178,52,182
2011,Liverpool 040C,E01006770,712,429,283,112,40,131
2011,Liverpool 040D,E01006771,1049,582,467,196,68,203
2011,Liverpool 040E,E01006772,820,512,308,138,39,131
2011,Liverpool 040F,E01006775,986,512,474,186,54,234
2011,Liverpool 041A,E01006582,1192,860,332,174,95,63
2011,Liverpool 041B,E01006589,1116,834,282,158,61,63
2011,Liverpool 041C,E01006591,1289,937,352,139,137,76
2011,Liverpool 041D,E01006592,1136,798,338,168,93,77
2011,Liverpool 041E,E01006597,1232,882,350,195,83,72
2011,Liverpool 042A,E01006553,1673,987,686,82,526,78
2011,Liverpool 042C,E01006588,1264,921,343,123,118,102
2011,Liverpool 042D,E01006590,1369,977,392,102,196,94
2011,Liverpool 042E,E01006593,1255,894,361,94,191,76
2011,Liverpool 042F,E01033749,1114,321,793,14,760,19
2011,Liverpool 042G,E01033766,926,628,298,63,182,53
2011,Liverpool 043A,E01006520,1523,1174,349,114,65,170
2011,Liverpool 043B,E01006549,1456,982,474,81,177,216
2011,Liverpool 043C,E01006675,1604,1116,488,110,99,279
2011,Liverpool 043D,E01006677,704,349,355,65,52,238
2011,Liverpool 044A,E01006518,1229,669,560,167,82,311
2011,Liverpool 044B,E01006630,970,531,439,95,67,277
2011,Liverpool 044C,E01006632,1352,837,515,160,80,275
2011,Liverpool 044D,E01006676,1208,658,550,116,121,313
2011,Liverpool 044E,E01006678,1657,890,767,230,155,382
2011,Liverpool 045A,E01006706,1010,538,472,191,57,224
2011,Liverpool 045B,E01006707,935,497,438,186,47,205
2011,Liverpool 045C,E01006708,1257,817,440,171,72,197
2011,Liverpool 045D,E01006710,1139,757,382,182,57,143
2011,Liverpool 046A,E01006792,964,647,317,205,48,64
2011,Liverpool 046B,E01006794,1196,818,378,216,47,115
2011,Liverpool 046C,E01006800,1002,620,382,263,49,70
2011,Liverpool 046D,E01006801,1000,692,308,226,28,54
2011,Liverpool 047A,E01006532,1132,763,369,216,72,81
2011,Liverpool 047B,E01006539,1117,766,351,200,59,92
2011,Liverpool 047C,E01006583,1408,898,510,163,306,41
2011,Liverpool 047D,E01006594,1054,714,340,204,73,63
2011,Liverpool 047E,E01006796,1166,784,382,214,88,80
2011,Liverpool 048A,E01006522,1564,1161,403,75,74,254
2011,Liverpool 048B,E01006524,2033,930,1103,132,900,71
2011,Liverpool 048C,E01006526,1029,760,269,141,35,93
2011,Liverpool 048D,E01006529,1007,751,256,132,49,75
2011,Liverpool 048E,E01006551,1298,578,720,187,322,211
2011,Liverpool 048F,E01006554,1500,875,625,81,416,128
2011,Liverpool 049A,E01006525,942,679,263,151,60,52
2011,Liverpool 049B,E01006595,1313,950,363,190,70,103
2011,Liverpool 049C,E01006596,1095,813,282,130,61,91
2011,Liverpool 049D,E01006689,1215,919,296,175,48,73
2011,Liverpool 050B,E01006633,1036,525,511,161,50,300
2011,Liverpool 050F,E01032505,999,650,349,129,71,149
2011,Liverpool 050G,E01032506,1106,761,345,148,50,147
2011,Liverpool 050H,E01032507,1285,961,324,127,91,106
2011,Liverpool 050I,E01033748,1174,993,181,37,100,44
2011,Liverpool 050J,E01033767,822,519,303,96,46,161
2011,Liverpool 051A,E01006793,1070,707,363,186,61,116
2011,Liverpool 051B,E01006795,1052,782,270,153,49,68
2011,Liverpool 051C,E01006797,1099,721,378,123,47,208
2011,Liverpool 051D,E01006798,1071,761,310,182,43,85
2011,Liverpool 051E,E01006799,1294,760,534,291,35,208
2011,Liverpool 052A,E01006521,1256,877,379,166,68,145
2011,Liverpool 052B,E01006523,1242,902,340,99,69,172
2011,Liverpool 052C,E01006528,1157,838,319,106,113,100
2011,Liverpool 052D,E01006628,1525,992,533,123,283,127
2011,Liverpool 052E,E01006629,1008,673,335,166,51,118
2011,Liverpool 053A,E01006527,1103,736,367,178,108,81
2011,Liverpool 053B,E01006680,1182,843,339,206,60,73
2011,Liverpool 053C,E01006682,963,687,276,177,47,52
2011,Liverpool 053D,E01006683,1118,800,318,196,51,71
2011,Liverpool 053E,E01006686,1060,718,342,188,86,68
2011,Liverpool 054A,E01006534,1158,779,379,137,82,160
2011,Liverpool 054B,E01006535,1222,834,388,172,60,156
2011,Liverpool 054C,E01006536,1386,894,492,200,76,216
2011,Liverpool 054D,E01006681,1176,780,396,179,59,158
2011,Liverpool 055A,E01006530,1005,683,322,203,49,70
2011,Liverpool 055B,E01006531,997,597,400,271,55,74
2011,Liverpool 055C,E01006533,992,640,352,202,45,105
2011,Liverpool 055D,E01006537,1728,1272,456,188,69,199
2011,Liverpool 055E,E01006538,972,693,279,137,46,96
2011,Liverpool 056A,E01006519,949,676,273,163,63,47
2011,Liverpool 056B,E01006684,1629,1256,373,217,65,91
2011,Liverpool 056C,E01006685,1121,738,383,222,77,84
2011,Liverpool 056D,E01006687,1483,1054,429,195,57,177
2011,Liverpool 056E,E01006688,1174,828,346,196,52,98
2011,Liverpool 057A,E01006740,943,544,399,129,47,223
2011,Liverpool 057B,E01006742,1056,738,318,114,58,146
2011,Liverpool 057C,E01006744,1125,817,308,129,37,142
2011,Liverpool 057D,E01006745,1422,1003,419,116,65,238
2011,Liverpool 058A,E01006738,1078,665,413,136,64,213
2011,Liverpool 058B,E01006739,1233,757,476,131,65,280
2011,Liverpool 058C,E01006741,1335,809,526,170,62,294
2011,Liverpool 058D,E01006743,1619,1164,455,153,78,224
2011,Liverpool 059A,E01006753,1090,652,438,133,53,252
2011,Liverpool 059B,E01006754,1199,734,465,163,60,242
2011,Liverpool 059C,E01006755,1082,646,436,88,54,294
2011,Liverpool 059D,E01006756,1236,757,479,110,64,305
2011,Liverpool 059E,E01006757,1027,598,429,117,74,238
2011,Liverpool 059F,E01006758,1062,643,419,118,67,234
2011,Liverpool 060A,E01006513,2853,1312,1541,25,1419,97
2011,Liverpool 060B,E01033758,1672,607,1065,27,942,96
2011,Liverpool 060C,E01033760,2098,1025,1073,12,1025,36
2011,Liverpool 060D,E01033761,1350,1017,333,3,279,51
2011,Liverpool 060E,E01033762,1746,798,948,34,849,65
2011,Liverpool 061A,E01033750,1360,1088,272,53,152,67
2011,Liverpool 061B,E01033754,1310,959,351,87,152,112
2011,Liverpool 061C,E01033756,1139,767,372,30,301,41
2011,Liverpool 061D,E01033765,1020,614,406,126,58,222
2011,Liverpool 062A,E01033751,1753,966,787,74,581,132
2011,Liverpool 062B,E01033752,1158,966,192,10,155,27
2011,Liverpool 062C,E01033753,1021,831,190,7,157,26
2011,Liverpool 062D,E01033755,1043,857,186,6,156,24
2011,Sefton 001A,E01006946,970,592,378,276,21,81
2011,Sefton 001B,E01007028,1005,695,310,199,29,82
2011,Sefton 001C,E01007029,847,454,393,302,29,62
2011,Sefton 001D,E01007030,1055,743,312,144,54,114
2011,Sefton 001E,E01007036,925,620,305,216,25,64
2011,Sefton 002A,E01006947,1037,678,359,238,42,79
2011,Sefton 002B,E01007031,1052,732,320,196,51,73
2011,Sefton 002C,E01007032,937,657,280,177,28,75
2011,Sefton 002D,E01007033,1034,705,329,208,38,83
2011,Sefton 002E,E01007035,981,653,328,220,21,87
2011,Sefton 003A,E01006944,1037,556,481,331,17,133
2011,Sefton 003B,E01006948,941,537,404,237,40,127
2011,Sefton 003C,E01006949,977,570,407,299,35,73
2011,Sefton 003D,E01006951,1038,616,422,297,29,96
2011,Sefton 003E,E01007034,945,676,269,192,31,46
2011,Sefton 004A,E01006945,1135,742,393,222,34,137
2011,Sefton 004B,E01006950,1160,755,405,190,31,184
2011,Sefton 004C,E01006968,1276,867,409,163,50,196
2011,Sefton 004D,E01006969,1061,762,299,129,49,121
2011,Sefton 004F,E01033094,813,535,278,118,23,137
2011,Sefton 004G,E01033097,799,542,257,135,18,104
2011,Sefton 005A,E01007055,1044,649,395,128,61,206
2011,Sefton 005B,E01007056,1175,881,294,133,46,115
2011,Sefton 005C,E01007057,1110,821,289,154,33,102
2011,Sefton 005D,E01007062,1047,771,276,147,53,76
2011,Sefton 005E,E01007063,1104,833,271,133,46,92
2011,Sefton 006A,E01007058,1109,830,279,126,37,116
2011,Sefton 006B,E01007059,1087,814,273,142,38,93
2011,Sefton 006C,E01007060,1020,700,320,123,36,161
2011,Sefton 006D,E01007061,1074,813,261,105,51,105
2011,Sefton 006E,E01007064,965,687,278,122,54,102
2011,Sefton 007A,E01006934,1105,800,305,150,50,105
2011,Sefton 007B,E01006970,1215,836,379,168,46,165
2011,Sefton 007C,E01006994,1130,826,304,118,44,142
2011,Sefton 007D,E01006996,1137,819,318,138,47,133
2011,Sefton 007E,E01006998,1202,898,304,128,54,122
2011,Sefton 008A,E01006995,967,699,268,125,51,92
2011,Sefton 008B,E01006997,1128,859,269,117,56,96
2011,Sefton 008C,E01006999,1185,811,374,239,45,90
2011,Sefton 008D,E01007000,937,658,279,111,52,116
2011,Sefton 008E,E01007001,1129,815,314,128,50,136
2011,Sefton 008F,E01007002,973,667,306,210,23,73
2011,Sefton 009A,E01006928,1050,728,322,203,51,68
2011,Sefton 009B,E01006935,1199,854,345,184,68,93
2011,Sefton 009C,E01006971,1060,601,459,307,36,116
2011,Sefton 009D,E01006972,994,527,467,364,38,65
2011,Sefton 009E,E01006973,983,560,423,258,58,107
2011,Sefton 009F,E01006974,1150,740,410,247,72,91
2011,Sefton 010A,E01006929,1163,859,304,153,56,95
2011,Sefton 010B,E01006930,1042,765,277,156,32,89
2011,Sefton 010C,E01006931,1100,828,272,177,37,58
2011,Sefton 010D,E01006932,1121,795,326,214,49,63
2011,Sefton 010E,E01006933,1004,733,271,130,40,101
2011,Sefton 011A,E01006920,1095,734,361,209,57,95
2011,Sefton 011B,E01006924,995,589,406,215,35,156
2011,Sefton 011C,E01006925,1102,746,356,143,58,155
2011,Sefton 011D,E01006927,1139,750,389,235,40,114
2011,Sefton 012A,E01006921,941,542,399,322,31,46
2011,Sefton 012B,E01006922,1084,658,426,323,36,67
2011,Sefton 012C,E01006923,1012,582,430,325,35,70
2011,Sefton 012D,E01006926,1181,712,469,363,40,66
2011,Sefton 013A,E01006985,1054,695,359,245,51,63
2011,Sefton 013B,E01006986,954,533,421,297,39,85
2011,Sefton 013C,E01006987,889,547,342,258,35,49
2011,Sefton 013D,E01006989,966,554,412,287,34,91
2011,Sefton 013E,E01006990,903,605,298,229,31,38
2011,Sefton 014A,E01006988,959,615,344,228,33,83
2011,Sefton 014B,E01007079,1090,697,393,269,46,78
2011,Sefton 014C,E01007080,1044,675,369,252,35,82
2011,Sefton 014D,E01007081,1006,675,331,238,36,57
2011,Sefton 015A,E01006991,1075,657,418,317,52,49
2011,Sefton 015B,E01006992,777,520,257,162,40,55
2011,Sefton 015C,E01006993,1093,735,358,264,50,44
2011,Sefton 015D,E01007078,1081,721,360,251,50,59
2011,Sefton 016A,E01007075,966,608,358,263,32,63
2011,Sefton 016B,E01007076,996,669,327,215,42,70
2011,Sefton 016C,E01007077,1066,764,302,177,49,76
2011,Sefton 016D,E01007082,1021,678,343,234,41,68
2011,Sefton 017A,E01007067,1060,753,307,210,36,61
2011,Sefton 017B,E01007068,987,736,251,162,34,55
2011,Sefton 017C,E01007069,1024,685,339,203,35,101
2011,Sefton 017D,E01007070,1091,723,368,264,44,60
2011,Sefton 017E,E01007101,1037,714,323,231,41,51
2011,Sefton 018C,E01007095,1086,754,332,223,53,56
2011,Sefton 018D,E01007096,985,691,294,210,36,48
2011,Sefton 018E,E01007100,1018,721,297,200,42,55
2011,Sefton 018F,E01033096,1936,1248,688,381,73,234
2011,Sefton 019A,E01007074,1084,752,332,184,48,100
2011,Sefton 019B,E01007097,1119,753,366,245,46,75
2011,Sefton 019C,E01007098,1028,685,343,234,39,70
2011,Sefton 019D,E01007099,1001,643,358,244,38,76
2011,Sefton 020A,E01007065,1016,761,255,150,31,74
2011,Sefton 020B,E01007066,1161,872,289,169,43,77
2011,Sefton 020C,E01007071,943,637,306,196,46,64
2011,Sefton 020D,E01007072,970,570,400,288,35,77
2011,Sefton 020E,E01007073,978,735,243,155,38,50
2011,Sefton 021A,E01007020,1013,688,325,123,64,138
2011,Sefton 021B,E01007022,1044,672,372,174,51,147
2011,Sefton 021C,E01007023,1000,709,291,175,51,65
2011,Sefton 021D,E01007027,1619,1084,535,345,84,106
2011,Sefton 021E,E01007037,1132,765,367,245,41,81
2011,Sefton 021F,E01007038,1127,741,386,204,52,130
2011,Sefton 022A,E01006936,1080,715,365,234,50,81
2011,Sefton 022B,E01006937,948,663,285,178,43,64
2011,Sefton 022C,E01006938,883,522,361,234,51,76
2011,Sefton 022D,E01006939,1090,795,295,148,57,90
2011,Sefton 022E,E01006940,1025,680,345,195,64,86
2011,Sefton 022F,E01006943,922,677,245,152,57,36
2011,Sefton 023A,E01007083,890,613,277,151,38,88
2011,Sefton 023B,E01007085,940,590,350,117,62,171
2011,Sefton 023C,E01007086,827,504,323,120,32,171
2011,Sefton 023D,E01007091,952,608,344,184,38,122
2011,Sefton 023E,E01007092,766,504,262,115,27,120
2011,Sefton 024A,E01006979,1019,605,414,128,61,225
2011,Sefton 024B,E01006980,1030,618,412,121,51,240
2011,Sefton 024C,E01007024,804,493,311,98,38,175
2011,Sefton 024D,E01007026,819,505,314,128,43,143
2011,Sefton 024E,E01007089,966,591,375,121,39,215
2011,Sefton 025A,E01007021,972,696,276,180,54,42
2011,Sefton 025B,E01007025,1016,689,327,215,49,63
2011,Sefton 025C,E01007105,1162,836,326,197,61,68
2011,Sefton 025D,E01007106,1075,757,318,201,35,82
2011,Sefton 025E,E01007107,971,703,268,149,55,64
2011,Sefton 025F,E01007108,1177,872,305,163,72,70
2011,Sefton 026A,E01007039,912,671,241,120,38,83
2011,Sefton 026B,E01007040,1746,1070,676,200,57,419
2011,Sefton 026C,E01007042,925,647,278,163,31,84
2011,Sefton 026D,E01007044,936,605,331,223,29,79
2011,Sefton 026E,E01007045,888,645,243,143,29,71
2011,Sefton 027A,E01007041,1034,749,285,129,59,97
2011,Sefton 027B,E01007043,1029,686,343,220,42,81
2011,Sefton 027C,E01007046,1195,849,346,163,62,121
2011,Sefton 027D,E01007053,1028,752,276,131,39,106
2011,Sefton 027E,E01007084,1088,859,229,122,34,73
2011,Sefton 028A,E01006941,1164,822,342,166,63,113
2011,Sefton 028B,E01006942,1118,834,284,149,49,86
2011,Sefton 028C,E01006954,1142,784,358,170,58,130
2011,Sefton 028D,E01007104,1010,758,252,143,36,73
2011,Sefton 028E,E01007109,1112,800,312,173,43,96
2011,Sefton 029A,E01007048,1140,745,395,99,61,235
2011,Sefton 029B,E01007054,1048,681,367,176,51,140
2011,Sefton 029C,E01007087,971,614,357,107,49,201
2011,Sefton 029D,E01007088,938,666,272,107,44,121
2011,Sefton 029E,E01007090,820,505,315,107,42,166
2011,Sefton 030A,E01006955,1244,941,303,149,65,89
2011,Sefton 030B,E01006956,1198,874,324,112,65,147
2011,Sefton 030C,E01006958,1118,794,324,131,47,146
2011,Sefton 030D,E01007102,1124,853,271,118,52,101
2011,Sefton 030E,E01007103,1083,783,300,188,59,53
2011,Sefton 031A,E01006978,1071,778,293,150,48,95
2011,Sefton 031B,E01006981,1065,665,400,118,59,223
2011,Sefton 031C,E01006982,975,683,292,171,35,86
2011,Sefton 031D,E01006983,1208,895,313,153,40,120
2011,Sefton 031E,E01006984,871,558,313,101,46,166
2011,Sefton 032A,E01006952,1046,672,374,107,61,206
2011,Sefton 032B,E01006953,1095,718,377,165,51,161
2011,Sefton 032C,E01006957,1222,765,457,158,36,263
2011,Sefton 032D,E01006959,1150,776,374,195,54,125
2011,Sefton 032E,E01006977,1132,650,482,262,55,165
2011,Sefton 033A,E01006976,1088,796,292,142,47,103
2011,Sefton 033B,E01007014,1172,826,346,209,51,86
2011,Sefton 033E,E01007047,1055,661,394,173,54,167
2011,Sefton 033F,E01033095,1382,959,423,270,53,100
2011,Sefton 034A,E01007004,1059,646,413,132,75,206
2011,Sefton 034B,E01007005,955,551,404,97,45,262
2011,Sefton 034C,E01007011,1099,656,443,129,74,240
2011,Sefton 034D,E01007016,1334,889,445,138,90,217
2011,Sefton 034E,E01007017,1168,729,439,135,48,256
2011,Sefton 035A,E01007019,956,554,402,103,66,233
2011,Sefton 035B,E01007049,1101,771,330,146,39,145
2011,Sefton 035C,E01007050,963,662,301,154,43,104
2011,Sefton 035D,E01007051,877,525,352,129,44,179
2011,Sefton 035E,E01007052,981,642,339,112,49,178
2011,Sefton 036A,E01006964,1108,752,356,127,62,167
2011,Sefton 036B,E01007003,893,553,340,95,37,208
2011,Sefton 036C,E01007006,1007,590,417,137,50,230
2011,Sefton 036D,E01007012,1002,703,299,98,44,157
2011,Sefton 036E,E01007013,1057,690,367,119,49,199
2011,Sefton 037A,E01006967,1107,666,441,189,53,199
2011,Sefton 037B,E01007007,946,521,425,137,49,239
2011,Sefton 037C,E01007008,982,591,391,108,50,233
2011,Sefton 037D,E01007009,1007,596,411,138,22,251
2011,Sefton 037E,E01007010,786,459,327,90,51,186
2011,Sefton 038A,E01006960,881,603,278,154,36,88
2011,Sefton 038B,E01006961,1115,750,365,128,57,180
2011,Sefton 038C,E01006962,1024,697,327,166,42,119
2011,Sefton 038D,E01006963,1059,666,393,108,52,233
2011,Sefton 038E,E01006965,1037,623,414,135,70,209
2011,Sefton 038F,E01006966,1134,785,349,150,74,125
2011,St. Helens 001A,E01006882,861,554,307,231,45,31
2011,St. Helens 001B,E01006883,973,606,367,271,37,59
2011,St. Helens 001C,E01006884,1000,617,383,236,47,100
2011,St. Helens 001D,E01006885,957,639,318,220,39,59
2011,St. Helens 001E,E01006886,990,630,360,286,32,42
2011,St. Helens 001F,E01006887,966,625,341,199,43,99
2011,St. Helens 002A,E01006802,1276,807,469,294,53,122
2011,St. Helens 002B,E01006804,1231,754,477,292,45,140
2011,St. Helens 002C,E01006806,1149,722,427,322,50,55
2011,St. Helens 002D,E01006807,1016,628,388,315,25,48
2011,St. Helens 003A,E01006803,1108,745,363,245,29,89
2011,St. Helens 003B,E01006805,1135,781,354,180,45,129
2011,St. Helens 003C,E01006808,1067,774,293,179,40,74
2011,St. Helens 003D,E01006809,1170,768,402,292,36,74
2011,St. Helens 004A,E01006849,1020,608,412,164,41,207
2011,St. Helens 004B,E01006850,1056,638,418,178,38,202
2011,St. Helens 004C,E01006851,963,602,361,219,41,101
2011,St. Helens 004D,E01006852,1055,741,314,205,40,69
2011,St. Helens 004E,E01006853,1074,758,316,178,47,91
2011,St. Helens 004F,E01006854,1092,782,310,150,38,122
2011,St. Helens 004G,E01006855,1081,664,417,221,36,160
2011,St. Helens 005A,E01006836,1065,639,426,239,43,144
2011,St. Helens 005B,E01006839,1032,739,293,161,35,97
2011,St. Helens 005C,E01006840,1163,820,343,198,27,118
2011,St. Helens 005D,E01006842,1048,719,329,93,50,186
2011,St. Helens 006A,E01006837,1120,760,360,188,35,137
2011,St. Helens 006B,E01006838,1061,703,358,186,36,136
2011,St. Helens 006C,E01006841,1258,942,316,185,47,84
2011,St. Helens 006D,E01006843,897,521,376,224,42,110
2011,St. Helens 007A,E01006914,890,581,309,230,38,41
2011,St. Helens 007B,E01006915,1166,784,382,193,59,130
2011,St. Helens 007C,E01006916,1172,823,349,170,43,136
2011,St. Helens 007D,E01006917,1181,847,334,206,59,69
2011,St. Helens 007E,E01006918,927,715,212,107,45,60
2011,St. Helens 007F,E01006919,1043,670,373,101,63,209
2011,St. Helens 008A,E01006810,1041,669,372,252,43,77
2011,St. Helens 008B,E01006811,1030,661,369,227,22,120
2011,St. Helens 008C,E01006812,975,633,342,107,44,191
2011,St. Helens 008D,E01006813,1121,736,385,171,44,170
2011,St. Helens 008E,E01006814,1242,886,356,239,29,88
2011,St. Helens 008F,E01006815,954,601,353,178,51,124
2011,St. Helens 008G,E01006818,1042,729,313,201,25,87
2011,St. Helens 009A,E01006822,999,684,315,222,37,56
2011,St. Helens 009B,E01006823,824,506,318,242,26,50
2011,St. Helens 009C,E01006824,862,607,255,171,37,47
2011,St. Helens 009D,E01006825,1077,681,396,274,63,59
2011,St. Helens 010A,E01006866,1080,680,400,153,41,206
2011,St. Helens 010B,E01006867,1522,1179,343,158,64,121
2011,St. Helens 010C,E01006868,1052,701,351,142,44,165
2011,St. Helens 010D,E01006869,1120,722,398,177,49,172
2011,St. Helens 011A,E01006819,1140,756,384,161,38,185
2011,St. Helens 011B,E01006820,1033,622,411,121,53,237
2011,St. Helens 011C,E01006821,961,588,373,117,38,218
2011,St. Helens 011D,E01006871,1071,643,428,113,55,260
2011,St. Helens 012A,E01006832,1262,959,303,77,48,178
2011,St. Helens 012B,E01006834,911,597,314,122,34,158
2011,St. Helens 012C,E01006877,1112,666,446,213,39,194
2011,St. Helens 012D,E01006880,1082,647,435,147,45,243
2011,St. Helens 012E,E01006881,1116,705,411,159,51,201
2011,St. Helens 013A,E01006863,1208,802,406,155,36,215
2011,St. Helens 013B,E01006864,1466,1126,340,163,61,116
2011,St. Helens 013C,E01006865,1209,737,472,201,43,228
2011,St. Helens 014A,E01006845,1128,767,361,153,43,165
2011,St. Helens 014B,E01006870,1029,702,327,148,34,145
2011,St. Helens 014C,E01006872,1114,717,397,142,34,221
2011,St. Helens 014D,E01006873,811,416,395,132,34,229
2011,St. Helens 014E,E01006874,870,489,381,119,38,224
2011,St. Helens 015A,E01006856,1032,803,229,125,35,69
2011,St. Helens 015B,E01006857,1089,765,324,195,61,68
2011,St. Helens 015C,E01006858,1057,706,351,124,58,169
2011,St. Helens 015D,E01006859,1240,916,324,211,49,64
2011,St. Helens 015E,E01006860,1045,746,299,133,33,133
2011,St. Helens 015F,E01006861,1076,644,432,125,72,235
2011,St. Helens 015G,E01006862,960,642,318,148,42,128
2011,St. Helens 016A,E01006831,1109,810,299,150,37,112
2011,St. Helens 016B,E01006833,1246,921,325,170,54,101
2011,St. Helens 016C,E01006835,1063,732,331,196,41,94
2011,St. Helens 016D,E01006876,1132,767,365,167,55,143
2011,St. Helens 016E,E01006878,1042,746,296,172,41,83
2011,St. Helens 016F,E01006879,1090,714,376,141,71,164
2011,St. Helens 016G,E01006904,1215,815,400,181,63,156
2011,St. Helens 017A,E01006816,1191,743,448,96,54,298
2011,St. Helens 017B,E01006817,959,556,403,121,40,242
2011,St. Helens 017C,E01006875,925,559,366,115,48,203
2011,St. Helens 017D,E01006899,1433,985,448,144,55,249
2011,St. Helens 018A,E01006826,1007,540,467,241,43,183
2011,St. Helens 018B,E01006827,1168,881,287,164,58,65
2011,St. Helens 018C,E01006828,1555,1059,496,325,77,94
2011,St. Helens 018D,E01006829,911,626,285,179,46,60
2011,St. Helens 019A,E01006830,940,563,377,137,35,205
2011,St. Helens 019C,E01006903,1090,676,414,179,41,194
2011,St. Helens 019D,E01006905,1026,624,402,158,38,206
2011,St. Helens 019E,E01006906,1124,802,322,157,50,115
2011,St. Helens 019F,E01006907,1162,774,388,197,40,151
2011,St. Helens 019G,E01006912,1078,731,347,122,63,162
2011,St. Helens 019H,E01006913,955,556,399,175,51,173
2011,St. Helens 019I,E01032904,1340,998,342,198,49,95
2011,St. Helens 019J,E01032905,1089,814,275,147,51,77
2011,St. Helens 020A,E01006844,1166,711,455,181,51,223
2011,St. Helens 020B,E01006846,1022,693,329,205,39,85
2011,St. Helens 020C,E01006847,1232,792,440,135,58,247
2011,St. Helens 020D,E01006848,1114,772,342,190,37,115
2011,St. Helens 020E,E01006896,1229,788,441,291,39,111
2011,St. Helens 020F,E01006897,1152,815,337,198,35,104
2011,St. Helens 020G,E01006901,1026,768,258,145,34,79
2011,St. Helens 021A,E01006890,1077,738,339,189,49,101
2011,St. Helens 021B,E01006892,901,597,304,174,51,79
2011,St. Helens 021C,E01006893,1013,722,291,162,41,88
2011,St. Helens 021D,E01006894,1017,630,387,298,29,60
2011,St. Helens 022A,E01006898,1169,724,445,262,39,144
2011,St. Helens 022B,E01006900,2025,1597,428,163,83,182
2011,St. Helens 022C,E01006908,1001,634,367,119,38,210
2011,St. Helens 022D,E01006909,865,440,425,116,51,258
2011,St. Helens 022E,E01006910,1291,875,416,156,51,209
2011,St. Helens 022F,E01006911,1223,749,474,338,35,101
2011,St. Helens 023A,E01006888,913,567,346,266,31,49
2011,St. Helens 023B,E01006889,1104,766,338,229,48,61
2011,St. Helens 023C,E01006891,966,642,324,179,56,89
2011,St. Helens 023D,E01006895,1002,567,435,340,36,59
2011,Wirral 001A,E01007229,1230,894,336,153,56,127
2011,Wirral 001B,E01007230,941,617,324,166,49,109
2011,Wirral 001C,E01007231,1201,856,345,158,54,133
2011,Wirral 001D,E01007237,1069,663,406,244,24,138
2011,Wirral 001E,E01007238,1187,736,451,189,48,214
2011,Wirral 002A,E01007218,1115,771,344,115,58,171
2011,Wirral 002B,E01007232,1106,735,371,140,49,182
2011,Wirral 002C,E01007233,1265,878,387,146,54,187
2011,Wirral 002D,E01007234,1195,822,373,172,57,144
2011,Wirral 002E,E01007236,981,687,294,123,53,118
2011,Wirral 003A,E01007307,1331,973,358,169,91,98
2011,Wirral 003B,E01007308,1090,752,338,226,41,71
2011,Wirral 003C,E01007312,1059,715,344,210,48,86
2011,Wirral 003D,E01007313,1137,758,379,227,51,101
2011,Wirral 003E,E01007315,1105,824,281,154,54,73
2011,Wirral 004A,E01007211,878,613,265,170,41,54
2011,Wirral 004B,E01007235,1091,783,308,162,51,95
2011,Wirral 004C,E01007310,1042,737,305,157,66,82
2011,Wirral 004D,E01007311,1133,786,347,222,61,64
2011,Wirral 004E,E01007314,1108,806,302,158,58,86
2011,Wirral 004F,E01007316,1158,802,356,205,65,86
2011,Wirral 005A,E01007215,1091,634,457,181,63,213
2011,Wirral 005B,E01007216,1115,782,333,131,50,152
2011,Wirral 005C,E01007219,1154,778,376,129,64,183
2011,Wirral 005D,E01007220,874,553,321,87,34,200
2011,Wirral 005E,E01007275,1141,793,348,122,40,186
2011,Wirral 006A,E01007203,1574,1220,354,189,57,108
2011,Wirral 006B,E01007205,1077,695,382,134,59,189
2011,Wirral 006C,E01007210,1433,937,496,190,68,238
2011,Wirral 006D,E01007309,1087,759,328,193,72,63
2011,Wirral 007A,E01007212,1093,720,373,206,56,111
2011,Wirral 007B,E01007213,1150,785,365,220,55,90
2011,Wirral 007C,E01007214,1088,671,417,199,40,178
2011,Wirral 007D,E01007217,1180,809,371,153,45,173
2011,Wirral 007E,E01007276,1094,770,324,140,55,129
2011,Wirral 008A,E01007272,1065,665,400,136,64,200
2011,Wirral 008B,E01007273,953,551,402,117,52,233
2011,Wirral 008C,E01007274,919,512,407,105,49,253
2011,Wirral 008D,E01007277,1034,655,379,117,55,207
2011,Wirral 008E,E01007278,1035,632,403,133,50,220
2011,Wirral 009A,E01007204,1081,607,474,101,73,300
2011,Wirral 009B,E01007206,1364,1014,350,138,56,156
2011,Wirral 009C,E01007207,954,470,484,165,40,279
2011,Wirral 009D,E01007209,899,476,423,225,28,170
2011,Wirral 010C,E01007269,1285,823,462,118,55,289
2011,Wirral 010D,E01007270,1276,834,442,140,60,242
2011,Wirral 010E,E01007271,1184,784,400,126,57,217
2011,Wirral 010F,E01032903,1767,1053,714,228,91,395
2011,Wirral 011A,E01007120,965,590,375,136,64,175
2011,Wirral 011B,E01007121,1060,610,450,126,33,291
2011,Wirral 011C,E01007122,985,451,534,153,43,338
2011,Wirral 011D,E01007123,1166,692,474,87,76,311
2011,Wirral 011E,E01007124,1037,567,470,116,63,291
2011,Wirral 012A,E01007208,1257,833,424,214,39,171
2011,Wirral 012B,E01007221,1069,714,355,199,42,114
2011,Wirral 012C,E01007225,1322,844,478,314,52,112
2011,Wirral 012D,E01007227,1032,637,395,141,63,191
2011,Wirral 012E,E01007228,1005,541,464,222,36,206
2011,Wirral 013A,E01007195,1178,807,371,233,65,73
2011,Wirral 013B,E01007199,1110,765,345,222,68,55
2011,Wirral 013C,E01007222,1207,870,337,201,42,94
2011,Wirral 013D,E01007223,1071,833,238,100,42,96
2011,Wirral 014A,E01007193,1128,752,376,220,58,98
2011,Wirral 014B,E01007194,1059,769,290,165,37,88
2011,Wirral 014C,E01007200,1210,891,319,201,59,59
2011,Wirral 014D,E01007201,1069,757,312,183,55,74
2011,Wirral 014E,E01007202,1008,681,327,145,63,119
2011,Wirral 015A,E01007125,1234,831,403,144,48,211
2011,Wirral 015B,E01007156,1155,790,365,198,36,131
2011,Wirral 015C,E01007157,1133,822,311,147,52,112
2011,Wirral 015D,E01007158,1142,790,352,215,50,87
2011,Wirral 015E,E01007159,1300,898,402,221,49,132
2011,Wirral 016A,E01007126,1510,944,566,136,67,363
2011,Wirral 016B,E01007127,1099,575,524,102,62,360
2011,Wirral 016C,E01007128,1212,632,580,188,69,323
2011,Wirral 016D,E01007129,1165,675,490,134,59,297
2011,Wirral 016E,E01007133,863,385,478,149,33,296
2011,Wirral 017A,E01007224,1117,778,339,224,56,59
2011,Wirral 017B,E01007226,1206,733,473,317,57,99
2011,Wirral 017C,E01007265,979,722,257,128,43,86
2011,Wirral 017D,E01007299,1015,738,277,154,44,79
2011,Wirral 017E,E01007306,1233,904,329,204,47,78
2011,Wirral 018A,E01007297,906,588,318,154,44,120
2011,Wirral 018B,E01007298,1069,725,344,226,47,71
2011,Wirral 018C,E01007301,1217,829,388,212,63,113
2011,Wirral 018D,E01007302,1075,707,368,194,42,132
2011,Wirral 018E,E01007305,1225,864,361,226,48,87
2011,Wirral 019A,E01007119,1029,610,419,156,56,207
2011,Wirral 019B,E01007161,1123,726,397,232,61,104
2011,Wirral 019C,E01007162,1034,621,413,121,77,215
2011,Wirral 019D,E01007300,1281,844,437,140,64,233
2011,Wirral 020A,E01007155,1368,866,502,195,63,244
2011,Wirral 020B,E01007160,1293,917,376,203,44,129
2011,Wirral 020C,E01007240,1222,833,389,170,39,180
2011,Wirral 020D,E01007241,995,663,332,231,34,67
2011,Wirral 020E,E01007242,1243,847,396,276,53,67
2011,Wirral 021A,E01007130,1241,823,418,107,62,249
2011,Wirral 021B,E01007131,1121,713,408,113,51,244
2011,Wirral 021C,E01007179,971,626,345,96,36,213
2011,Wirral 021D,E01007291,1282,819,463,136,57,270
2011,Wirral 021E,E01007292,1030,619,411,117,52,242
2011,Wirral 021F,E01007294,1023,727,296,99,41,156
2011,Wirral 022A,E01007180,1182,791,391,162,63,166
2011,Wirral 022B,E01007181,1079,792,287,119,50,118
2011,Wirral 022C,E01007239,1250,882,368,122,58,188
2011,Wirral 022D,E01007243,1223,792,431,258,59,114
2011,Wirral 022E,E01007244,1506,1089,417,120,75,222
2011,Wirral 023A,E01007259,889,652,237,149,40,48
2011,Wirral 023B,E01007261,976,610,366,275,45,46
2011,Wirral 023C,E01007264,1044,724,320,233,36,51
2011,Wirral 023D,E01007266,1054,770,284,177,49,58
2011,Wirral 023E,E01007267,1103,775,328,190,58,80
2011,Wirral 023F,E01007268,918,585,333,218,35,80
2011,Wirral 024A,E01007163,1740,1266,474,256,78,140
2011,Wirral 024B,E01007245,1144,773,371,243,38,90
2011,Wirral 024C,E01007246,1206,825,381,240,58,83
2011,Wirral 024D,E01007247,1308,952,356,221,57,78
2011,Wirral 024E,E01007252,1153,794,359,199,56,104
2011,Wirral 025A,E01007249,929,603,326,126,43,157
2011,Wirral 025B,E01007251,886,616,270,164,36,70
2011,Wirral 025C,E01007257,922,570,352,122,48,182
2011,Wirral 025D,E01007303,1010,589,421,156,35,230
2011,Wirral 025E,E01007304,1045,606,439,155,62,222
2011,Wirral 026A,E01007196,995,646,349,192,59,98
2011,Wirral 026B,E01007197,1151,801,350,212,63,75
2011,Wirral 026C,E01007198,1144,823,321,185,56,80
2011,Wirral 026D,E01007263,1033,616,417,226,40,151
2011,Wirral 026E,E01007282,1013,714,299,184,49,66
2011,Wirral 027A,E01007175,1325,799,526,152,71,303
2011,Wirral 027B,E01007290,1237,724,513,164,72,277
2011,Wirral 027C,E01007293,1002,500,502,144,57,301
2011,Wirral 027D,E01007295,873,545,328,75,50,203
2011,Wirral 027E,E01007296,1227,802,425,148,44,233
2011,Wirral 028A,E01007258,1089,727,362,243,45,74
2011,Wirral 028B,E01007260,1078,728,350,219,58,73
2011,Wirral 028C,E01007262,1057,700,357,239,57,61
2011,Wirral 028D,E01007281,924,577,347,252,45,50
2011,Wirral 028E,E01007283,891,532,359,220,62,77
2011,Wirral 029A,E01007173,1141,748,393,197,58,138
2011,Wirral 029B,E01007174,1134,817,317,147,50,120
2011,Wirral 029C,E01007176,1171,791,380,149,45,186
2011,Wirral 029D,E01007177,1077,688,389,205,50,134
2011,Wirral 029E,E01007178,1131,808,323,129,47,147
2011,Wirral 030A,E01007248,1127,770,357,187,52,118
2011,Wirral 030B,E01007250,1051,756,295,185,49,61
2011,Wirral 030C,E01007253,1098,708,390,173,49,168
2011,Wirral 030D,E01007254,1111,762,349,232,43,74
2011,Wirral 031A,E01007115,1153,789,364,182,52,130
2011,Wirral 031B,E01007138,1209,744,465,174,44,247
2011,Wirral 031C,E01007139,1169,799,370,138,50,182
2011,Wirral 031D,E01007141,1162,787,375,206,44,125
2011,Wirral 031E,E01007289,1102,607,495,97,61,337
2011,Wirral 032A,E01007111,1168,851,317,197,56,64
2011,Wirral 032B,E01007112,1113,765,348,195,40,113
2011,Wirral 032C,E01007113,983,706,277,170,43,64
2011,Wirral 032D,E01007114,1067,739,328,129,48,151
2011,Wirral 032E,E01007116,1096,786,310,200,45,65
2011,Wirral 033A,E01007280,1248,881,367,221,71,75
2011,Wirral 033B,E01007284,1224,813,411,282,55,74
2011,Wirral 033C,E01007285,1059,708,351,240,44,67
2011,Wirral 033D,E01007287,1305,844,461,304,49,108
2011,Wirral 034A,E01007183,948,651,297,181,43,73
2011,Wirral 034B,E01007255,1092,743,349,201,43,105
2011,Wirral 034C,E01007256,1098,681,417,299,39,79
2011,Wirral 034D,E01007279,1202,851,351,211,57,83
2011,Wirral 034E,E01007286,1060,706,354,226,39,89
2011,Wirral 035A,E01007110,1167,802,365,246,54,65
2011,Wirral 035B,E01007117,1186,903,283,162,58,63
2011,Wirral 035C,E01007118,1076,712,364,148,50,166
2011,Wirral 035D,E01007151,1106,776,330,201,55,74
2011,Wirral 035E,E01007154,1125,762,363,238,43,82
2011,Wirral 036A,E01007140,1265,912,353,157,45,151
2011,Wirral 036B,E01007142,1353,937,416,293,53,70
2011,Wirral 036C,E01007143,1233,940,293,131,45,117
2011,Wirral 036D,E01007152,1143,750,393,246,43,104
2011,Wirral 036E,E01007153,1016,611,405,238,46,121
2011,Wirral 037A,E01007182,1044,675,369,244,36,89
2011,Wirral 037B,E01007184,1037,716,321,224,48,49
2011,Wirral 037C,E01007185,1135,836,299,164,42,93
2011,Wirral 037D,E01007192,893,529,364,248,38,78
2011,Wirral 037E,E01007288,1112,671,441,291,53,97
2011,Wirral 038A,E01007144,938,631,307,206,34,67
2011,Wirral 038B,E01007145,1017,609,408,297,48,63
2011,Wirral 038C,E01007146,1169,835,334,251,39,44
2011,Wirral 038D,E01007147,1017,633,384,282,40,62
2011,Wirral 038E,E01007148,1253,761,492,346,48,98
2011,Wirral 039A,E01007135,1087,748,339,207,46,86
2011,Wirral 039B,E01007136,1201,779,422,156,48,218
2011,Wirral 039C,E01007137,1197,779,418,203,52,163
2011,Wirral 039D,E01007170,1103,743,360,260,41,59
2011,Wirral 040A,E01007186,1089,720,369,248,61,60
2011,Wirral 040B,E01007187,1048,647,401,288,41,72
2011,Wirral 040C,E01007188,1038,693,345,253,38,54
2011,Wirral 040D,E01007189,1090,698,392,294,37,61
2011,Wirral 040E,E01007190,1014,610,404,286,49,69
2011,Wirral 040F,E01007191,937,579,358,261,49,48
2011,Wirral 041A,E01007149,1087,714,373,277,43,53
2011,Wirral 041B,E01007150,1134,779,355,259,38,58
2011,Wirral 041C,E01007165,1001,652,349,265,39,45
2011,Wirral 041D,E01007171,1111,826,285,177,42,66
2011,Wirral 041E,E01007172,1061,733,328,247,32,49
2011,Wirral 042A,E01007164,1237,924,313,158,40,115
2011,Wirral 042B,E01007166,1112,730,382,286,34,62
2011,Wirral 042C,E01007167,1049,705,344,168,48,128
2011,Wirral 042D,E01007168,1164,740,424,187,38,199
2011,Wirral 042E,E01007169,1263,873,390,219,61,110
2011,East Riding of Yorkshire 001A,E01012933,802,450,352,291,14,47
2011,East Riding of Yorkshire 001B,E01012934,1132,701,431,295,37,99
2011,East Riding of Yorkshire 001C,E01012938,1664,931,733,527,43,163
2011,East Riding of Yorkshire 001D,E01012939,1306,738,568,449,30,89
2011,East Riding of Yorkshire 001E,E01012940,1213,695,518,418,26,74
2011,East Riding of Yorkshire 001F,E01012941,964,482,482,404,13,65
2011,East Riding of Yorkshire 002A,E01012929,1393,1020,373,187,67,119
2011,East Riding of Yorkshire 002B,E01012930,1021,651,370,253,31,86
2011,East Riding of Yorkshire 002C,E01012935,907,494,413,336,24,53
2011,East Riding of Yorkshire 002D,E01012937,1660,875,785,623,41,121
2011,East Riding of Yorkshire 002E,E01012942,841,394,447,391,12,44
2011,East Riding of Yorkshire 003A,E01012928,1155,664,491,212,56,223
2011,East Riding of Yorkshire 003B,E01012931,1099,562,537,285,32,220
2011,East Riding of Yorkshire 003C,E01012932,1139,685,454,231,62,161
2011,East Riding of Yorkshire 003D,E01012946,1084,584,500,223,46,231
2011,East Riding of Yorkshire 003E,E01012949,966,528,438,223,39,176
2011,East Riding of Yorkshire 004A,E01012936,940,511,429,322,27,80
2011,East Riding of Yorkshire 004B,E01012943,1186,788,398,193,44,161
2011,East Riding of Yorkshire 004C,E01012945,1180,716,464,201,53,210
2011,East Riding of Yorkshire 004D,E01012952,1108,711,397,193,32,172
2011,East Riding of Yorkshire 005A,E01012944,1129,673,456,170,50,236
2011,East Riding of Yorkshire 005B,E01012947,1046,656,390,242,35,113
2011,East Riding of Yorkshire 005C,E01012948,1088,650,438,172,44,222
2011,East Riding of Yorkshire 005D,E01012951,947,556,391,199,33,159
2011,East Riding of Yorkshire 006A,E01012950,988,598,390,276,35,79
2011,East Riding of Yorkshire 006B,E01012990,1037,739,298,187,33,78
2011,East Riding of Yorkshire 006C,E01012991,1197,793,404,250,51,103
2011,East Riding of Yorkshire 006D,E01012992,1152,740,412,261,40,111
2011,East Riding of Yorkshire 008A,E01012978,1011,659,352,276,26,50
2011,East Riding of Yorkshire 008B,E01012981,1107,743,364,211,43,110
2011,East Riding of Yorkshire 008C,E01012983,1328,954,374,242,37,95
2011,East Riding of Yorkshire 008D,E01012989,1264,824,440,313,44,83
2011,East Riding of Yorkshire 008E,E01013125,1312,953,359,238,48,73
2011,East Riding of Yorkshire 009A,E01013057,1145,830,315,234,34,47
2011,East Riding of Yorkshire 009B,E01013059,1219,896,323,242,32,49
2011,East Riding of Yorkshire 009C,E01013060,1340,955,385,292,36,57
2011,East Riding of Yorkshire 009D,E01013061,1179,839,340,248,36,56
2011,East Riding of Yorkshire 009E,E01013126,1744,987,757,165,49,543
2011,East Riding of Yorkshire 010A,E01012986,1180,716,464,324,30,110
2011,East Riding of Yorkshire 010B,E01012987,1285,884,401,265,51,85
2011,East Riding of Yorkshire 010C,E01012988,1140,856,284,174,25,85
2011,East Riding of Yorkshire 010D,E01013048,1555,1049,506,322,41,143
2011,East Riding of Yorkshire 011A,E01013052,1162,876,286,167,48,71
2011,East Riding of Yorkshire 011B,E01013053,993,615,378,294,26,58
2011,East Riding of Yorkshire 011C,E01013054,1405,1076,329,156,96,77
2011,East Riding of Yorkshire 011D,E01013055,1106,798,308,201,48,59
2011,East Riding of Yorkshire 011E,E01013056,1171,854,317,177,35,105
2011,East Riding of Yorkshire 011F,E01013058,1009,705,304,220,26,58
2011,East Riding of Yorkshire 011G,E01013119,1130,823,307,179,46,82
2011,East Riding of Yorkshire 012A,E01013046,1236,726,510,388,39,83
2011,East Riding of Yorkshire 012B,E01013047,1164,698,466,305,43,118
2011,East Riding of Yorkshire 012C,E01013049,1112,694,418,256,45,117
2011,East Riding of Yorkshire 012D,E01013050,1216,743,473,307,28,138
2011,East Riding of Yorkshire 012E,E01013051,1106,681,425,237,46,142
2011,East Riding of Yorkshire 013A,E01012922,1161,815,346,238,36,72
2011,East Riding of Yorkshire 013B,E01012923,1180,880,300,164,40,96
2011,East Riding of Yorkshire 013C,E01012925,976,709,267,167,35,65
2011,East Riding of Yorkshire 013D,E01012927,1187,813,374,269,49,56
2011,East Riding of Yorkshire 014A,E01012924,1306,970,336,235,44,57
2011,East Riding of Yorkshire 014B,E01012926,1813,1212,601,471,42,88
2011,East Riding of Yorkshire 014C,E01013027,1224,842,382,252,42,88
2011,East Riding of Yorkshire 014D,E01013034,1350,964,386,260,48,78
2011,East Riding of Yorkshire 015A,E01013120,1452,1027,425,299,41,85
2011,East Riding of Yorkshire 015B,E01013121,1489,1165,324,194,44,86
2011,East Riding of Yorkshire 015C,E01013123,1144,867,277,195,20,62
2011,East Riding of Yorkshire 015D,E01013124,1428,966,462,323,37,102
2011,East Riding of Yorkshire 016A,E01013064,1058,844,214,129,45,40
2011,East Riding of Yorkshire 016B,E01013065,1250,857,393,285,34,74
2011,East Riding of Yorkshire 016C,E01013066,1171,853,318,230,43,45
2011,East Riding of Yorkshire 016D,E01013067,1319,1013,306,203,49,54
2011,East Riding of Yorkshire 016E,E01013068,1006,621,385,284,37,64
2011,East Riding of Yorkshire 016F,E01013070,1052,709,343,238,40,65
2011,East Riding of Yorkshire 017A,E01013038,1026,698,328,118,45,165
2011,East Riding of Yorkshire 017B,E01013045,1043,742,301,116,50,135
2011,East Riding of Yorkshire 017C,E01013069,1180,852,328,207,41,80
2011,East Riding of Yorkshire 017D,E01013071,1129,725,404,196,42,166
2011,East Riding of Yorkshire 018A,E01013022,1472,1082,390,234,52,104
2011,East Riding of Yorkshire 018B,E01013023,1417,991,426,243,48,135
2011,East Riding of Yorkshire 018C,E01013024,1376,1020,356,225,54,77
2011,East Riding of Yorkshire 018D,E01013122,1121,854,267,159,47,61
2011,East Riding of Yorkshire 018E,E01013127,1126,817,309,202,36,71
2011,East Riding of Yorkshire 019A,E01013036,1160,885,275,156,40,79
2011,East Riding of Yorkshire 019B,E01013037,1153,908,245,135,38,72
2011,East Riding of Yorkshire 019C,E01013040,1512,1234,278,147,50,81
2011,East Riding of Yorkshire 019D,E01013041,1088,706,382,287,26,69
2011,East Riding of Yorkshire 019E,E01013062,1236,908,328,202,39,87
2011,East Riding of Yorkshire 019F,E01013063,1120,769,351,250,41,60
2011,East Riding of Yorkshire 020A,E01012919,1196,832,364,149,168,47
2011,East Riding of Yorkshire 020B,E01012921,827,598,229,152,30,47
2011,East Riding of Yorkshire 020C,E01013039,1352,956,396,253,50,93
2011,East Riding of Yorkshire 020D,E01013042,1200,909,291,184,53,54
2011,East Riding of Yorkshire 020E,E01013043,1043,794,249,126,62,61
2011,East Riding of Yorkshire 020F,E01013044,1203,905,298,190,52,56
2011,East Riding of Yorkshire 021A,E01013029,1089,719,370,227,22,121
2011,East Riding of Yorkshire 021B,E01013030,1139,744,395,265,38,92
2011,East Riding of Yorkshire 021C,E01013031,1173,762,411,272,56,83
2011,East Riding of Yorkshire 021D,E01013032,1100,748,352,246,33,73
2011,East Riding of Yorkshire 021E,E01013035,1055,710,345,249,29,67
2011,East Riding of Yorkshire 022A,E01012954,916,619,297,195,34,68
2011,East Riding of Yorkshire 022B,E01012956,900,623,277,177,42,58
2011,East Riding of Yorkshire 022C,E01012958,799,481,318,245,27,46
2011,East Riding of Yorkshire 022D,E01012961,1023,612,411,272,31,108
2011,East Riding of Yorkshire 022E,E01012966,977,643,334,234,40,60
2011,East Riding of Yorkshire 023A,E01012953,833,588,245,173,19,53
2011,East Riding of Yorkshire 023B,E01012955,1117,802,315,222,36,57
2011,East Riding of Yorkshire 023C,E01012959,1096,786,310,207,47,56
2011,East Riding of Yorkshire 023D,E01012962,811,584,227,164,33,30
2011,East Riding of Yorkshire 023E,E01012964,1189,828,361,207,53,101
2011,East Riding of Yorkshire 024A,E01012920,1101,802,299,201,31,67
2011,East Riding of Yorkshire 024B,E01012965,760,538,222,150,25,47
2011,East Riding of Yorkshire 024C,E01012967,1121,797,324,235,35,54
2011,East Riding of Yorkshire 024D,E01012968,1271,920,351,247,41,63
2011,East Riding of Yorkshire 024E,E01012969,1532,823,709,143,52,514
2011,East Riding of Yorkshire 025A,E01012957,2183,1034,1149,207,882,60
2011,East Riding of Yorkshire 025B,E01012960,1138,812,326,216,44,66
2011,East Riding of Yorkshire 025C,E01012963,982,604,378,237,27,114
2011,East Riding of Yorkshire 025D,E01013112,991,610,381,292,30,59
2011,East Riding of Yorkshire 026A,E01013018,1324,966,358,240,34,84
2011,East Riding of Yorkshire 026B,E01013019,926,688,238,138,33,67
2011,East Riding of Yorkshire 026C,E01013021,1151,807,344,232,27,85
2011,East Riding of Yorkshire 026D,E01013025,987,675,312,221,34,57
2011,East Riding of Yorkshire 026E,E01013026,1241,894,347,197,40,110
2011,East Riding of Yorkshire 027A,E01013105,1004,734,270,175,29,66
2011,East Riding of Yorkshire 027B,E01013110,1059,798,261,155,43,63
2011,East Riding of Yorkshire 027C,E01013111,1069,768,301,209,33,59
2011,East Riding of Yorkshire 027D,E01013115,1153,836,317,212,39,66
2011,East Riding of Yorkshire 027E,E01013117,1105,810,295,222,38,35
2011,East Riding of Yorkshire 028A,E01013108,1116,778,338,243,37,58
2011,East Riding of Yorkshire 028B,E01013113,1088,756,332,229,39,64
2011,East Riding of Yorkshire 028C,E01013114,1101,748,353,271,39,43
2011,East Riding of Yorkshire 028D,E01013116,1103,795,308,218,48,42
2011,East Riding of Yorkshire 028E,E01013118,1056,691,365,266,35,64
2011,East Riding of Yorkshire 029A,E01013094,1041,691,350,230,35,85
2011,East Riding of Yorkshire 029B,E01013095,1142,780,362,244,28,90
2011,East Riding of Yorkshire 029C,E01013096,1221,906,315,191,47,77
2011,East Riding of Yorkshire 029D,E01013097,1089,781,308,205,28,75
2011,East Riding of Yorkshire 029E,E01013102,1117,765,352,254,27,71
2011,East Riding of Yorkshire 031A,E01013028,1214,885,329,229,37,63
2011,East Riding of Yorkshire 031B,E01013078,1088,680,408,272,43,93
2011,East Riding of Yorkshire 031C,E01013081,1172,782,390,249,38,103
2011,East Riding of Yorkshire 031D,E01013082,1206,750,456,293,38,125
2011,East Riding of Yorkshire 031E,E01013085,1250,819,431,295,31,105
2011,East Riding of Yorkshire 032A,E01012970,1119,790,329,243,37,49
2011,East Riding of Yorkshire 032C,E01012972,1057,777,280,212,31,37
2011,East Riding of Yorkshire 032D,E01012973,2093,1737,356,185,73,98
2011,East Riding of Yorkshire 032E,E01012974,1102,803,299,205,31,63
2011,East Riding of Yorkshire 032F,E01013092,1458,1086,372,241,56,75
2011,East Riding of Yorkshire 032G,E01033495,1035,905,130,49,32,49
2011,East Riding of Yorkshire 032H,E01033496,1210,946,264,174,37,53
2011,East Riding of Yorkshire 033A,E01013033,1211,903,308,170,48,90
2011,East Riding of Yorkshire 033B,E01013098,1630,1180,450,270,57,123
2011,East Riding of Yorkshire 033C,E01013099,964,605,359,223,36,100
2011,East Riding of Yorkshire 033D,E01013100,1255,846,409,277,57,75
2011,East Riding of Yorkshire 033E,E01013101,1277,892,385,273,33,79
2011,East Riding of Yorkshire 034A,E01013008,1115,887,228,114,34,80
2011,East Riding of Yorkshire 034B,E01013009,1088,752,336,202,37,97
2011,East Riding of Yorkshire 034C,E01013013,1166,882,284,182,29,73
2011,East Riding of Yorkshire 034D,E01013014,1087,801,286,165,42,79
2011,East Riding of Yorkshire 034E,E01013107,1011,686,325,206,34,85
2011,East Riding of Yorkshire 035A,E01013088,1152,770,382,282,35,65
2011,East Riding of Yorkshire 035B,E01013089,1242,891,351,250,35,66
2011,East Riding of Yorkshire 035C,E01013090,1064,742,322,225,45,52
2011,East Riding of Yorkshire 035D,E01013091,1104,777,327,228,40,59
2011,East Riding of Yorkshire 035E,E01013093,1081,714,367,268,39,60
2011,East Riding of Yorkshire 036A,E01013005,961,648,313,208,29,76
2011,East Riding of Yorkshire 036B,E01013007,1119,867,252,157,28,67
2011,East Riding of Yorkshire 036C,E01013011,1108,842,266,167,36,63
2011,East Riding of Yorkshire 036D,E01013012,1041,819,222,147,24,51
2011,East Riding of Yorkshire 037A,E01012996,1152,870,282,205,23,54
2011,East Riding of Yorkshire 037B,E01012998,1619,1209,410,239,54,117
2011,East Riding of Yorkshire 037C,E01013015,1196,929,267,158,30,79
2011,East Riding of Yorkshire 037D,E01013016,1297,924,373,272,38,63
2011,East Riding of Yorkshire 038A,E01013003,1014,677,337,230,24,83
2011,East Riding of Yorkshire 038B,E01013017,1167,809,358,209,42,107
2011,East Riding of Yorkshire 038C,E01013020,1364,1045,319,195,37,87
2011,East Riding of Yorkshire 038D,E01013076,1085,749,336,193,39,104
2011,East Riding of Yorkshire 039A,E01013079,1158,706,452,301,40,111
2011,East Riding of Yorkshire 039B,E01013080,921,561,360,164,38,158
2011,East Riding of Yorkshire 039C,E01013083,1036,623,413,202,41,170
2011,East Riding of Yorkshire 039D,E01013084,983,496,487,241,38,208
2011,East Riding of Yorkshire 039E,E01013086,1143,680,463,270,47,146
2011,East Riding of Yorkshire 039F,E01013087,1032,657,375,215,24,136
2011,East Riding of Yorkshire 040A,E01012993,980,646,334,235,20,79
2011,East Riding of Yorkshire 040B,E01012997,1397,1046,351,167,49,135
2011,East Riding of Yorkshire 040C,E01012999,1302,1030,272,83,52,137
2011,East Riding of Yorkshire 040D,E01013001,1273,909,364,218,36,110
2011,East Riding of Yorkshire 040E,E01013074,1240,885,355,251,23,81
2011,East Riding of Yorkshire 041A,E01012994,1258,883,375,221,36,118
2011,East Riding of Yorkshire 041B,E01012995,1374,969,405,184,75,146
2011,East Riding of Yorkshire 041C,E01013000,1414,1024,390,135,51,204
2011,East Riding of Yorkshire 041D,E01013002,1159,813,346,136,46,164
2011,East Riding of Yorkshire 041E,E01013004,1193,854,339,143,60,136
2011,East Riding of Yorkshire 042A,E01013072,1230,871,359,218,35,106
2011,East Riding of Yorkshire 042B,E01013073,1220,895,325,210,34,81
2011,East Riding of Yorkshire 042C,E01013075,1037,741,296,195,26,75
2011,East Riding of Yorkshire 042D,E01013077,1456,1057,399,282,36,81
2011,East Riding of Yorkshire 043A,E01013006,1135,897,238,112,45,81
2011,East Riding of Yorkshire 043B,E01013010,1126,815,311,207,33,71
2011,East Riding of Yorkshire 043C,E01013103,1084,742,342,264,29,49
2011,East Riding of Yorkshire 043D,E01013104,929,628,301,215,23,63
2011,East Riding of Yorkshire 043E,E01013106,827,593,234,128,31,75
2011,East Riding of Yorkshire 043F,E01032596,1040,798,242,135,45,62
2011,East Riding of Yorkshire 044A,E01012975,1167,777,390,291,29,70
2011,East Riding of Yorkshire 044B,E01012977,1892,1419,473,281,77,115
2011,East Riding of Yorkshire 044C,E01012984,1246,922,324,214,34,76
2011,East Riding of Yorkshire 044D,E01012985,1222,793,429,290,38,101
2011,East Riding of Yorkshire 045A,E01012976,1072,726,346,174,39,133
2011,East Riding of Yorkshire 045B,E01012979,1126,777,349,216,33,100
2011,East Riding of Yorkshire 045C,E01012980,1262,887,375,184,44,147
2011,East Riding of Yorkshire 045D,E01012982,1188,877,311,197,35,79
2011,Kingston upon Hull 001A,E01012779,897,578,319,66,58,195
2011,Kingston upon Hull 001B,E01012780,1089,661,428,105,47,276
2011,Kingston upon Hull 001C,E01012781,852,484,368,120,26,222
2011,Kingston upon Hull 001E,E01012832,1023,794,229,75,30,124
2011,Kingston upon Hull 001F,E01033105,1123,957,166,52,51,63
2011,Kingston upon Hull 001G,E01033106,928,830,98,13,43,42
2011,Kingston upon Hull 001H,E01033107,1015,865,150,37,39,74
2011,Kingston upon Hull 001I,E01033108,1089,944,145,41,47,57
2011,Kingston upon Hull 002A,E01012782,947,535,412,116,76,220
2011,Kingston upon Hull 002B,E01012785,882,508,374,100,52,222
2011,Kingston upon Hull 002C,E01012786,907,559,348,176,34,138
2011,Kingston upon Hull 002D,E01012787,1107,680,427,156,53,218
2011,Kingston upon Hull 002E,E01012788,1042,615,427,139,62,226
2011,Kingston upon Hull 002F,E01012789,952,605,347,158,40,149
2011,Kingston upon Hull 003A,E01012875,988,559,429,101,59,269
2011,Kingston upon Hull 003B,E01012876,1105,618,487,161,67,259
2011,Kingston upon Hull 003C,E01012877,935,538,397,112,62,223
2011,Kingston upon Hull 003D,E01012878,1106,639,467,131,60,276
2011,Kingston upon Hull 003E,E01012879,979,567,412,85,58,269
2011,Kingston upon Hull 004A,E01012778,1023,641,382,97,66,219
2011,Kingston upon Hull 004B,E01012783,838,500,338,89,51,198
2011,Kingston upon Hull 004C,E01012784,1497,1116,381,122,60,199
2011,Kingston upon Hull 004D,E01012790,971,550,421,215,35,171
2011,Kingston upon Hull 004E,E01012906,1153,734,419,137,60,222
2011,Kingston upon Hull 004F,E01012908,854,494,360,127,22,211
2011,Kingston upon Hull 005A,E01012764,893,552,341,248,16,77
2011,Kingston upon Hull 005B,E01012765,1123,848,275,154,48,73
2011,Kingston upon Hull 005C,E01012768,1065,773,292,198,25,69
2011,Kingston upon Hull 005D,E01012769,943,566,377,301,19,57
2011,Kingston upon Hull 006A,E01012829,1240,905,335,203,38,94
2011,Kingston upon Hull 006B,E01012830,1157,838,319,197,29,93
2011,Kingston upon Hull 006C,E01012905,966,596,370,170,47,153
2011,Kingston upon Hull 006D,E01012910,994,776,218,89,41,88
2011,Kingston upon Hull 006E,E01012912,1386,975,411,276,47,88
2011,Kingston upon Hull 007A,E01012822,1040,743,297,188,32,77
2011,Kingston upon Hull 007B,E01012904,1085,775,310,190,43,77
2011,Kingston upon Hull 007C,E01012907,1060,747,313,149,40,124
2011,Kingston upon Hull 007D,E01012909,1048,862,186,113,17,56
2011,Kingston upon Hull 007E,E01012911,963,748,215,136,29,50
2011,Kingston upon Hull 008A,E01012873,1045,611,434,103,72,259
2011,Kingston upon Hull 008B,E01012874,1055,627,428,126,50,252
2011,Kingston upon Hull 008C,E01012880,1175,683,492,122,67,303
2011,Kingston upon Hull 008D,E01012881,1066,632,434,145,58,231
2011,Kingston upon Hull 008E,E01012915,1035,630,405,145,75,185
2011,Kingston upon Hull 008F,E01012917,1120,643,477,197,80,200
2011,Kingston upon Hull 008G,E01012918,1111,697,414,104,83,227
2011,Kingston upon Hull 009A,E01012833,1029,651,378,124,55,199
2011,Kingston upon Hull 009B,E01012835,889,610,279,207,25,47
2011,Kingston upon Hull 009C,E01012836,1098,695,403,138,45,220
2011,Kingston upon Hull 009D,E01012839,894,604,290,148,23,119
2011,Kingston upon Hull 009E,E01012840,1039,653,386,137,41,208
2011,Kingston upon Hull 010A,E01012824,1198,891,307,169,46,92
2011,Kingston upon Hull 010B,E01012825,1094,747,347,212,36,99
2011,Kingston upon Hull 010C,E01012834,1047,682,365,132,42,191
2011,Kingston upon Hull 010D,E01012837,1085,687,398,177,48,173
2011,Kingston upon Hull 010E,E01012838,984,632,352,103,40,209
2011,Kingston upon Hull 011A,E01012821,865,560,305,166,35,104
2011,Kingston upon Hull 011B,E01012823,960,538,422,143,71,208
2011,Kingston upon Hull 011C,E01012826,1039,663,376,185,51,140
2011,Kingston upon Hull 011D,E01012827,1089,693,396,224,53,119
2011,Kingston upon Hull 011E,E01012828,1092,771,321,175,30,116
2011,Kingston upon Hull 012A,E01012766,1145,895,250,116,86,48
2011,Kingston upon Hull 012B,E01012767,1474,819,655,121,448,86
2011,Kingston upon Hull 012C,E01012914,2023,696,1327,30,1262,35
2011,Kingston upon Hull 012D,E01012916,1215,779,436,157,183,96
2011,Kingston upon Hull 013A,E01012812,1069,818,251,149,46,56
2011,Kingston upon Hull 013B,E01012813,1369,1051,318,186,56,76
2011,Kingston upon Hull 013C,E01012814,1158,827,331,228,41,62
2011,Kingston upon Hull 013D,E01012815,1216,970,246,142,37,67
2011,Kingston upon Hull 013E,E01012818,952,705,247,154,43,50
2011,Kingston upon Hull 014A,E01012791,1285,952,333,209,55,69
2011,Kingston upon Hull 014B,E01012792,1149,833,316,170,83,63
2011,Kingston upon Hull 014C,E01012793,1038,700,338,172,92,74
2011,Kingston upon Hull 014D,E01012794,1234,943,291,143,77,71
2011,Kingston upon Hull 014E,E01012913,1446,961,485,156,149,180
2011,Kingston upon Hull 015A,E01012761,1396,864,532,137,208,187
2011,Kingston upon Hull 015B,E01012868,1520,771,749,73,598,78
2011,Kingston upon Hull 015C,E01012869,1546,839,707,74,511,122
2011,Kingston upon Hull 015D,E01012871,1522,1021,501,75,274,152
2011,Kingston upon Hull 015E,E01012872,1661,780,881,51,732,98
2011,Kingston upon Hull 016A,E01012804,1167,914,253,144,21,88
2011,Kingston upon Hull 016B,E01012806,1125,823,302,91,36,175
2011,Kingston upon Hull 016C,E01012807,1021,730,291,163,32,96
2011,Kingston upon Hull 016D,E01012817,1093,867,226,91,33,102
2011,Kingston upon Hull 016E,E01012819,1113,848,265,136,43,86
2011,Kingston upon Hull 017A,E01012841,1041,607,434,103,60,271
2011,Kingston upon Hull 017B,E01012844,928,510,418,131,43,244
2011,Kingston upon Hull 017C,E01012849,1054,654,400,166,51,183
2011,Kingston upon Hull 017D,E01012895,1011,542,469,132,68,269
2011,Kingston upon Hull 017E,E01012897,1037,516,521,149,55,317
2011,Kingston upon Hull 017F,E01012898,895,508,387,189,32,166
2011,Kingston upon Hull 018A,E01012758,1256,954,302,129,85,88
2011,Kingston upon Hull 018B,E01012762,1284,902,382,106,198,78
2011,Kingston upon Hull 018C,E01012763,1698,1206,492,100,230,162
2011,Kingston upon Hull 018D,E01012866,1311,857,454,72,269,113
2011,Kingston upon Hull 018E,E01012870,1487,797,690,53,549,88
2011,Kingston upon Hull 019A,E01012774,1144,823,321,144,51,126
2011,Kingston upon Hull 019B,E01012795,1340,901,439,195,72,172
2011,Kingston upon Hull 019C,E01012797,978,671,307,180,37,90
2011,Kingston upon Hull 019D,E01012798,1052,586,466,240,44,182
2011,Kingston upon Hull 019E,E01012801,1078,783,295,172,29,94
2011,Kingston upon Hull 020A,E01012816,1024,762,262,140,45,77
2011,Kingston upon Hull 020B,E01012848,1617,950,667,97,38,532
2011,Kingston upon Hull 020C,E01012894,1167,746,421,158,66,197
2011,Kingston upon Hull 020D,E01012896,1559,1192,367,131,69,167
2011,Kingston upon Hull 020E,E01012901,1073,800,273,147,41,85
2011,Kingston upon Hull 021A,E01012842,1041,657,384,117,45,222
2011,Kingston upon Hull 021B,E01012843,972,567,405,116,45,244
2011,Kingston upon Hull 021C,E01012845,1036,648,388,114,63,211
2011,Kingston upon Hull 021D,E01012846,983,627,356,132,38,186
2011,Kingston upon Hull 021E,E01012847,862,530,332,89,45,198
2011,Kingston upon Hull 022A,E01012820,1049,796,253,119,49,85
2011,Kingston upon Hull 022B,E01012899,1146,854,292,145,32,115
2011,Kingston upon Hull 022C,E01012900,1221,872,349,104,35,210
2011,Kingston upon Hull 022D,E01012902,1215,917,298,171,44,83
2011,Kingston upon Hull 022E,E01012903,1319,964,355,147,33,175
2011,Kingston upon Hull 023A,E01012796,980,694,286,176,35,75
2011,Kingston upon Hull 023B,E01012799,955,760,195,103,19,73
2011,Kingston upon Hull 023C,E01012800,1151,880,271,147,32,92
2011,Kingston upon Hull 023D,E01012802,1091,811,280,163,27,90
2011,Kingston upon Hull 023E,E01012803,1075,796,279,154,41,84
2011,Kingston upon Hull 024A,E01012850,1504,1070,434,92,92,250
2011,Kingston upon Hull 024B,E01012852,1307,853,454,120,69,265
2011,Kingston upon Hull 024C,E01012856,1186,677,509,190,56,263
2011,Kingston upon Hull 024D,E01012857,1206,742,464,130,61,273
2011,Kingston upon Hull 024E,E01012867,1188,739,449,99,103,247
2011,Kingston upon Hull 025A,E01012756,1202,914,288,141,60,87
2011,Kingston upon Hull 025B,E01012757,1220,900,320,83,86,151
2011,Kingston upon Hull 025C,E01012759,1298,990,308,129,58,121
2011,Kingston upon Hull 025D,E01012760,1177,908,269,105,49,115
2011,Kingston upon Hull 025E,E01012862,964,612,352,154,47,151
2011,Kingston upon Hull 026A,E01012805,1068,730,338,109,39,190
2011,Kingston upon Hull 026B,E01012808,1271,782,489,174,49,266
2011,Kingston upon Hull 026C,E01012809,1431,1033,398,115,52,231
2011,Kingston upon Hull 026D,E01012810,1405,1059,346,180,32,134
2011,Kingston upon Hull 026E,E01012811,1323,1050,273,103,47,123
2011,Kingston upon Hull 027A,E01012773,1277,1004,273,134,37,102
2011,Kingston upon Hull 027B,E01012776,1124,887,237,136,39,62
2011,Kingston upon Hull 027C,E01012863,1072,764,308,131,35,142
2011,Kingston upon Hull 027D,E01012864,1272,935,337,68,59,210
2011,Kingston upon Hull 027E,E01012865,1022,702,320,123,41,156
2011,Kingston upon Hull 028A,E01012770,1127,870,257,170,40,47
2011,Kingston upon Hull 028B,E01012771,1140,827,313,188,44,81
2011,Kingston upon Hull 028C,E01012772,1104,832,272,137,43,92
2011,Kingston upon Hull 028D,E01012775,1052,711,341,173,29,139
2011,Kingston upon Hull 028E,E01012777,983,570,413,242,36,135
2011,Kingston upon Hull 029A,E01012851,1927,1235,692,192,137,363
2011,Kingston upon Hull 029C,E01012854,1755,1128,627,132,72,423
2011,Kingston upon Hull 029D,E01012855,1337,818,519,139,59,321
2011,Kingston upon Hull 029E,E01033104,1195,868,327,78,142,107
2011,Kingston upon Hull 029F,E01033109,1117,828,289,69,62,158
2011,Kingston upon Hull 030A,E01012859,1116,768,348,69,60,219
2011,Kingston upon Hull 030B,E01012889,991,635,356,134,26,196
2011,Kingston upon Hull 030C,E01012891,1720,1268,452,94,73,285
2011,Kingston upon Hull 030D,E01012892,1422,1014,408,93,75,240
2011,Kingston upon Hull 030E,E01012893,1092,668,424,120,56,248
2011,Kingston upon Hull 031A,E01012858,1267,829,438,158,66,214
2011,Kingston upon Hull 031B,E01012860,1214,849,365,132,51,182
2011,Kingston upon Hull 031D,E01012886,1170,781,389,173,53,163
2011,Kingston upon Hull 031E,E01012888,1176,845,331,89,29,213
2011,Kingston upon Hull 031G,E01033110,1115,678,437,172,36,229
2011,Kingston upon Hull 033A,E01012882,1215,926,289,164,35,90
2011,Kingston upon Hull 033B,E01012883,1014,651,363,260,29,74
2011,Kingston upon Hull 033C,E01012884,1261,793,468,228,51,189
2011,Kingston upon Hull 033D,E01012887,1024,658,366,124,49,193
2011,Kingston upon Hull 033E,E01032595,1218,808,410,155,63,192
2011,North East Lincolnshire 001A,E01013174,952,617,335,59,46,230
2011,North East Lincolnshire 001B,E01013175,1062,745,317,192,35,90
2011,North East Lincolnshire 001C,E01013176,1055,741,314,182,30,102
2011,North East Lincolnshire 001D,E01013177,1163,692,471,181,44,246
2011,North East Lincolnshire 001E,E01013178,1080,712,368,244,42,82
2011,North East Lincolnshire 001F,E01013179,1062,705,357,194,44,119
2011,North East Lincolnshire 001G,E01013180,1101,752,349,185,47,117
2011,North East Lincolnshire 002A,E01013136,1170,600,570,176,86,308
2011,North East Lincolnshire 002B,E01013137,1151,593,558,197,44,317
2011,North East Lincolnshire 002C,E01013139,878,467,411,160,26,225
2011,North East Lincolnshire 002D,E01013142,1205,818,387,95,51,241
2011,North East Lincolnshire 003A,E01013218,1011,720,291,75,43,173
2011,North East Lincolnshire 003B,E01013219,1019,690,329,114,47,168
2011,North East Lincolnshire 003C,E01013220,1185,830,355,114,57,184
2011,North East Lincolnshire 003D,E01013221,1315,889,426,155,50,221
2011,North East Lincolnshire 003E,E01013222,1152,818,334,101,63,170
2011,North East Lincolnshire 004A,E01013144,1051,600,451,196,37,218
2011,North East Lincolnshire 004B,E01013145,1005,704,301,194,36,71
2011,North East Lincolnshire 004C,E01013146,1274,932,342,163,42,137
2011,North East Lincolnshire 004D,E01013148,1149,876,273,168,46,59
2011,North East Lincolnshire 005A,E01013195,1008,737,271,108,41,122
2011,North East Lincolnshire 005B,E01013196,995,663,332,86,57,189
2011,North East Lincolnshire 005C,E01013201,1119,731,388,112,59,217
2011,North East Lincolnshire 005D,E01013202,1085,770,315,111,69,135
2011,North East Lincolnshire 005E,E01013203,1208,803,405,104,61,240
2011,North East Lincolnshire 006A,E01013138,980,571,409,86,43,280
2011,North East Lincolnshire 006B,E01013140,1134,759,375,88,65,222
2011,North East Lincolnshire 006C,E01013141,1157,802,355,101,65,189
2011,North East Lincolnshire 006D,E01013143,982,727,255,100,41,114
2011,North East Lincolnshire 007A,E01013173,921,650,271,180,20,71
2011,North East Lincolnshire 007B,E01013223,2125,1588,537,338,73,126
2011,North East Lincolnshire 007C,E01013224,1343,969,374,237,41,96
2011,North East Lincolnshire 007D,E01013226,1127,844,283,186,32,65
2011,North East Lincolnshire 008A,E01013187,1028,644,384,180,70,134
2011,North East Lincolnshire 008B,E01013188,1216,902,314,171,57,86
2011,North East Lincolnshire 008C,E01013231,1209,892,317,145,56,116
2011,North East Lincolnshire 008D,E01013233,1101,851,250,111,36,103
2011,North East Lincolnshire 009A,E01013147,1004,635,369,164,54,151
2011,North East Lincolnshire 009D,E01013234,981,736,245,137,31,77
2011,North East Lincolnshire 009E,E01033414,1740,1253,487,274,50,163
2011,North East Lincolnshire 010A,E01013128,1096,758,338,133,52,153
2011,North East Lincolnshire 010B,E01013198,1082,798,284,119,43,122
2011,North East Lincolnshire 010C,E01013199,915,641,274,101,26,147
2011,North East Lincolnshire 010D,E01013200,949,727,222,119,34,69
2011,North East Lincolnshire 011A,E01013159,1081,745,336,87,52,197
2011,North East Lincolnshire 011B,E01013161,998,718,280,57,53,170
2011,North East Lincolnshire 011C,E01013162,1166,802,364,107,73,184
2011,North East Lincolnshire 011D,E01013165,1000,692,308,62,37,209
2011,North East Lincolnshire 012A,E01013158,1043,815,228,103,38,87
2011,North East Lincolnshire 012B,E01013160,1146,876,270,170,28,72
2011,North East Lincolnshire 012C,E01013163,986,638,348,238,26,84
2011,North East Lincolnshire 012D,E01013164,1318,952,366,115,80,171
2011,North East Lincolnshire 012E,E01013197,958,688,270,134,40,96
2011,North East Lincolnshire 013A,E01013149,914,626,288,201,37,50
2011,North East Lincolnshire 013B,E01013150,1053,761,292,180,39,73
2011,North East Lincolnshire 013C,E01013227,1188,791,397,237,48,112
2011,North East Lincolnshire 013D,E01013228,1234,985,249,117,46,86
2011,North East Lincolnshire 013E,E01013229,1047,720,327,90,70,167
2011,North East Lincolnshire 014A,E01013131,1119,781,338,147,23,168
2011,North East Lincolnshire 014B,E01013132,1066,749,317,167,34,116
2011,North East Lincolnshire 014C,E01013133,1171,886,285,153,39,93
2011,North East Lincolnshire 014D,E01013134,997,637,360,219,35,106
2011,North East Lincolnshire 015A,E01013206,971,593,378,131,49,198
2011,North East Lincolnshire 015B,E01013207,999,667,332,193,37,102
2011,North East Lincolnshire 015C,E01013211,1074,778,296,167,40,89
2011,North East Lincolnshire 015D,E01013212,912,558,354,91,51,212
2011,North East Lincolnshire 016A,E01013181,1093,771,322,78,71,173
2011,North East Lincolnshire 016B,E01013182,1090,678,412,241,85,86
2011,North East Lincolnshire 016C,E01013183,1126,854,272,138,57,77
2011,North East Lincolnshire 016D,E01013184,1159,836,323,133,75,115
2011,North East Lincolnshire 016E,E01013185,1187,882,305,114,100,91
2011,North East Lincolnshire 016F,E01013186,971,760,211,123,39,49
2011,North East Lincolnshire 017A,E01013129,1161,817,344,130,53,161
2011,North East Lincolnshire 017B,E01013151,936,635,301,220,31,50
2011,North East Lincolnshire 017C,E01013152,1030,707,323,222,36,65
2011,North East Lincolnshire 017D,E01013155,1008,696,312,222,19,71
2011,North East Lincolnshire 018A,E01013130,978,633,345,155,54,136
2011,North East Lincolnshire 018B,E01013135,1010,580,430,290,24,116
2011,North East Lincolnshire 018C,E01013154,1037,682,355,277,29,49
2011,North East Lincolnshire 018D,E01013156,846,464,382,294,16,72
2011,North East Lincolnshire 019A,E01013204,998,647,351,148,49,154
2011,North East Lincolnshire 019B,E01013205,893,512,381,86,54,241
2011,North East Lincolnshire 019C,E01013208,911,465,446,89,77,280
2011,North East Lincolnshire 019D,E01013209,1010,583,427,134,43,250
2011,North East Lincolnshire 019E,E01013210,919,526,393,91,54,248
2011,North East Lincolnshire 020A,E01013153,993,572,421,347,19,55
2011,North East Lincolnshire 020B,E01013157,1337,1038,299,194,41,64
2011,North East Lincolnshire 020C,E01013166,1156,762,394,292,31,71
2011,North East Lincolnshire 020D,E01013167,1346,853,493,367,29,97
2011,North East Lincolnshire 020E,E01013169,751,448,303,220,29,54
2011,North East Lincolnshire 021A,E01013189,1058,720,338,231,31,76
2011,North East Lincolnshire 021B,E01013190,2052,1583,469,250,92,127
2011,North East Lincolnshire 021C,E01013191,1122,786,336,235,41,60
2011,North East Lincolnshire 021D,E01013192,1003,652,351,171,46,134
2011,North East Lincolnshire 021E,E01013194,1025,640,385,275,32,78
2011,North East Lincolnshire 022A,E01013168,1196,825,371,278,25,68
2011,North East Lincolnshire 022B,E01013170,1070,785,285,200,31,54
2011,North East Lincolnshire 022C,E01013171,1275,991,284,150,56,78
2011,North East Lincolnshire 022D,E01013172,1093,711,382,287,35,60
2011,North East Lincolnshire 022E,E01013193,1163,765,398,306,28,64
2011,North East Lincolnshire 023A,E01013213,779,489,290,176,38,76
2011,North East Lincolnshire 023B,E01013214,1076,688,388,278,38,72
2011,North East Lincolnshire 023C,E01013215,1115,764,351,242,42,67
2011,North East Lincolnshire 023D,E01013216,986,734,252,158,41,53
2011,North East Lincolnshire 023E,E01013217,1068,756,312,209,36,67
2011,North East Lincolnshire 023F,E01013225,810,527,283,165,31,87
2011,North Lincolnshire 001A,E01013254,1262,819,443,256,50,137
2011,North Lincolnshire 001B,E01013255,1249,874,375,226,32,117
2011,North Lincolnshire 001C,E01013256,1838,1333,505,261,79,165
2011,North Lincolnshire 001D,E01013257,1332,937,395,258,49,88
2011,North Lincolnshire 001E,E01013258,1164,766,398,173,52,173
2011,North Lincolnshire 001F,E01013259,1178,712,466,204,55,207
2011,North Lincolnshire 002A,E01013303,992,658,334,167,42,125
2011,North Lincolnshire 002B,E01013304,1213,847,366,229,44,93
2011,North Lincolnshire 002C,E01013305,1264,890,374,195,43,136
2011,North Lincolnshire 002D,E01013307,1298,891,407,233,41,133
2011,North Lincolnshire 003A,E01013288,1170,824,346,213,47,86
2011,North Lincolnshire 003B,E01013291,1066,696,370,158,48,164
2011,North Lincolnshire 003C,E01013292,1306,886,420,274,48,98
2011,North Lincolnshire 003D,E01013294,1171,805,366,237,43,86
2011,North Lincolnshire 004A,E01013270,1428,1052,376,208,40,128
2011,North Lincolnshire 004B,E01013306,1135,803,332,184,41,107
2011,North Lincolnshire 004C,E01013308,1332,921,411,216,47,148
2011,North Lincolnshire 004D,E01013309,1222,849,373,225,36,112
2011,North Lincolnshire 005A,E01013286,1723,1067,656,413,36,207
2011,North Lincolnshire 005B,E01013287,1147,810,337,241,13,83
2011,North Lincolnshire 005C,E01013289,1236,952,284,173,34,77
2011,North Lincolnshire 005D,E01013290,1259,833,426,277,39,110
2011,North Lincolnshire 005E,E01013293,1108,740,368,268,29,71
2011,North Lincolnshire 006A,E01013245,1053,744,309,153,25,131
2011,North Lincolnshire 006B,E01013246,1176,817,359,197,51,111
2011,North Lincolnshire 006C,E01013247,1328,948,380,221,42,117
2011,North Lincolnshire 006D,E01013248,1329,954,375,246,45,84
2011,North Lincolnshire 006E,E01013249,1270,918,352,182,43,127
2011,North Lincolnshire 007A,E01013297,1624,1252,372,184,58,130
2011,North Lincolnshire 007B,E01013300,1239,884,355,93,68,194
2011,North Lincolnshire 007C,E01013302,1093,759,334,189,48,97
2011,North Lincolnshire 007D,E01013331,1269,832,437,176,44,217
2011,North Lincolnshire 008A,E01013296,1190,846,344,78,57,209
2011,North Lincolnshire 008B,E01013298,1048,670,378,93,56,229
2011,North Lincolnshire 008C,E01013299,1094,667,427,134,62,231
2011,North Lincolnshire 008D,E01013330,1263,885,378,115,49,214
2011,North Lincolnshire 008E,E01013332,1315,854,461,114,88,259
2011,North Lincolnshire 009A,E01013295,1052,679,373,274,21,78
2011,North Lincolnshire 009B,E01013301,1176,870,306,151,54,101
2011,North Lincolnshire 009C,E01013333,1174,874,300,138,55,107
2011,North Lincolnshire 009D,E01013334,1127,849,278,146,45,87
2011,North Lincolnshire 010A,E01013310,1078,751,327,158,48,121
2011,North Lincolnshire 010B,E01013312,1330,932,398,96,62,240
2011,North Lincolnshire 010C,E01013313,1163,873,290,130,54,106
2011,North Lincolnshire 010D,E01013314,1124,857,267,117,37,113
2011,North Lincolnshire 011A,E01013267,919,624,295,195,33,67
2011,North Lincolnshire 011B,E01013268,944,607,337,208,40,89
2011,North Lincolnshire 011C,E01013269,1324,922,402,258,47,97
2011,North Lincolnshire 011D,E01013271,1386,970,416,163,67,186
2011,North Lincolnshire 011E,E01013272,1225,811,414,225,48,141
2011,North Lincolnshire 011F,E01013273,1257,863,394,285,33,76
2011,North Lincolnshire 012A,E01013279,1040,650,390,119,42,229
2011,North Lincolnshire 012B,E01013285,993,707,286,202,26,58
2011,North Lincolnshire 012C,E01013316,1038,792,246,159,43,44
2011,North Lincolnshire 012D,E01013321,1253,925,328,187,51,90
2011,North Lincolnshire 013A,E01013274,1564,1135,429,240,52,137
2011,North Lincolnshire 013B,E01013275,1161,841,320,230,32,58
2011,North Lincolnshire 013C,E01013276,1147,792,355,221,29,105
2011,North Lincolnshire 013D,E01013277,1117,827,290,182,37,71
2011,North Lincolnshire 014A,E01013315,1008,604,404,247,30,127
2011,North Lincolnshire 014B,E01013317,1001,712,289,157,47,85
2011,North Lincolnshire 014C,E01013318,1093,799,294,146,55,93
2011,North Lincolnshire 014D,E01013319,1548,1127,421,136,61,224
2011,North Lincolnshire 015A,E01013238,1233,873,360,150,45,165
2011,North Lincolnshire 015B,E01013240,1711,1175,536,186,72,278
2011,North Lincolnshire 015C,E01013311,1221,757,464,136,52,276
2011,North Lincolnshire 015D,E01013320,1087,750,337,163,50,124
2011,North Lincolnshire 016A,E01013278,1052,611,441,142,55,244
2011,North Lincolnshire 016B,E01013280,1115,755,360,211,28,121
2011,North Lincolnshire 016C,E01013281,929,601,328,95,47,186
2011,North Lincolnshire 016D,E01013283,1011,625,386,124,53,209
2011,North Lincolnshire 017A,E01013236,1096,734,362,220,37,105
2011,North Lincolnshire 017B,E01013239,1175,835,340,161,55,124
2011,North Lincolnshire 017C,E01013282,1121,722,399,162,68,169
2011,North Lincolnshire 017D,E01013284,1150,722,428,155,70,203
2011,North Lincolnshire 018B,E01013237,1160,762,398,132,53,213
2011,North Lincolnshire 018C,E01013261,1081,719,362,285,28,49
2011,North Lincolnshire 018D,E01013262,1004,657,347,269,19,59
2011,North Lincolnshire 018E,E01013263,1085,745,340,245,29,66
2011,North Lincolnshire 018F,E01033296,1049,714,335,192,31,112
2011,North Lincolnshire 018G,E01033297,1205,1077,128,27,44,57
2011,North Lincolnshire 019A,E01013260,1092,727,365,275,27,63
2011,North Lincolnshire 019B,E01013264,1303,956,347,225,46,76
2011,North Lincolnshire 019C,E01013265,1240,866,374,287,32,55
2011,North Lincolnshire 019D,E01013266,1440,1082,358,228,38,92
2011,North Lincolnshire 020A,E01013241,1089,698,391,278,32,81
2011,North Lincolnshire 020B,E01013242,1348,958,390,231,61,98
2011,North Lincolnshire 020C,E01013243,1609,1169,440,259,69,112
2011,North Lincolnshire 020D,E01013244,1283,870,413,224,49,140
2011,North Lincolnshire 021A,E01013324,1192,871,321,216,38,67
2011,North Lincolnshire 021B,E01013326,1169,748,421,302,36,83
2011,North Lincolnshire 021C,E01013327,1022,653,369,289,20,60
2011,North Lincolnshire 021D,E01013328,948,684,264,183,32,49
2011,North Lincolnshire 022A,E01013322,1444,1018,426,236,58,132
2011,North Lincolnshire 022B,E01013323,1302,935,367,212,43,112
2011,North Lincolnshire 022C,E01013325,1158,761,397,266,42,89
2011,North Lincolnshire 022D,E01013329,1334,878,456,264,50,142
2011,North Lincolnshire 023A,E01013250,1194,772,422,247,49,126
2011,North Lincolnshire 023B,E01013251,1402,972,430,286,50,94
2011,North Lincolnshire 023C,E01013252,1236,806,430,275,47,108
2011,North Lincolnshire 023D,E01013253,1413,1022,391,224,41,126
2011,York 001A,E01013436,1242,964,278,149,44,85
2011,York 001B,E01013438,1277,946,331,202,38,91
2011,York 001C,E01013439,1041,809,232,134,36,62
2011,York 001D,E01013440,1397,1038,359,245,45,69
2011,York 002A,E01013370,1054,738,316,244,19,53
2011,York 002B,E01013373,1028,697,331,240,21,70
2011,York 002C,E01013375,969,669,300,236,17,47
2011,York 002D,E01013376,1099,763,336,264,17,55
2011,York 003A,E01013371,1122,836,286,213,30,43
2011,York 003B,E01013372,1065,703,362,282,29,51
2011,York 003C,E01013374,1122,835,287,211,31,45
2011,York 003D,E01013377,1226,915,311,227,28,56
2011,York 004A,E01013404,1089,764,325,160,43,122
2011,York 004B,E01013407,963,624,339,254,21,64
2011,York 004C,E01013408,947,556,391,319,19,53
2011,York 004D,E01013410,999,708,291,131,41,119
2011,York 005A,E01013405,1063,784,279,218,19,42
2011,York 005B,E01013406,1513,1191,322,169,55,98
2011,York 005C,E01013409,1109,793,316,221,21,74
2011,York 005D,E01013411,1061,706,355,268,30,57
2011,York 006A,E01013428,1242,985,257,143,26,88
2011,York 006B,E01013429,1507,1289,218,104,36,78
2011,York 006C,E01013430,1176,847,329,218,38,73
2011,York 006D,E01013431,1152,962,190,97,29,64
2011,York 006E,E01013435,1082,792,290,187,31,72
2011,York 007A,E01013344,1259,922,337,145,136,56
2011,York 007B,E01013346,1213,849,364,209,58,97
2011,York 007C,E01013432,1449,1147,302,199,42,61
2011,York 007D,E01013433,1071,763,308,246,18,44
2011,York 007E,E01013434,1044,765,279,187,26,66
2011,York 008A,E01013379,1031,762,269,164,55,50
2011,York 008B,E01013380,1422,975,447,126,263,58
2011,York 008C,E01013385,1062,773,289,132,36,121
2011,York 008D,E01013387,1019,686,333,260,23,50
2011,York 008E,E01013388,774,494,280,221,19,40
2011,York 008F,E01013389,866,613,253,193,24,36
2011,York 008G,E01013437,937,649,288,190,31,67
2011,York 009A,E01013343,1674,1259,415,114,213,88
2011,York 009B,E01013345,1382,1074,308,129,116,63
2011,York 009C,E01013347,1182,825,357,124,72,161
2011,York 009D,E01013349,948,657,291,86,48,157
2011,York 009E,E01013350,1221,870,351,132,79,140
2011,York 010A,E01013348,1659,1225,434,79,284,71
2011,York 010B,E01013368,1942,1444,498,134,287,77
2011,York 010C,E01013382,1227,877,350,149,73,128
2011,York 010D,E01013383,1889,1377,512,134,239,139
2011,York 010E,E01013386,1297,942,355,131,74,150
2011,York 011A,E01013421,1196,762,434,158,106,170
2011,York 011B,E01013422,1190,920,270,163,40,67
2011,York 011C,E01013426,1142,753,389,297,28,64
2011,York 011D,E01013427,945,630,315,229,41,45
2011,York 012A,E01013335,1133,775,358,157,56,145
2011,York 012B,E01013336,1088,785,303,210,26,67
2011,York 012C,E01013337,1207,941,266,158,33,75
2011,York 012D,E01013338,1613,1254,359,205,46,108
2011,York 012E,E01013339,1118,823,295,191,40,64
2011,York 012F,E01013392,1161,930,231,138,30,63
2011,York 013A,E01013366,1720,1190,530,132,251,147
2011,York 013C,E01013369,1511,1105,406,145,142,119
2011,York 013E,E01013416,1232,869,363,115,107,141
2011,York 013F,E01033067,1120,774,346,85,131,130
2011,York 013G,E01033068,1027,768,259,94,101,64
2011,York 013H,E01033069,961,712,249,100,74,75
2011,York 013I,E01033070,1425,932,493,88,336,69
2011,York 014A,E01013381,1136,840,296,120,123,53
2011,York 014B,E01013402,1411,755,656,239,377,40
2011,York 014C,E01013419,1061,697,364,226,94,44
2011,York 014D,E01013420,1485,1013,472,256,164,52
2011,York 015A,E01013384,1372,885,487,114,283,90
2011,York 015B,E01013398,1285,748,537,105,345,87
2011,York 015C,E01013399,1247,764,483,112,196,175
2011,York 015D,E01013400,1750,1062,688,53,560,75
2011,York 015E,E01013401,1408,803,605,100,419,86
2011,York 015F,E01013403,1621,770,851,122,675,54
2011,York 016A,E01013393,1218,999,219,98,35,86
2011,York 016B,E01013394,952,677,275,131,31,113
2011,York 016C,E01013395,1095,870,225,126,27,72
2011,York 016D,E01013396,1141,809,332,212,24,96
2011,York 016E,E01013441,1178,897,281,161,28,92
2011,York 016F,E01013445,1078,772,306,131,35,140
2011,York 017A,E01013390,1318,1106,212,99,31,82
2011,York 017B,E01013391,1792,1494,298,108,77,113
2011,York 017C,E01013397,1124,861,263,186,29,48
2011,York 017D,E01013413,1282,1034,248,126,72,50
2011,York 017E,E01013417,1514,1101,413,185,110,118
2011,York 018A,E01013442,974,746,228,135,27,66
2011,York 018B,E01013443,1053,699,354,155,41,158
2011,York 018C,E01013444,973,690,283,103,46,134
2011,York 018D,E01013446,1207,913,294,149,45,100
2011,York 018E,E01013447,1072,785,287,112,36,139
2011,York 018F,E01013448,998,726,272,100,26,146
2011,York 019A,E01013360,1314,877,437,135,208,94
2011,York 019B,E01013361,1575,1143,432,103,267,62
2011,York 019C,E01013362,1526,1109,417,191,141,85
2011,York 019D,E01013363,1781,1065,716,116,482,118
2011,York 019E,E01013364,1773,1047,726,86,539,101
2011,York 019F,E01013418,1276,942,334,149,91,94
2011,York 020A,E01013351,1326,897,429,329,39,61
2011,York 020B,E01013352,1166,752,414,315,40,59
2011,York 020C,E01013451,892,704,188,127,18,43
2011,York 020D,E01013452,1109,808,301,200,39,62
2011,York 021A,E01013357,1352,971,381,265,59,57
2011,York 021B,E01013358,1174,881,293,213,36,44
2011,York 021C,E01013412,1453,1184,269,95,101,73
2011,York 021D,E01013414,1317,1020,297,134,104,59
2011,York 022A,E01013353,1131,828,303,145,50,108
2011,York 022B,E01013354,1146,859,287,211,28,48
2011,York 022C,E01013355,1123,720,403,326,23,54
2011,York 022D,E01013356,1095,788,307,212,27,68
2011,York 022E,E01013359,1082,835,247,109,41,97
2011,York 022F,E01013449,1245,911,334,204,46,84
2011,York 023A,E01013365,1975,1315,660,378,179,103
2011,York 023B,E01013378,4515,1252,3263,113,3083,67
2011,York 023C,E01013450,894,655,239,151,31,57
2011,York 024A,E01013340,898,627,271,186,41,44
2011,York 024B,E01013341,865,553,312,236,22,54
2011,York 024C,E01013342,1071,682,389,304,30,55
2011,York 024D,E01013423,937,650,287,225,21,41
2011,York 024E,E01013424,1017,755,262,171,38,53
2011,York 024F,E01013425,1114,814,300,210,39,51
2011,Craven 001A,E01027558,1434,1025,409,294,42,73
2011,Craven 001B,E01027559,1257,892,365,225,30,110
2011,Craven 001C,E01027569,1001,705,296,222,34,40
2011,Craven 001D,E01027570,1837,1276,561,387,60,114
2011,Craven 002A,E01027562,1223,907,316,210,37,69
2011,Craven 002B,E01027567,1111,757,354,255,28,71
2011,Craven 002C,E01027585,1348,851,497,405,30,62
2011,Craven 003A,E01027568,1606,1132,474,332,39,103
2011,Craven 003B,E01027571,1370,878,492,301,117,74
2011,Craven 003C,E01027572,1509,1072,437,294,47,96
2011,Craven 003D,E01027573,1089,743,346,269,27,50
2011,Craven 004A,E01027557,1213,897,316,204,43,69
2011,Craven 004B,E01027561,1345,946,399,279,44,76
2011,Craven 004C,E01027576,1104,738,366,271,39,56
2011,Craven 005A,E01027574,1051,749,302,230,28,44
2011,Craven 005B,E01027575,1379,984,395,270,46,79
2011,Craven 005C,E01027577,1421,1078,343,214,53,76
2011,Craven 005D,E01027579,777,560,217,95,25,97
2011,Craven 006A,E01027578,1135,893,242,137,23,82
2011,Craven 006B,E01027580,782,549,233,94,31,108
2011,Craven 006C,E01027581,1772,1289,483,220,70,193
2011,Craven 006D,E01027582,1104,853,251,153,35,63
2011,Craven 007A,E01027556,1229,927,302,198,36,68
2011,Craven 007B,E01027560,1722,1362,360,214,26,120
2011,Craven 007C,E01027563,990,677,313,228,26,59
2011,Craven 007D,E01027586,1397,1046,351,249,36,66
2011,Craven 008A,E01027555,1388,950,438,313,51,74
2011,Craven 008B,E01027564,811,572,239,156,28,55
2011,Craven 008C,E01027565,1117,813,304,219,33,52
2011,Craven 008D,E01027566,934,703,231,156,35,40
2011,Craven 008E,E01027583,1433,1063,370,239,60,71
2011,Craven 008F,E01027584,1167,857,310,192,41,77
2011,Hambleton 001A,E01027591,1282,850,432,313,46,73
2011,Hambleton 001B,E01027597,1154,789,365,249,38,78
2011,Hambleton 001C,E01027599,1177,816,361,192,44,125
2011,Hambleton 001D,E01027623,877,593,284,202,38,44
2011,Hambleton 001E,E01027625,1122,706,416,224,47,145
2011,Hambleton 002A,E01027598,1283,721,562,430,57,75
2011,Hambleton 002B,E01027618,1788,1165,623,457,76,90
2011,Hambleton 002C,E01027624,930,626,304,211,52,41
2011,Hambleton 002D,E01027626,1007,626,381,265,37,79
2011,Hambleton 002E,E01027627,1408,957,451,308,57,86
2011,Hambleton 003A,E01027590,1567,1179,388,225,41,122
2011,Hambleton 003B,E01027592,1383,983,400,289,33,78
2011,Hambleton 003C,E01027613,1303,963,340,250,41,49
2011,Hambleton 003D,E01027617,857,606,251,161,25,65
2011,Hambleton 004A,E01027605,1194,961,233,130,43,60
2011,Hambleton 004B,E01027606,1051,752,299,218,27,54
2011,Hambleton 004C,E01027608,1428,1016,412,137,41,234
2011,Hambleton 004D,E01027609,979,764,215,69,28,118
2011,Hambleton 004E,E01027610,1245,921,324,182,40,102
2011,Hambleton 004F,E01027611,1356,921,435,323,28,84
2011,Hambleton 004G,E01027612,1174,818,356,188,36,132
2011,Hambleton 004H,E01027616,1012,760,252,169,21,62
2011,Hambleton 005A,E01027603,1423,1013,410,272,40,98
2011,Hambleton 005B,E01027604,1300,973,327,244,29,54
2011,Hambleton 005C,E01027607,925,621,304,244,19,41
2011,Hambleton 005D,E01027614,894,628,266,212,21,33
2011,Hambleton 005E,E01027615,951,678,273,207,30,36
2011,Hambleton 006A,E01027587,913,646,267,195,30,42
2011,Hambleton 006B,E01027588,1096,858,238,138,37,63
2011,Hambleton 006C,E01027589,1249,953,296,180,36,80
2011,Hambleton 006D,E01027593,1318,953,365,262,34,69
2011,Hambleton 007B,E01027628,1390,1048,342,219,37,86
2011,Hambleton 007C,E01027633,1388,995,393,282,33,78
2011,Hambleton 007D,E01033065,891,676,215,116,28,71
2011,Hambleton 007E,E01033066,1712,1499,213,76,32,105
2011,Hambleton 008A,E01027620,1364,1065,299,181,30,88
2011,Hambleton 008B,E01027630,1319,980,339,199,32,108
2011,Hambleton 008C,E01027631,1015,716,299,211,35,53
2011,Hambleton 008D,E01027632,1099,834,265,160,39,66
2011,Hambleton 008E,E01027637,1416,1009,407,289,40,78
2011,Hambleton 009A,E01027621,1623,1120,503,333,38,132
2011,Hambleton 009B,E01027629,945,630,315,180,17,118
2011,Hambleton 009C,E01027635,1949,1531,418,225,50,143
2011,Hambleton 009D,E01027636,1579,1125,454,312,47,95
2011,Hambleton 010A,E01027594,1039,699,340,211,32,97
2011,Hambleton 010B,E01027595,1158,837,321,222,31,68
2011,Hambleton 010C,E01027596,1048,673,375,290,29,56
2011,Hambleton 010D,E01027601,1422,1067,355,244,44,67
2011,Hambleton 010E,E01027622,1399,1005,394,265,48,81
2011,Hambleton 011A,E01027600,1434,1095,339,229,35,75
2011,Hambleton 011B,E01027619,1904,1527,377,206,53,118
2011,Hambleton 011C,E01027634,1515,1121,394,213,58,123
2011,Harrogate 001A,E01027666,1238,905,333,226,43,64
2011,Harrogate 001B,E01027667,1041,747,294,163,55,76
2011,Harrogate 001C,E01027685,868,620,248,185,15,48
2011,Harrogate 001D,E01027686,882,643,239,143,26,70
2011,Harrogate 002A,E01027712,1351,1122,229,126,38,65
2011,Harrogate 002B,E01027713,1180,885,295,181,26,88
2011,Harrogate 002C,E01027714,1141,832,309,208,20,81
2011,Harrogate 002D,E01027715,765,598,167,70,36,61
2011,Harrogate 003A,E01027643,1067,736,331,222,31,78
2011,Harrogate 003B,E01027688,1161,773,388,294,32,62
2011,Harrogate 003C,E01027736,1152,898,254,164,20,70
2011,Harrogate 003D,E01027737,1329,1090,239,131,19,89
2011,Harrogate 004A,E01027705,1268,984,284,150,29,105
2011,Harrogate 004B,E01027706,1354,1016,338,193,35,110
2011,Harrogate 004C,E01027707,1293,939,354,238,32,84
2011,Harrogate 004D,E01027708,1022,727,295,206,20,69
2011,Harrogate 004E,E01027709,883,627,256,189,20,47
2011,Harrogate 004F,E01027710,718,498,220,122,20,78
2011,Harrogate 004G,E01027711,944,727,217,102,31,84
2011,Harrogate 005A,E01027644,1055,791,264,187,23,54
2011,Harrogate 005B,E01027645,1155,883,272,172,30,70
2011,Harrogate 005C,E01027647,1189,868,321,215,36,70
2011,Harrogate 005D,E01027687,1122,839,283,191,46,46
2011,Harrogate 006A,E01027681,1207,888,319,194,36,89
2011,Harrogate 006B,E01027693,1341,1019,322,213,37,72
2011,Harrogate 006C,E01027701,1194,872,322,228,28,66
2011,Harrogate 006D,E01027702,805,577,228,153,16,59
2011,Harrogate 007A,E01027642,995,669,326,235,32,59
2011,Harrogate 007B,E01027646,1116,788,328,228,28,72
2011,Harrogate 007C,E01027674,945,686,259,151,43,65
2011,Harrogate 007D,E01027675,1700,1288,412,256,50,106
2011,Harrogate 008A,E01027641,1006,795,211,111,42,58
2011,Harrogate 008B,E01027664,1439,1073,366,214,46,106
2011,Harrogate 008C,E01027665,808,581,227,152,23,52
2011,Harrogate 008D,E01027722,1031,880,151,68,26,57
2011,Harrogate 009A,E01027668,1059,786,273,187,18,68
2011,Harrogate 009B,E01027669,1285,898,387,268,28,91
2011,Harrogate 009C,E01027673,1303,993,310,195,37,78
2011,Harrogate 009D,E01027676,1269,983,286,139,39,108
2011,Harrogate 010A,E01027638,1006,735,271,200,19,52
2011,Harrogate 010B,E01027639,950,691,259,177,26,56
2011,Harrogate 010C,E01027640,1065,826,239,161,21,57
2011,Harrogate 010D,E01027690,1056,804,252,160,23,69
2011,Harrogate 010E,E01027738,998,820,178,86,20,72
2011,Harrogate 010F,E01027739,841,664,177,92,12,73
2011,Harrogate 010G,E01027741,991,704,287,193,24,70
2011,Harrogate 011A,E01027689,1056,849,207,114,28,65
2011,Harrogate 011B,E01027691,1148,924,224,133,25,66
2011,Harrogate 011C,E01027720,1098,826,272,137,37,98
2011,Harrogate 011D,E01027721,1142,897,245,153,35,57
2011,Harrogate 011E,E01027723,1134,848,286,143,33,110
2011,Harrogate 012A,E01027670,1211,918,293,200,35,58
2011,Harrogate 012B,E01027671,1146,810,336,251,32,53
2011,Harrogate 012C,E01027672,1269,818,451,301,43,107
2011,Harrogate 012D,E01027704,860,593,267,181,25,61
2011,Harrogate 013A,E01027649,1265,970,295,131,38,126
2011,Harrogate 013B,E01027651,1078,765,313,116,58,139
2011,Harrogate 013C,E01027657,1016,866,150,48,34,68
2011,Harrogate 013D,E01027658,1198,992,206,103,20,83
2011,Harrogate 013E,E01027692,874,697,177,85,20,72
2011,Harrogate 013F,E01027740,1097,594,503,294,19,190
2011,Harrogate 014A,E01027648,1112,854,258,128,30,100
2011,Harrogate 014B,E01027650,1096,858,238,143,31,64
2011,Harrogate 014C,E01027726,1241,929,312,138,99,75
2011,Harrogate 014D,E01027727,1160,897,263,144,34,85
2011,Harrogate 014E,E01027728,952,678,274,194,10,70
2011,Harrogate 014F,E01027729,1158,955,203,86,25,92
2011,Harrogate 015A,E01027652,1128,830,298,174,35,89
2011,Harrogate 015B,E01027655,1035,666,369,165,147,57
2011,Harrogate 015C,E01027659,1447,1227,220,96,16,108
2011,Harrogate 015D,E01027677,1145,898,247,136,21,90
2011,Harrogate 015E,E01027678,1428,1180,248,89,30,129
2011,Harrogate 015F,E01027680,993,843,150,78,22,50
2011,Harrogate 016A,E01027683,1070,811,259,167,42,50
2011,Harrogate 016B,E01027684,1088,776,312,190,46,76
2011,Harrogate 016C,E01027695,1225,899,326,212,25,89
2011,Harrogate 016D,E01027696,1393,863,530,145,323,62
2011,Harrogate 016E,E01027703,1333,988,345,210,48,87
2011,Harrogate 017A,E01027660,1044,710,334,216,42,76
2011,Harrogate 017B,E01027661,1044,782,262,170,32,60
2011,Harrogate 017C,E01027662,870,675,195,119,31,45
2011,Harrogate 017D,E01027663,1007,767,240,168,20,52
2011,Harrogate 017E,E01027697,1003,757,246,148,38,60
2011,Harrogate 017F,E01027733,943,688,255,167,35,53
2011,Harrogate 018A,E01027682,1186,851,335,227,26,82
2011,Harrogate 018B,E01027694,952,690,262,156,24,82
2011,Harrogate 018C,E01027734,1153,843,310,203,30,77
2011,Harrogate 018D,E01027735,1183,853,330,210,46,74
2011,Harrogate 019A,E01027656,1200,883,317,198,33,86
2011,Harrogate 019B,E01027679,1101,828,273,166,27,80
2011,Harrogate 019C,E01027730,1107,822,285,146,52,87
2011,Harrogate 019D,E01027731,1038,812,226,120,42,64
2011,Harrogate 019E,E01027732,880,643,237,145,27,65
2011,Harrogate 020A,E01027653,945,630,315,181,39,95
2011,Harrogate 020B,E01027654,845,583,262,155,29,78
2011,Harrogate 020C,E01027698,1077,754,323,213,45,65
2011,Harrogate 020D,E01027716,976,626,350,252,35,63
2011,Harrogate 020E,E01027717,1039,805,234,138,32,64
2011,Harrogate 020F,E01027718,1270,902,368,206,58,104
2011,Harrogate 020G,E01027719,1009,678,331,206,74,51
2011,Harrogate 021A,E01027699,910,600,310,197,46,67
2011,Harrogate 021B,E01027700,850,593,257,167,25,65
2011,Harrogate 021C,E01027724,1129,822,307,192,38,77
2011,Harrogate 021D,E01027725,1093,778,315,203,40,72
2011,Richmondshire 001A,E01027743,908,618,290,206,24,60
2011,Richmondshire 001B,E01027751,947,696,251,158,32,61
2011,Richmondshire 001C,E01027752,897,664,233,160,26,47
2011,Richmondshire 001D,E01027759,1071,735,336,219,30,87
2011,Richmondshire 001E,E01027761,820,524,296,229,24,43
2011,Richmondshire 001F,E01027762,1026,774,252,157,26,69
2011,Richmondshire 002A,E01027765,1168,848,320,192,48,80
2011,Richmondshire 002B,E01027766,869,632,237,168,15,54
2011,Richmondshire 002C,E01027767,1072,720,352,245,37,70
2011,Richmondshire 002D,E01027768,831,577,254,166,40,48
2011,Richmondshire 002E,E01027769,952,655,297,176,39,82
2011,Richmondshire 002F,E01027770,1190,784,406,270,37,99
2011,Richmondshire 003A,E01027745,1129,851,278,141,36,101
2011,Richmondshire 003B,E01027746,1076,804,272,163,30,79
2011,Richmondshire 003C,E01027747,1650,1370,280,131,35,114
2011,Richmondshire 003D,E01027748,838,580,258,182,22,54
2011,Richmondshire 004A,E01027749,1386,997,389,136,41,212
2011,Richmondshire 004B,E01027750,2202,1814,388,168,61,159
2011,Richmondshire 004C,E01027754,938,714,224,83,18,123
2011,Richmondshire 004E,E01027771,2856,2518,338,35,19,284
2011,Richmondshire 004F,E01027772,1008,765,243,146,32,65
2011,Richmondshire 004G,E01033183,901,719,182,5,21,156
2011,Richmondshire 004H,E01033184,2147,1922,225,30,37,158
2011,Richmondshire 005A,E01027742,986,751,235,183,16,36
2011,Richmondshire 005B,E01027753,1035,784,251,155,25,71
2011,Richmondshire 005C,E01027763,881,605,276,217,14,45
2011,Richmondshire 005D,E01027764,914,653,261,180,26,55
2011,Richmondshire 005E,E01027773,846,590,256,199,15,42
2011,Richmondshire 006A,E01027744,953,655,298,234,12,52
2011,Richmondshire 006B,E01027756,1307,996,311,171,39,101
2011,Richmondshire 006D,E01027758,1045,757,288,211,22,55
2011,Richmondshire 006E,E01027760,974,697,277,198,14,65
2011,Richmondshire 006F,E01033185,901,640,261,205,5,51
2011,Richmondshire 006G,E01033186,928,608,320,242,19,59
2011,Ryedale 001A,E01027776,1121,764,357,243,33,81
2011,Ryedale 001B,E01027777,1093,805,288,199,27,62
2011,Ryedale 001C,E01027783,1297,880,417,333,23,61
2011,Ryedale 001D,E01027784,1148,811,337,218,30,89
2011,Ryedale 002A,E01027792,1277,842,435,337,30,68
2011,Ryedale 002B,E01027793,1020,701,319,205,25,89
2011,Ryedale 002C,E01027794,1418,948,470,340,36,94
2011,Ryedale 002D,E01027795,1137,813,324,184,35,105
2011,Ryedale 002E,E01027801,1122,735,387,280,36,71
2011,Ryedale 002F,E01027802,1210,843,367,235,36,96
2011,Ryedale 003A,E01027775,1460,815,645,220,325,100
2011,Ryedale 003B,E01027780,1340,1033,307,209,25,73
2011,Ryedale 003C,E01027781,851,578,273,208,14,51
2011,Ryedale 003D,E01027800,1252,920,332,220,34,78
2011,Ryedale 004A,E01027779,852,573,279,156,29,94
2011,Ryedale 004B,E01027796,1276,921,355,251,27,77
2011,Ryedale 004C,E01027798,1464,1050,414,222,42,150
2011,Ryedale 004D,E01027803,1340,975,365,211,42,112
2011,Ryedale 007A,E01027774,1509,1073,436,294,43,99
2011,Ryedale 007B,E01027778,1722,1245,477,300,57,120
2011,Ryedale 007C,E01027782,1245,863,382,253,44,85
2011,Ryedale 007D,E01027797,1288,954,334,216,43,75
2011,Ryedale 007E,E01027799,1287,921,366,262,32,72
2011,Ryedale 008A,E01027785,1118,862,256,133,19,104
2011,Ryedale 008B,E01027786,1142,777,365,277,35,53
2011,Ryedale 008C,E01027787,1228,874,354,195,36,123
2011,Ryedale 008D,E01027788,1061,714,347,256,20,71
2011,Ryedale 008E,E01027789,1732,1322,410,212,41,157
2011,Ryedale 008F,E01027790,1452,1148,304,168,46,90
2011,Ryedale 008G,E01027791,1119,884,235,168,17,50
2011,Scarborough 001A,E01027837,954,591,363,208,27,128
2011,Scarborough 001B,E01027839,1184,834,350,209,40,101
2011,Scarborough 001C,E01027869,910,594,316,155,15,146
2011,Scarborough 001D,E01027870,992,666,326,236,14,76
2011,Scarborough 001E,E01027871,1009,672,337,239,17,81
2011,Scarborough 002A,E01027813,1571,1046,525,326,57,142
2011,Scarborough 002B,E01027822,1087,753,334,223,30,81
2011,Scarborough 002C,E01027840,1567,975,592,349,67,176
2011,Scarborough 002D,E01027841,1009,695,314,211,23,80
2011,Scarborough 003A,E01027838,1166,785,381,270,29,82
2011,Scarborough 003B,E01027864,1066,737,329,144,28,157
2011,Scarborough 003C,E01027865,1256,876,380,203,37,140
2011,Scarborough 003D,E01027866,1133,780,353,210,28,115
2011,Scarborough 004A,E01027821,1054,693,361,279,19,63
2011,Scarborough 004B,E01027823,997,629,368,260,32,76
2011,Scarborough 004C,E01027831,782,525,257,190,13,54
2011,Scarborough 004D,E01027832,789,511,278,159,54,65
2011,Scarborough 004E,E01027836,1611,1065,546,401,46,99
2011,Scarborough 004F,E01027857,981,668,313,227,26,60
2011,Scarborough 005A,E01027842,1178,744,434,286,36,112
2011,Scarborough 005B,E01027843,952,651,301,181,33,87
2011,Scarborough 005C,E01027844,1151,778,373,263,39,71
2011,Scarborough 005D,E01027845,1243,906,337,239,37,61
2011,Scarborough 005E,E01027855,1086,682,404,290,46,68
2011,Scarborough 005F,E01027856,737,404,333,274,16,43
2011,Scarborough 006A,E01027805,1126,716,410,207,52,151
2011,Scarborough 006B,E01027806,1399,885,514,174,120,220
2011,Scarborough 006C,E01027846,1419,1029,390,196,58,136
2011,Scarborough 006D,E01027847,1524,1011,513,164,82,267
2011,Scarborough 006E,E01027848,748,514,234,156,30,48
2011,Scarborough 007A,E01027849,832,530,302,212,27,63
2011,Scarborough 007B,E01027850,905,610,295,143,21,131
2011,Scarborough 007C,E01027872,1039,649,390,182,60,148
2011,Scarborough 007D,E01027874,1085,623,462,130,67,265
2011,Scarborough 008A,E01027810,1213,908,305,118,69,118
2011,Scarborough 008B,E01027811,1207,912,295,129,63,103
2011,Scarborough 008C,E01027812,1275,949,326,133,61,132
2011,Scarborough 008D,E01027851,1154,878,276,151,39,86
2011,Scarborough 008E,E01027862,1204,849,355,177,47,131
2011,Scarborough 009A,E01027824,994,595,399,248,29,122
2011,Scarborough 009B,E01027825,1305,905,400,138,53,209
2011,Scarborough 009C,E01027826,1103,825,278,126,50,102
2011,Scarborough 009D,E01027861,945,678,267,148,25,94
2011,Scarborough 009E,E01027863,992,620,372,281,32,59
2011,Scarborough 009F,E01027873,1067,721,346,233,37,76
2011,Scarborough 010A,E01027804,1268,898,370,142,81,147
2011,Scarborough 010B,E01027852,1366,917,449,177,148,124
2011,Scarborough 010C,E01027853,923,580,343,206,56,81
2011,Scarborough 010D,E01027854,1199,798,401,172,102,127
2011,Scarborough 010E,E01027868,1533,856,677,428,116,133
2011,Scarborough 011A,E01027807,1072,719,353,261,16,76
2011,Scarborough 011B,E01027808,1080,642,438,323,25,90
2011,Scarborough 011C,E01027809,926,547,379,314,11,54
2011,Scarborough 011D,E01027818,1020,744,276,155,25,96
2011,Scarborough 011E,E01027867,1174,660,514,283,163,68
2011,Scarborough 012A,E01027817,998,625,373,137,48,188
2011,Scarborough 012B,E01027819,963,555,408,131,58,219
2011,Scarborough 012C,E01027820,926,604,322,104,28,190
2011,Scarborough 012D,E01027858,1017,683,334,255,23,56
2011,Scarborough 012E,E01027860,1103,760,343,216,31,96
2011,Scarborough 013A,E01027814,1110,764,346,240,36,70
2011,Scarborough 013B,E01027815,1010,718,292,203,28,61
2011,Scarborough 013C,E01027816,1138,743,395,283,33,79
2011,Scarborough 013D,E01027859,1297,921,376,272,35,69
2011,Scarborough 014A,E01027827,1200,699,501,306,27,168
2011,Scarborough 014B,E01027828,1113,552,561,426,33,102
2011,Scarborough 014C,E01027829,1032,530,502,413,24,65
2011,Scarborough 014D,E01027830,1288,839,449,220,55,174
2011,Scarborough 014E,E01027833,1201,707,494,329,35,130
2011,Scarborough 014F,E01027834,1112,660,452,338,31,83
2011,Scarborough 014G,E01027835,1323,857,466,305,42,119
2011,Selby 001A,E01027918,1079,805,274,154,37,83
2011,Selby 001B,E01027919,869,652,217,133,34,50
2011,Selby 001C,E01027920,951,692,259,165,36,58
2011,Selby 001D,E01027921,1230,877,353,255,32,66
2011,Selby 001E,E01027922,1245,922,323,226,35,62
2011,Selby 002A,E01027875,1357,962,395,254,59,82
2011,Selby 002B,E01027886,1001,749,252,170,22,60
2011,Selby 002C,E01027887,1192,896,296,191,34,71
2011,Selby 002D,E01027888,1276,968,308,191,49,68
2011,Selby 002E,E01027904,1695,1282,413,246,61,106
2011,Selby 003A,E01027876,1213,936,277,175,33,69
2011,Selby 003B,E01027877,938,709,229,148,13,68
2011,Selby 003C,E01027900,1414,1110,304,182,30,92
2011,Selby 003D,E01027901,1175,886,289,204,29,56
2011,Selby 003E,E01027902,1090,789,301,196,39,66
2011,Selby 003F,E01027903,810,533,277,149,90,38
2011,Selby 004A,E01027898,1784,1389,395,256,47,92
2011,Selby 004B,E01027914,1278,933,345,239,32,74
2011,Selby 004C,E01027915,1176,861,315,171,35,109
2011,Selby 004D,E01027916,1117,825,292,144,54,94
2011,Selby 004E,E01027917,1415,1141,274,144,51,79
2011,Selby 005A,E01027878,964,766,198,101,28,69
2011,Selby 005B,E01027905,1446,1091,355,173,32,150
2011,Selby 005C,E01027907,953,615,338,112,37,189
2011,Selby 005D,E01027908,1157,863,294,125,31,138
2011,Selby 005E,E01027909,1568,1205,363,167,35,161
2011,Selby 005F,E01027910,1960,1473,487,175,77,235
2011,Selby 006A,E01027881,911,609,302,205,18,79
2011,Selby 006B,E01027906,1052,768,284,108,44,132
2011,Selby 006C,E01027911,986,662,324,220,27,77
2011,Selby 006D,E01027912,768,545,223,158,17,48
2011,Selby 006E,E01027913,849,631,218,157,14,47
2011,Selby 007A,E01027879,1042,772,270,169,31,70
2011,Selby 007B,E01027880,1190,845,345,250,36,59
2011,Selby 007C,E01027882,1388,1061,327,207,40,80
2011,Selby 007D,E01027894,1407,993,414,248,45,121
2011,Selby 007E,E01027895,1196,815,381,284,30,67
2011,Selby 008A,E01027883,862,623,239,140,29,70
2011,Selby 008B,E01027884,1198,905,293,153,50,90
2011,Selby 008C,E01027885,1165,836,329,213,38,78
2011,Selby 008D,E01027896,1480,1138,342,207,45,90
2011,Selby 008E,E01027897,1576,1205,371,228,37,106
2011,Selby 009A,E01027891,1280,901,379,262,20,97
2011,Selby 009B,E01027892,1417,1001,416,233,33,150
2011,Selby 009C,E01027893,1388,1038,350,254,28,68
2011,Selby 009D,E01027899,1246,937,309,185,50,74
2011,Selby 010A,E01027889,1279,934,345,195,27,123
2011,Selby 010B,E01027890,1485,1102,383,244,43,96
2011,Selby 010C,E01027923,1688,1225,463,316,44,103
2011,Selby 010D,E01027924,1625,1244,381,228,45,108
2011,Barnsley 001A,E01007434,1406,972,434,184,54,196
2011,Barnsley 001B,E01007435,1112,702,410,164,43,203
2011,Barnsley 001C,E01007438,1132,724,408,245,48,115
2011,Barnsley 001D,E01007439,943,662,281,180,29,72
2011,Barnsley 002A,E01007433,1198,754,444,222,60,162
2011,Barnsley 002B,E01007436,912,570,342,201,18,123
2011,Barnsley 002C,E01007437,1136,786,350,164,37,149
2011,Barnsley 002D,E01007440,1126,744,382,145,48,189
2011,Barnsley 003A,E01007329,1112,745,367,172,40,155
2011,Barnsley 003B,E01007331,1405,953,452,249,41,162
2011,Barnsley 003C,E01007342,1039,691,348,180,35,133
2011,Barnsley 003D,E01007343,977,616,361,203,29,129
2011,Barnsley 004A,E01007356,1029,655,374,246,30,98
2011,Barnsley 004B,E01007357,999,693,306,152,44,110
2011,Barnsley 004C,E01007361,1235,913,322,169,47,106
2011,Barnsley 004D,E01007362,1245,885,360,230,39,91
2011,Barnsley 004E,E01007363,1151,707,444,214,39,191
2011,Barnsley 005A,E01007355,1125,865,260,163,36,61
2011,Barnsley 005B,E01007358,1139,823,316,192,39,85
2011,Barnsley 005C,E01007359,1095,749,346,194,38,114
2011,Barnsley 005D,E01007360,1151,695,456,285,47,124
2011,Barnsley 005E,E01007386,1294,873,421,304,45,72
2011,Barnsley 006A,E01007328,1376,847,529,185,42,302
2011,Barnsley 006B,E01007330,1269,852,417,201,48,168
2011,Barnsley 006C,E01007332,1646,1066,580,209,41,330
2011,Barnsley 006D,E01007333,929,570,359,135,30,194
2011,Barnsley 007A,E01007323,1072,721,351,104,45,202
2011,Barnsley 007B,E01007324,1223,766,457,196,41,220
2011,Barnsley 007C,E01007325,1108,676,432,93,56,283
2011,Barnsley 007D,E01007326,1107,700,407,150,56,201
2011,Barnsley 007E,E01007327,1210,660,550,252,43,255
2011,Barnsley 007F,E01007411,837,473,364,101,48,215
2011,Barnsley 008A,E01007341,879,527,352,104,48,200
2011,Barnsley 008B,E01007345,1169,828,341,161,41,139
2011,Barnsley 008C,E01007346,1186,806,380,148,40,192
2011,Barnsley 008D,E01007347,1186,873,313,159,42,112
2011,Barnsley 009A,E01007334,1095,769,326,215,37,74
2011,Barnsley 009B,E01007335,1123,785,338,179,40,119
2011,Barnsley 009C,E01007400,1508,1075,433,269,47,117
2011,Barnsley 009D,E01007404,1017,653,364,255,25,84
2011,Barnsley 009E,E01007406,1244,741,503,248,40,215
2011,Barnsley 010C,E01007408,1096,750,346,194,50,102
2011,Barnsley 010D,E01007409,1093,796,297,178,49,70
2011,Barnsley 010E,E01007410,1270,794,476,222,47,207
2011,Barnsley 010G,E01032550,2077,1445,632,263,80,289
2011,Barnsley 010H,E01032551,1890,1350,540,277,87,176
2011,Barnsley 011A,E01007344,1570,1137,433,205,48,180
2011,Barnsley 011B,E01007402,1184,707,477,143,51,283
2011,Barnsley 011C,E01007403,1120,657,463,143,38,282
2011,Barnsley 011D,E01007405,1046,560,486,269,36,181
2011,Barnsley 012A,E01007379,1204,790,414,274,29,111
2011,Barnsley 012B,E01007380,1341,982,359,231,58,70
2011,Barnsley 012C,E01007381,1131,815,316,179,43,94
2011,Barnsley 012D,E01007387,1073,790,283,163,31,89
2011,Barnsley 012E,E01007442,980,599,381,292,37,52
2011,Barnsley 012F,E01007444,1122,737,385,251,36,98
2011,Barnsley 012G,E01007446,989,625,364,253,27,84
2011,Barnsley 013A,E01007336,1232,865,367,144,53,170
2011,Barnsley 013B,E01007340,1246,959,287,84,49,154
2011,Barnsley 013C,E01007415,1097,775,322,158,38,126
2011,Barnsley 013D,E01007417,1206,875,331,133,46,152
2011,Barnsley 013E,E01007441,1191,866,325,131,56,138
2011,Barnsley 013F,E01007443,1577,1130,447,126,82,239
2011,Barnsley 013G,E01007445,1095,837,258,130,21,107
2011,Barnsley 014A,E01007372,867,469,398,143,35,220
2011,Barnsley 014B,E01007373,1159,673,486,156,48,282
2011,Barnsley 014C,E01007374,1105,660,445,252,36,157
2011,Barnsley 014D,E01007375,1217,754,463,217,47,199
2011,Barnsley 014E,E01007377,797,499,298,92,33,173
2011,Barnsley 014F,E01007378,1122,587,535,191,37,307
2011,Barnsley 015A,E01007319,1115,729,386,252,40,94
2011,Barnsley 015B,E01007321,1113,720,393,269,38,86
2011,Barnsley 015C,E01007322,1547,1171,376,150,48,178
2011,Barnsley 015D,E01007337,1392,1031,361,129,51,181
2011,Barnsley 016A,E01007418,948,599,349,252,40,57
2011,Barnsley 016B,E01007419,1277,850,427,286,55,86
2011,Barnsley 016C,E01007420,1059,703,356,238,47,71
2011,Barnsley 016D,E01007425,1107,745,362,255,38,69
2011,Barnsley 017A,E01007338,1089,539,550,282,27,241
2011,Barnsley 017B,E01007339,1152,777,375,134,59,182
2011,Barnsley 017C,E01007413,946,551,395,127,40,228
2011,Barnsley 017D,E01007414,1191,782,409,161,59,189
2011,Barnsley 018A,E01007317,1093,626,467,198,47,222
2011,Barnsley 018B,E01007318,1095,691,404,130,38,236
2011,Barnsley 018C,E01007320,1160,706,454,159,53,242
2011,Barnsley 018D,E01007416,854,478,376,138,42,196
2011,Barnsley 019A,E01007382,1097,735,362,193,54,115
2011,Barnsley 019B,E01007383,1049,813,236,109,45,82
2011,Barnsley 019C,E01007384,1222,827,395,254,43,98
2011,Barnsley 019D,E01007385,1026,606,420,238,37,145
2011,Barnsley 020A,E01007348,1021,577,444,199,36,209
2011,Barnsley 020B,E01007349,1107,669,438,201,51,186
2011,Barnsley 020C,E01007350,892,516,376,270,24,82
2011,Barnsley 020D,E01007351,1036,697,339,191,30,118
2011,Barnsley 020E,E01007352,1004,620,384,144,48,192
2011,Barnsley 020F,E01007353,1186,837,349,157,47,145
2011,Barnsley 020G,E01007354,1263,830,433,179,54,200
2011,Barnsley 021A,E01007458,1132,774,358,156,49,153
2011,Barnsley 021B,E01007459,1111,648,463,307,47,109
2011,Barnsley 021C,E01007460,1093,742,351,206,45,100
2011,Barnsley 021D,E01007461,1195,732,463,172,37,254
2011,Barnsley 021E,E01007462,1106,671,435,149,46,240
2011,Barnsley 021F,E01007463,1232,680,552,207,46,299
2011,Barnsley 022A,E01007369,1106,677,429,133,29,267
2011,Barnsley 022B,E01007370,1033,624,409,150,43,216
2011,Barnsley 022C,E01007371,1452,950,502,205,64,233
2011,Barnsley 022D,E01007376,1037,658,379,134,43,202
2011,Barnsley 023A,E01007447,1062,689,373,171,30,172
2011,Barnsley 023B,E01007448,1263,873,390,157,29,204
2011,Barnsley 023C,E01007449,1389,973,416,226,34,156
2011,Barnsley 023D,E01007450,1163,659,504,238,42,224
2011,Barnsley 024A,E01007427,1157,872,285,171,33,81
2011,Barnsley 024B,E01007428,1081,789,292,194,28,70
2011,Barnsley 024C,E01007429,1008,634,374,225,44,105
2011,Barnsley 024D,E01007430,1682,1362,320,162,56,102
2011,Barnsley 024E,E01007431,1052,766,286,179,37,70
2011,Barnsley 024F,E01007432,1040,731,309,180,46,83
2011,Barnsley 025A,E01007364,1014,597,417,159,40,218
2011,Barnsley 025B,E01007365,871,523,348,125,36,187
2011,Barnsley 025C,E01007366,1540,1130,410,230,37,143
2011,Barnsley 025D,E01007367,839,534,305,101,32,172
2011,Barnsley 025E,E01007368,1194,825,369,148,43,178
2011,Barnsley 026A,E01007451,1229,822,407,175,51,181
2011,Barnsley 026B,E01007452,1156,873,283,134,35,114
2011,Barnsley 026C,E01007453,1070,599,471,185,38,248
2011,Barnsley 026E,E01007455,1064,691,373,248,35,90
2011,Barnsley 026F,E01032924,1141,925,216,75,47,94
2011,Barnsley 026G,E01032925,950,623,327,172,34,121
2011,Barnsley 027A,E01007421,1056,736,320,220,49,51
2011,Barnsley 027B,E01007422,1153,844,309,201,37,71
2011,Barnsley 027C,E01007423,1214,853,361,228,41,92
2011,Barnsley 027D,E01007426,1193,841,352,247,23,82
2011,Barnsley 028A,E01007396,1178,822,356,186,48,122
2011,Barnsley 028B,E01007397,1029,634,395,229,28,138
2011,Barnsley 028C,E01007398,1183,697,486,361,25,100
2011,Barnsley 028D,E01007399,1523,1171,352,208,46,98
2011,Barnsley 028E,E01007424,1236,876,360,220,41,99
2011,Barnsley 029A,E01007388,1248,916,332,149,49,134
2011,Barnsley 029B,E01007393,1310,937,373,163,52,158
2011,Barnsley 029C,E01007394,991,668,323,125,44,154
2011,Barnsley 029D,E01007456,1331,993,338,190,33,115
2011,Barnsley 029E,E01007457,1204,818,386,166,43,177
2011,Barnsley 030A,E01007389,1090,688,402,309,24,69
2011,Barnsley 030B,E01007390,1146,814,332,182,34,116
2011,Barnsley 030C,E01007391,1070,703,367,182,31,154
2011,Barnsley 030D,E01007392,1092,688,404,140,51,213
2011,Barnsley 030E,E01007395,1413,888,525,217,55,253
2011,Doncaster 001A,E01007632,1177,794,383,122,59,202
2011,Doncaster 001B,E01007633,942,603,339,103,44,192
2011,Doncaster 001C,E01007634,1138,705,433,163,35,235
2011,Doncaster 001D,E01007635,1049,622,427,239,23,165
2011,Doncaster 002A,E01007487,1155,754,401,216,46,139
2011,Doncaster 002B,E01007488,1321,861,460,258,42,160
2011,Doncaster 002C,E01007489,1243,917,326,163,38,125
2011,Doncaster 002D,E01007490,1143,740,403,210,44,149
2011,Doncaster 002E,E01007491,1212,747,465,155,48,262
2011,Doncaster 002F,E01007492,1058,617,441,200,53,188
2011,Doncaster 002G,E01007493,1283,928,355,214,44,97
2011,Doncaster 003A,E01007636,1059,661,398,149,44,205
2011,Doncaster 003B,E01007637,1104,671,433,233,39,161
2011,Doncaster 003C,E01007638,1131,697,434,189,57,188
2011,Doncaster 003D,E01007639,1428,978,450,213,64,173
2011,Doncaster 003E,E01007640,1236,811,425,278,36,111
2011,Doncaster 003F,E01007641,1110,781,329,149,43,137
2011,Doncaster 003G,E01007642,1100,719,381,127,55,199
2011,Doncaster 004A,E01007625,1123,786,337,198,41,98
2011,Doncaster 004B,E01007626,892,550,342,133,22,187
2011,Doncaster 004C,E01007627,1174,711,463,202,51,210
2011,Doncaster 004D,E01007628,1032,629,403,108,56,239
2011,Doncaster 004E,E01007629,1109,643,466,172,52,242
2011,Doncaster 005A,E01007468,965,581,384,299,24,61
2011,Doncaster 005B,E01007469,977,695,282,139,30,113
2011,Doncaster 005C,E01007470,1019,704,315,113,39,163
2011,Doncaster 005D,E01007472,1120,647,473,157,50,266
2011,Doncaster 005E,E01007473,1079,748,331,135,23,173
2011,Doncaster 005F,E01007474,896,452,444,203,28,213
2011,Doncaster 006A,E01007554,1240,885,355,195,38,122
2011,Doncaster 006B,E01007555,1038,575,463,230,40,193
2011,Doncaster 006C,E01007556,960,626,334,85,44,205
2011,Doncaster 006D,E01007561,1035,723,312,224,35,53
2011,Doncaster 006E,E01007562,1023,696,327,180,36,111
2011,Doncaster 006F,E01007563,993,599,394,104,47,243
2011,Doncaster 007A,E01007621,1052,804,248,116,53,79
2011,Doncaster 007B,E01007622,1144,821,323,218,31,74
2011,Doncaster 007C,E01007623,895,598,297,178,21,98
2011,Doncaster 007D,E01007624,1358,1042,316,185,57,74
2011,Doncaster 007E,E01007630,974,589,385,287,27,71
2011,Doncaster 007F,E01007631,910,587,323,246,26,51
2011,Doncaster 008A,E01007553,1262,901,361,226,46,89
2011,Doncaster 008B,E01007557,2513,1035,1478,148,69,1261
2011,Doncaster 008C,E01007558,1093,754,339,182,39,118
2011,Doncaster 008D,E01007559,936,537,399,166,33,200
2011,Doncaster 008E,E01007560,1122,730,392,276,31,85
2011,Doncaster 009A,E01007464,1102,720,382,136,61,185
2011,Doncaster 009B,E01007465,1041,687,354,157,40,157
2011,Doncaster 009C,E01007466,1168,730,438,129,51,258
2011,Doncaster 009D,E01007467,1088,731,357,145,31,181
2011,Doncaster 009E,E01007471,1150,886,264,141,45,78
2011,Doncaster 009F,E01007504,1147,778,369,162,44,163
2011,Doncaster 009G,E01007507,940,586,354,89,55,210
2011,Doncaster 010A,E01007506,1017,634,383,109,46,228
2011,Doncaster 010B,E01007508,1161,752,409,111,46,252
2011,Doncaster 010C,E01007509,1235,747,488,185,46,257
2011,Doncaster 010D,E01007510,1128,799,329,153,47,129
2011,Doncaster 010E,E01007511,1124,705,419,153,52,214
2011,Doncaster 011A,E01007475,1175,914,261,153,46,62
2011,Doncaster 011B,E01007476,1001,688,313,186,36,91
2011,Doncaster 011C,E01007477,1040,711,329,210,47,72
2011,Doncaster 011D,E01007478,1157,768,389,211,42,136
2011,Doncaster 012A,E01007512,1191,917,274,139,39,96
2011,Doncaster 012B,E01007513,994,663,331,184,44,103
2011,Doncaster 012C,E01007515,1126,750,376,154,44,178
2011,Doncaster 012D,E01007518,1097,780,317,170,44,103
2011,Doncaster 012E,E01007519,938,711,227,66,51,110
2011,Doncaster 013A,E01007505,1285,862,423,243,40,140
2011,Doncaster 013B,E01007514,1119,845,274,101,34,139
2011,Doncaster 013C,E01007516,996,727,269,150,40,79
2011,Doncaster 013D,E01007517,1152,810,342,121,42,179
2011,Doncaster 014A,E01007479,1146,759,387,209,32,146
2011,Doncaster 014B,E01007480,1065,762,303,102,44,157
2011,Doncaster 014D,E01007482,960,563,397,200,35,162
2011,Doncaster 014E,E01033259,1190,1011,179,90,28,61
2011,Doncaster 014F,E01033260,1177,932,245,83,37,125
2011,Doncaster 015A,E01007570,1031,709,322,191,41,90
2011,Doncaster 015B,E01007650,1224,810,414,255,39,120
2011,Doncaster 015C,E01007651,1250,858,392,106,68,218
2011,Doncaster 015D,E01007652,1313,829,484,170,65,249
2011,Doncaster 015E,E01007653,1199,887,312,124,49,139
2011,Doncaster 015F,E01007656,1077,679,398,174,44,180
2011,Doncaster 016A,E01007581,1159,840,319,202,52,65
2011,Doncaster 016B,E01007582,1085,818,267,156,36,75
2011,Doncaster 016C,E01007588,1196,824,372,182,47,143
2011,Doncaster 016D,E01007589,1283,866,417,293,43,81
2011,Doncaster 017A,E01007483,1078,780,298,180,38,80
2011,Doncaster 017B,E01007484,1007,711,296,182,28,86
2011,Doncaster 017C,E01007485,1107,864,243,146,30,67
2011,Doncaster 017D,E01007486,1003,597,406,292,17,97
2011,Doncaster 018A,E01007564,1034,705,329,119,52,158
2011,Doncaster 018B,E01007565,1089,778,311,167,45,99
2011,Doncaster 018C,E01007566,1155,736,419,146,35,238
2011,Doncaster 018D,E01007567,980,682,298,123,58,117
2011,Doncaster 018E,E01007568,1116,712,404,101,72,231
2011,Doncaster 018F,E01007569,1136,794,342,123,41,178
2011,Doncaster 019A,E01007644,1169,838,331,106,120,105
2011,Doncaster 019B,E01007646,1100,817,283,152,37,94
2011,Doncaster 019C,E01007647,1112,825,287,139,55,93
2011,Doncaster 019D,E01007648,1503,1100,403,119,64,220
2011,Doncaster 019E,E01007649,1164,882,282,129,63,90
2011,Doncaster 019F,E01007654,1167,834,333,124,42,167
2011,Doncaster 020A,E01007583,1121,727,394,269,45,80
2011,Doncaster 020B,E01007586,1184,768,416,255,44,117
2011,Doncaster 020C,E01007587,1174,724,450,292,30,128
2011,Doncaster 020D,E01007620,1245,834,411,280,37,94
2011,Doncaster 021A,E01007584,1136,828,308,207,36,65
2011,Doncaster 021B,E01007585,1152,840,312,173,44,95
2011,Doncaster 021C,E01007617,1095,725,370,289,34,47
2011,Doncaster 021D,E01007618,953,683,270,188,34,48
2011,Doncaster 021E,E01007619,1296,977,319,204,55,60
2011,Doncaster 022A,E01007529,1696,845,851,79,54,718
2011,Doncaster 022B,E01007530,877,572,305,83,36,186
2011,Doncaster 022C,E01007531,1183,756,427,190,40,197
2011,Doncaster 022D,E01007643,1157,726,431,129,68,234
2011,Doncaster 022E,E01007645,1589,1128,461,99,91,271
2011,Doncaster 022F,E01007655,1526,1079,447,100,81,266
2011,Doncaster 023A,E01007494,1187,869,318,126,30,162
2011,Doncaster 023B,E01007532,1344,740,604,171,63,370
2011,Doncaster 023C,E01007533,1053,724,329,144,57,128
2011,Doncaster 023D,E01007535,1130,825,305,110,43,152
2011,Doncaster 024A,E01007522,1041,630,411,177,65,169
2011,Doncaster 024B,E01007525,1012,689,323,146,38,139
2011,Doncaster 024C,E01007528,894,583,311,145,29,137
2011,Doncaster 024D,E01007604,1076,747,329,206,42,81
2011,Doncaster 025A,E01007521,1028,691,337,192,47,98
2011,Doncaster 025B,E01007523,1098,762,336,182,50,104
2011,Doncaster 025C,E01007524,1121,747,374,235,47,92
2011,Doncaster 025D,E01007526,1154,792,362,216,53,93
2011,Doncaster 025E,E01007607,1051,652,399,208,53,138
2011,Doncaster 026A,E01007599,1318,915,403,250,61,92
2011,Doncaster 026B,E01007600,1121,761,360,249,48,63
2011,Doncaster 026C,E01007601,986,649,337,250,32,55
2011,Doncaster 026D,E01007602,1116,768,348,224,52,72
2011,Doncaster 026E,E01007603,1108,782,326,210,38,78
2011,Doncaster 027A,E01007520,1033,619,414,303,31,80
2011,Doncaster 027B,E01007527,1816,1414,402,207,75,120
2011,Doncaster 027C,E01007605,1093,730,363,243,53,67
2011,Doncaster 027D,E01007606,1109,738,371,232,54,85
2011,Doncaster 028A,E01007495,1360,939,421,139,53,229
2011,Doncaster 028B,E01007500,873,547,326,132,39,155
2011,Doncaster 028C,E01007502,2111,1793,318,107,58,153
2011,Doncaster 028D,E01007534,1543,1056,487,113,52,322
2011,Doncaster 029A,E01007496,1100,713,387,88,74,225
2011,Doncaster 029B,E01007497,984,639,345,152,32,161
2011,Doncaster 029C,E01007498,1173,825,348,132,50,166
2011,Doncaster 029D,E01007499,1011,589,422,168,45,209
2011,Doncaster 029E,E01007501,1051,683,368,256,35,77
2011,Doncaster 029F,E01007503,1258,910,348,228,35,85
2011,Doncaster 030A,E01007575,956,517,439,158,40,241
2011,Doncaster 030B,E01007578,1206,778,428,194,50,184
2011,Doncaster 030C,E01007579,1148,799,349,164,38,147
2011,Doncaster 030D,E01007580,1071,608,463,280,48,135
2011,Doncaster 031A,E01007571,1234,896,338,149,45,144
2011,Doncaster 031B,E01007572,1074,676,398,216,53,129
2011,Doncaster 031C,E01007573,1062,602,460,126,67,267
2011,Doncaster 031D,E01007574,1158,725,433,137,51,245
2011,Doncaster 031E,E01007576,1177,832,345,147,55,143
2011,Doncaster 031F,E01007577,1115,666,449,133,47,269
2011,Doncaster 032A,E01007536,1519,1114,405,206,45,154
2011,Doncaster 032B,E01007542,1275,733,542,215,45,282
2011,Doncaster 032C,E01007543,1109,536,573,257,51,265
2011,Doncaster 032D,E01007544,1182,508,674,237,66,371
2011,Doncaster 033A,E01007546,1038,705,333,153,40,140
2011,Doncaster 033B,E01007551,1228,851,377,240,39,98
2011,Doncaster 033C,E01007552,1033,727,306,202,33,71
2011,Doncaster 033D,E01007613,1223,816,407,265,68,74
2011,Doncaster 034A,E01007545,1122,841,281,126,37,118
2011,Doncaster 034B,E01007547,1119,757,362,132,43,187
2011,Doncaster 034C,E01007548,751,488,263,104,23,136
2011,Doncaster 034D,E01007549,1052,630,422,189,50,183
2011,Doncaster 034E,E01007550,1191,781,410,182,45,183
2011,Doncaster 035A,E01007537,1274,890,384,160,65,159
2011,Doncaster 035B,E01007538,1094,733,361,135,54,172
2011,Doncaster 035C,E01007539,1016,676,340,118,38,184
2011,Doncaster 035D,E01007540,1188,823,365,155,44,166
2011,Doncaster 035E,E01007541,1074,681,393,178,44,171
2011,Doncaster 036A,E01007591,1033,699,334,154,38,142
2011,Doncaster 036B,E01007594,1530,1196,334,161,68,105
2011,Doncaster 036C,E01007596,956,658,298,190,34,74
2011,Doncaster 036D,E01007598,1198,820,378,235,37,106
2011,Doncaster 037A,E01007590,904,609,295,111,45,139
2011,Doncaster 037B,E01007592,1075,672,403,139,44,220
2011,Doncaster 037C,E01007593,959,610,349,120,35,194
2011,Doncaster 037D,E01007595,1060,685,375,176,54,145
2011,Doncaster 037E,E01007597,1064,641,423,139,50,234
2011,Doncaster 038A,E01007608,1228,979,249,54,74,121
2011,Doncaster 038B,E01007609,1699,1173,526,307,56,163
2011,Doncaster 038C,E01007610,1295,869,426,295,41,90
2011,Doncaster 039A,E01007611,971,630,341,227,30,84
2011,Doncaster 039B,E01007612,1037,684,353,251,31,71
2011,Doncaster 039C,E01007614,1013,675,338,194,30,114
2011,Doncaster 039D,E01007615,852,532,320,232,14,74
2011,Doncaster 039E,E01007616,907,559,348,260,24,64
2011,Rotherham 001A,E01007693,1591,1208,383,152,42,189
2011,Rotherham 001B,E01007694,1250,839,411,144,59,208
2011,Rotherham 001C,E01007695,1788,1377,411,212,58,141
2011,Rotherham 001D,E01007697,1095,665,430,194,51,185
2011,Rotherham 001E,E01007698,1140,828,312,173,35,104
2011,Rotherham 002A,E01007816,1196,768,428,199,50,179
2011,Rotherham 002B,E01007817,1016,657,359,209,36,114
2011,Rotherham 002C,E01007819,1063,658,405,235,40,130
2011,Rotherham 002D,E01007820,1107,802,305,108,37,160
2011,Rotherham 002E,E01007821,1111,711,400,222,35,143
2011,Rotherham 002F,E01007822,1097,625,472,245,40,187
2011,Rotherham 003A,E01007796,754,471,283,137,20,126
2011,Rotherham 003B,E01007797,1026,658,368,221,42,105
2011,Rotherham 003C,E01007798,972,650,322,218,32,72
2011,Rotherham 003D,E01007799,1011,636,375,190,48,137
2011,Rotherham 003E,E01007800,1114,794,320,169,27,124
2011,Rotherham 003F,E01007818,1178,826,352,237,45,70
2011,Rotherham 004A,E01007777,1156,779,377,173,36,168
2011,Rotherham 004B,E01007793,1028,680,348,189,41,118
2011,Rotherham 004C,E01007794,995,566,429,168,46,215
2011,Rotherham 004D,E01007795,1175,807,368,263,29,76
2011,Rotherham 005A,E01007778,1151,825,326,197,57,72
2011,Rotherham 005B,E01007779,909,557,352,200,15,137
2011,Rotherham 005C,E01007780,1060,691,369,243,32,94
2011,Rotherham 005D,E01007781,1075,694,381,186,53,142
2011,Rotherham 005E,E01007782,1077,700,377,161,58,158
2011,Rotherham 006A,E01007771,1064,758,306,201,25,80
2011,Rotherham 006B,E01007772,992,674,318,149,33,136
2011,Rotherham 006C,E01007773,998,673,325,139,40,146
2011,Rotherham 006D,E01007774,1099,781,318,117,40,161
2011,Rotherham 007A,E01007696,1111,749,362,274,23,65
2011,Rotherham 007B,E01007801,1148,853,295,189,37,69
2011,Rotherham 007C,E01007802,1070,781,289,184,44,61
2011,Rotherham 007D,E01007803,1001,717,284,166,38,80
2011,Rotherham 007E,E01007808,1193,942,251,167,43,41
2011,Rotherham 008A,E01007775,911,524,387,114,42,231
2011,Rotherham 008B,E01007776,1109,766,343,168,42,133
2011,Rotherham 008C,E01007783,1220,746,474,249,38,187
2011,Rotherham 008D,E01007784,1300,935,365,108,37,220
2011,Rotherham 009A,E01007728,844,541,303,179,27,97
2011,Rotherham 009B,E01007729,1267,818,449,191,24,234
2011,Rotherham 009C,E01007730,1065,678,387,179,30,178
2011,Rotherham 009D,E01007731,927,674,253,157,27,69
2011,Rotherham 009E,E01007732,1104,664,440,233,33,174
2011,Rotherham 009F,E01007733,996,654,342,179,23,140
2011,Rotherham 010A,E01007719,882,528,354,137,31,186
2011,Rotherham 010B,E01007720,1094,690,404,219,31,154
2011,Rotherham 010C,E01007721,1135,697,438,137,50,251
2011,Rotherham 010D,E01007727,1120,663,457,200,48,209
2011,Rotherham 011A,E01007740,1077,713,364,137,57,170
2011,Rotherham 011B,E01007804,1016,633,383,153,43,187
2011,Rotherham 011C,E01007805,1006,614,392,172,41,179
2011,Rotherham 011D,E01007806,896,618,278,93,42,143
2011,Rotherham 011E,E01007807,1014,687,327,172,51,104
2011,Rotherham 012A,E01007681,1004,637,367,250,26,91
2011,Rotherham 012B,E01007691,1541,1081,460,333,35,92
2011,Rotherham 012C,E01007692,1137,829,308,207,28,73
2011,Rotherham 012E,E01032926,1236,1055,181,46,37,98
2011,Rotherham 012F,E01032927,1099,819,280,121,48,111
2011,Rotherham 013A,E01007723,989,596,393,151,39,203
2011,Rotherham 013B,E01007735,979,555,424,103,44,277
2011,Rotherham 013C,E01007737,1064,635,429,87,69,273
2011,Rotherham 013D,E01007738,1058,628,430,117,67,246
2011,Rotherham 013E,E01007739,1091,522,569,212,65,292
2011,Rotherham 014A,E01007736,1104,610,494,117,54,323
2011,Rotherham 014B,E01007765,1167,853,314,139,54,121
2011,Rotherham 014C,E01007766,1057,675,382,131,59,192
2011,Rotherham 014D,E01007768,1327,764,563,147,75,341
2011,Rotherham 014E,E01007770,1258,768,490,138,78,274
2011,Rotherham 015A,E01007741,1204,809,395,299,36,60
2011,Rotherham 015B,E01007742,1035,666,369,213,56,100
2011,Rotherham 015C,E01007743,1049,783,266,177,36,53
2011,Rotherham 015D,E01007744,1182,810,372,181,41,150
2011,Rotherham 015E,E01007745,1086,737,349,154,38,157
2011,Rotherham 015F,E01007746,1151,832,319,148,51,120
2011,Rotherham 016A,E01007715,1183,707,476,74,78,324
2011,Rotherham 016B,E01007716,1355,795,560,147,95,318
2011,Rotherham 016C,E01007717,1407,951,456,159,61,236
2011,Rotherham 016D,E01007718,1089,742,347,109,28,210
2011,Rotherham 017A,E01007677,984,514,470,143,54,273
2011,Rotherham 017B,E01007714,1523,958,565,143,88,334
2011,Rotherham 017C,E01007767,1180,775,405,149,67,189
2011,Rotherham 017D,E01007769,1185,660,525,72,89,364
2011,Rotherham 018A,E01007685,1094,796,298,212,31,55
2011,Rotherham 018B,E01007754,1088,843,245,97,44,104
2011,Rotherham 018C,E01007755,1092,830,262,141,34,87
2011,Rotherham 018D,E01007756,1142,833,309,205,40,64
2011,Rotherham 018E,E01007761,1148,772,376,209,55,112
2011,Rotherham 018F,E01007762,1004,673,331,209,39,83
2011,Rotherham 019A,E01007682,1039,745,294,138,33,123
2011,Rotherham 019B,E01007683,1120,792,328,202,39,87
2011,Rotherham 019C,E01007686,997,619,378,303,22,53
2011,Rotherham 019D,E01007688,1050,656,394,296,35,63
2011,Rotherham 019E,E01007725,944,734,210,104,41,65
2011,Rotherham 019F,E01007726,1091,667,424,136,37,251
2011,Rotherham 020A,E01007757,1265,864,401,226,46,129
2011,Rotherham 020B,E01007758,953,623,330,158,33,139
2011,Rotherham 020C,E01007759,1109,686,423,180,58,185
2011,Rotherham 020D,E01007760,1291,823,468,144,71,253
2011,Rotherham 020E,E01007763,1078,677,401,150,46,205
2011,Rotherham 020F,E01007764,1155,701,454,130,58,266
2011,Rotherham 021A,E01007708,1155,659,496,192,55,249
2011,Rotherham 021B,E01007709,1033,716,317,212,43,62
2011,Rotherham 021C,E01007710,1142,794,348,254,42,52
2011,Rotherham 021D,E01007711,1238,865,373,245,58,70
2011,Rotherham 021E,E01007724,1038,696,342,215,33,94
2011,Rotherham 021F,E01007734,1229,757,472,162,58,252
2011,Rotherham 022A,E01007684,1238,919,319,168,47,104
2011,Rotherham 022B,E01007687,1022,685,337,211,30,96
2011,Rotherham 022C,E01007689,1107,858,249,151,39,59
2011,Rotherham 022D,E01007690,1209,775,434,311,58,65
2011,Rotherham 023A,E01007675,1294,821,473,176,74,223
2011,Rotherham 023B,E01007678,1197,717,480,298,58,124
2011,Rotherham 023C,E01007679,1292,814,478,179,91,208
2011,Rotherham 023D,E01007680,1284,765,519,144,112,263
2011,Rotherham 023E,E01007712,1409,964,445,258,69,118
2011,Rotherham 023F,E01007713,1161,753,408,282,52,74
2011,Rotherham 024A,E01007811,972,668,304,185,40,79
2011,Rotherham 024B,E01007812,913,560,353,169,44,140
2011,Rotherham 024C,E01007813,985,708,277,166,37,74
2011,Rotherham 024D,E01007814,829,548,281,196,32,53
2011,Rotherham 025A,E01007676,1215,794,421,214,45,162
2011,Rotherham 025B,E01007702,1166,871,295,118,40,137
2011,Rotherham 025C,E01007703,893,586,307,195,36,76
2011,Rotherham 025D,E01007704,1028,725,303,169,30,104
2011,Rotherham 025E,E01007705,1127,778,349,226,38,85
2011,Rotherham 025F,E01007707,1180,771,409,278,36,95
2011,Rotherham 026A,E01007666,1102,782,320,199,42,79
2011,Rotherham 026B,E01007809,1086,667,419,187,38,194
2011,Rotherham 026C,E01007810,1382,884,498,260,73,165
2011,Rotherham 026D,E01007815,1254,852,402,175,50,177
2011,Rotherham 027A,E01007665,1351,981,370,217,40,113
2011,Rotherham 027B,E01007699,1363,995,368,172,39,157
2011,Rotherham 027C,E01007700,1324,1023,301,150,40,111
2011,Rotherham 027D,E01007701,1189,773,416,163,41,212
2011,Rotherham 027E,E01007706,1148,869,279,155,29,95
2011,Rotherham 028A,E01007787,2121,1571,550,309,67,174
2011,Rotherham 028B,E01007788,1125,784,341,221,31,89
2011,Rotherham 028C,E01007789,1147,729,418,195,37,186
2011,Rotherham 028D,E01007792,1037,799,238,122,67,49
2011,Rotherham 029A,E01007657,1090,758,332,216,38,78
2011,Rotherham 029B,E01007659,857,603,254,177,24,53
2011,Rotherham 029C,E01007785,1002,710,292,144,32,116
2011,Rotherham 029D,E01007786,835,551,284,185,24,75
2011,Rotherham 029E,E01007790,1054,652,402,163,43,196
2011,Rotherham 029F,E01007791,1002,605,397,158,46,193
2011,Rotherham 030A,E01007667,1010,661,349,154,56,139
2011,Rotherham 030B,E01007668,1093,630,463,178,48,237
2011,Rotherham 030C,E01007669,1133,720,413,284,29,100
2011,Rotherham 030D,E01007670,1138,848,290,215,35,40
2011,Rotherham 030E,E01007672,1101,815,286,198,33,55
2011,Rotherham 030F,E01007673,1031,675,356,163,29,164
2011,Rotherham 031A,E01007671,1580,1211,369,198,63,108
2011,Rotherham 031B,E01007674,1463,1118,345,245,34,66
2011,Rotherham 031C,E01007747,942,618,324,155,36,133
2011,Rotherham 031D,E01007750,1123,753,370,251,37,82
2011,Rotherham 032A,E01007658,1069,764,305,186,41,78
2011,Rotherham 032B,E01007660,948,653,295,190,31,74
2011,Rotherham 032C,E01007661,1064,704,360,246,42,72
2011,Rotherham 032D,E01007662,703,413,290,149,33,108
2011,Rotherham 032E,E01007663,1112,726,386,303,27,56
2011,Rotherham 032F,E01007664,1394,854,540,398,58,84
2011,Rotherham 033A,E01007748,1095,682,413,299,43,71
2011,Rotherham 033B,E01007749,1309,944,365,226,47,92
2011,Rotherham 033C,E01007751,1421,1054,367,193,51,123
2011,Rotherham 033D,E01007752,1124,829,295,200,30,65
2011,Rotherham 033E,E01007753,1103,729,374,229,42,103
2011,Sheffield 001A,E01008144,1196,844,352,209,36,107
2011,Sheffield 001B,E01008145,1069,665,404,235,32,137
2011,Sheffield 001C,E01008148,1079,673,406,233,43,130
2011,Sheffield 001D,E01008149,1147,828,319,231,35,53
2011,Sheffield 001E,E01008150,998,679,319,187,33,99
2011,Sheffield 002A,E01008142,1044,734,310,136,48,126
2011,Sheffield 002B,E01008143,1225,880,345,216,30,99
2011,Sheffield 002C,E01008146,1002,709,293,228,31,34
2011,Sheffield 002D,E01008147,1089,723,366,273,30,63
2011,Sheffield 003A,E01007888,1110,847,263,160,29,74
2011,Sheffield 003B,E01007892,1041,617,424,164,56,204
2011,Sheffield 003C,E01007893,1152,830,322,230,32,60
2011,Sheffield 003D,E01007898,1140,926,214,118,36,60
2011,Sheffield 003E,E01007899,1113,741,372,283,28,61
2011,Sheffield 003F,E01007900,1242,869,373,204,44,125
2011,Sheffield 003G,E01007901,1007,656,351,175,34,142
2011,Sheffield 004A,E01007887,1017,757,260,158,27,75
2011,Sheffield 004B,E01007889,1926,1561,365,196,68,101
2011,Sheffield 004C,E01007890,1084,798,286,224,16,46
2011,Sheffield 004D,E01007891,1162,774,388,287,42,59
2011,Sheffield 004E,E01007894,1075,829,246,153,34,59
2011,Sheffield 004F,E01007895,1045,696,349,187,40,122
2011,Sheffield 004G,E01007896,1001,738,263,203,17,43
2011,Sheffield 005A,E01007897,1077,673,404,306,38,60
2011,Sheffield 005B,E01008134,967,659,308,196,36,76
2011,Sheffield 005C,E01008135,1336,1044,292,177,47,68
2011,Sheffield 005D,E01008137,1083,688,395,295,39,61
2011,Sheffield 005E,E01008141,1168,854,314,242,23,49
2011,Sheffield 006A,E01008053,924,569,355,172,34,149
2011,Sheffield 006B,E01008056,1068,738,330,139,41,150
2011,Sheffield 006C,E01008058,1104,747,357,197,41,119
2011,Sheffield 006D,E01008138,891,540,351,207,25,119
2011,Sheffield 006E,E01008139,1173,814,359,243,23,93
2011,Sheffield 007A,E01007856,925,622,303,108,59,136
2011,Sheffield 007B,E01008054,914,580,334,89,50,195
2011,Sheffield 007C,E01008055,1027,654,373,97,59,217
2011,Sheffield 007D,E01008057,999,681,318,114,34,170
2011,Sheffield 008A,E01008126,1152,766,386,291,41,54
2011,Sheffield 008C,E01008128,1306,993,313,207,35,71
2011,Sheffield 008D,E01008136,991,671,320,187,31,102
2011,Sheffield 008E,E01008140,1316,966,350,220,41,89
2011,Sheffield 008F,E01033275,1194,966,228,88,54,86
2011,Sheffield 008G,E01033280,1221,896,325,155,55,115
2011,Sheffield 009A,E01008085,980,630,350,155,47,148
2011,Sheffield 009B,E01008086,949,617,332,133,35,164
2011,Sheffield 009C,E01008116,939,594,345,134,39,172
2011,Sheffield 009D,E01008117,884,529,355,168,37,150
2011,Sheffield 009E,E01008118,993,647,346,164,36,146
2011,Sheffield 009F,E01008119,840,545,295,92,41,162
2011,Sheffield 009G,E01008125,1041,682,359,174,30,155
2011,Sheffield 010A,E01007849,1471,964,507,158,100,249
2011,Sheffield 010B,E01007857,1070,660,410,155,40,215
2011,Sheffield 010C,E01008059,1035,653,382,136,36,210
2011,Sheffield 010D,E01008060,952,643,309,111,41,157
2011,Sheffield 011A,E01008061,1060,669,391,127,61,203
2011,Sheffield 011B,E01008063,1136,752,384,202,46,136
2011,Sheffield 011E,E01033277,1606,993,613,183,84,346
2011,Sheffield 012A,E01008087,1177,887,290,193,33,64
2011,Sheffield 012B,E01008088,1100,793,307,199,39,69
2011,Sheffield 012C,E01008090,1161,732,429,142,57,230
2011,Sheffield 012D,E01008092,1021,626,395,161,41,193
2011,Sheffield 012E,E01008122,908,542,366,112,38,216
2011,Sheffield 012F,E01008124,1029,669,360,84,47,229
2011,Sheffield 013A,E01007848,1180,712,468,153,74,241
2011,Sheffield 013B,E01007851,1005,638,367,88,76,203
2011,Sheffield 013C,E01007947,1099,530,569,197,62,310
2011,Sheffield 013D,E01007948,1091,616,475,114,106,255
2011,Sheffield 013E,E01008062,1064,578,486,122,85,279
2011,Sheffield 014A,E01007847,972,618,354,176,31,147
2011,Sheffield 014B,E01007850,1211,823,388,224,51,113
2011,Sheffield 014C,E01007852,1175,880,295,163,46,86
2011,Sheffield 014D,E01007853,1185,868,317,185,47,85
2011,Sheffield 014E,E01007854,1156,751,405,79,68,258
2011,Sheffield 014F,E01007855,1471,1058,413,105,68,240
2011,Sheffield 015A,E01007941,1101,637,464,196,55,213
2011,Sheffield 015B,E01007945,1254,777,477,150,70,257
2011,Sheffield 015C,E01007946,1071,688,383,110,34,239
2011,Sheffield 015D,E01007950,1009,636,373,141,45,187
2011,Sheffield 015E,E01008123,891,569,322,103,39,180
2011,Sheffield 016A,E01007987,1118,871,247,127,57,63
2011,Sheffield 016B,E01007988,1102,826,276,170,45,61
2011,Sheffield 016C,E01007989,1110,894,216,125,31,60
2011,Sheffield 016D,E01007991,1065,695,370,207,62,101
2011,Sheffield 017A,E01007995,1186,950,236,92,53,91
2011,Sheffield 017B,E01008089,1135,802,333,124,68,141
2011,Sheffield 017C,E01008091,1190,990,200,93,44,63
2011,Sheffield 017D,E01008093,1157,883,274,141,39,94
2011,Sheffield 018A,E01007903,1114,647,467,170,92,205
2011,Sheffield 018B,E01007904,1117,557,560,180,77,303
2011,Sheffield 018C,E01007913,946,515,431,85,82,264
2011,Sheffield 018D,E01007914,978,562,416,63,101,252
2011,Sheffield 019A,E01007870,1350,806,544,153,125,266
2011,Sheffield 019B,E01007871,1284,790,494,195,78,221
2011,Sheffield 019C,E01007943,1156,707,449,160,47,242
2011,Sheffield 019D,E01008094,790,481,309,128,23,158
2011,Sheffield 020A,E01007869,1131,684,447,70,114,263
2011,Sheffield 020B,E01007872,1177,734,443,140,91,212
2011,Sheffield 020C,E01007873,1191,675,516,102,120,294
2011,Sheffield 020D,E01007942,1232,690,542,91,124,327
2011,Sheffield 020E,E01007949,1029,639,390,81,73,236
2011,Sheffield 021A,E01007990,1072,728,344,210,33,101
2011,Sheffield 021B,E01007992,1218,934,284,148,46,90
2011,Sheffield 021C,E01007993,1181,809,372,172,57,143
2011,Sheffield 021D,E01007994,1109,882,227,126,38,63
2011,Sheffield 021E,E01007996,1105,837,268,162,34,72
2011,Sheffield 022A,E01007874,1170,637,533,109,128,296
2011,Sheffield 022B,E01007875,1162,622,540,62,194,284
2011,Sheffield 022D,E01007877,861,489,372,72,84,216
2011,Sheffield 022E,E01007940,1084,554,530,97,131,302
2011,Sheffield 022F,E01007944,1260,761,499,48,114,337
2011,Sheffield 022G,E01033269,1220,631,589,69,157,363
2011,Sheffield 022H,E01033270,1236,886,350,26,184,140
2011,Sheffield 023A,E01008129,1029,783,246,172,41,33
2011,Sheffield 023B,E01008130,1119,749,370,262,44,64
2011,Sheffield 023C,E01008131,1159,846,313,195,42,76
2011,Sheffield 023D,E01008132,1049,812,237,164,35,38
2011,Sheffield 023E,E01008133,1050,676,374,296,31,47
2011,Sheffield 024A,E01008151,1314,964,350,85,185,80
2011,Sheffield 024B,E01008153,1338,1057,281,124,86,71
2011,Sheffield 024C,E01008154,1288,951,337,174,62,101
2011,Sheffield 024D,E01008155,1278,910,368,113,145,110
2011,Sheffield 024E,E01008156,1172,870,302,197,49,56
2011,Sheffield 024F,E01008160,1068,795,273,168,40,65
2011,Sheffield 025A,E01007997,1049,696,353,238,35,80
2011,Sheffield 025B,E01007998,1121,699,422,243,34,145
2011,Sheffield 025C,E01008152,1001,742,259,153,32,74
2011,Sheffield 025D,E01008158,1129,730,399,230,44,125
2011,Sheffield 026A,E01008065,1390,647,743,171,209,363
2011,Sheffield 026B,E01008068,2407,839,1568,82,1233,253
2011,Sheffield 026C,E01008072,1120,660,460,138,134,188
2011,Sheffield 026D,E01008157,1167,686,481,221,70,190
2011,Sheffield 026E,E01008161,1332,1021,311,156,63,92
2011,Sheffield 027A,E01007883,848,407,441,82,105,254
2011,Sheffield 027B,E01007902,1198,637,561,216,61,284
2011,Sheffield 027C,E01007905,1147,665,482,47,132,303
2011,Sheffield 027D,E01007906,1313,735,578,124,132,322
2011,Sheffield 028A,E01008064,1492,862,630,63,521,46
2011,Sheffield 028B,E01008066,1488,642,846,39,769,38
2011,Sheffield 028C,E01008069,1469,762,707,60,606,41
2011,Sheffield 028D,E01008074,1268,817,451,77,327,47
2011,Sheffield 029A,E01007951,1149,839,310,137,123,50
2011,Sheffield 029B,E01007960,1278,880,398,138,216,44
2011,Sheffield 029C,E01007962,1202,684,518,103,351,64
2011,Sheffield 029D,E01008159,1223,924,299,149,92,58
2011,Sheffield 030A,E01007866,1514,777,737,63,625,49
2011,Sheffield 030B,E01007867,1881,854,1027,46,922,59
2011,Sheffield 030C,E01007868,869,580,289,91,156,42
2011,Sheffield 030D,E01008067,1577,652,925,26,846,53
2011,Sheffield 030E,E01008073,1469,827,642,91,424,127
2011,Sheffield 032A,E01007907,1166,775,391,139,84,168
2011,Sheffield 032B,E01007908,1154,884,270,138,40,92
2011,Sheffield 032C,E01007909,1499,1178,321,158,48,115
2011,Sheffield 032D,E01007911,1042,742,300,216,27,57
2011,Sheffield 032E,E01008014,1057,645,412,178,49,185
2011,Sheffield 032F,E01008016,1056,703,353,153,57,143
2011,Sheffield 033A,E01007952,1107,800,307,207,58,42
2011,Sheffield 033B,E01007953,1079,660,419,298,44,77
2011,Sheffield 033C,E01007954,1172,846,326,198,65,63
2011,Sheffield 033D,E01007961,1066,819,247,153,52,42
2011,Sheffield 036A,E01007859,1499,680,819,75,721,23
2011,Sheffield 036B,E01007860,1296,744,552,60,434,58
2011,Sheffield 036C,E01007863,1579,966,613,88,472,53
2011,Sheffield 036D,E01007864,1823,939,884,37,827,20
2011,Sheffield 036E,E01008104,1275,694,581,82,417,82
2011,Sheffield 037A,E01007910,1146,789,357,190,46,121
2011,Sheffield 037B,E01007912,1115,794,321,202,36,83
2011,Sheffield 037C,E01007971,963,657,306,153,38,115
2011,Sheffield 037D,E01007973,1070,755,315,214,31,70
2011,Sheffield 038A,E01007858,1051,825,226,98,56,72
2011,Sheffield 038B,E01007861,1096,789,307,183,60,64
2011,Sheffield 038C,E01007862,3905,1281,2624,113,2452,59
2011,Sheffield 038D,E01007865,1220,915,305,173,71,61
2011,Sheffield 039A,E01008011,1091,618,473,110,58,305
2011,Sheffield 039B,E01008012,1537,1018,519,127,88,304
2011,Sheffield 039C,E01008013,837,532,305,89,35,181
2011,Sheffield 039D,E01008015,1157,722,435,162,49,224
2011,Sheffield 039E,E01008017,1145,649,496,191,66,239
2011,Sheffield 039F,E01008018,907,555,352,124,40,188
2011,Sheffield 040A,E01008105,3030,1543,1487,62,1300,125
2011,Sheffield 040C,E01008107,1191,752,439,83,181,175
2011,Sheffield 040D,E01008111,1482,910,572,76,411,85
2011,Sheffield 040E,E01033271,1059,600,459,51,169,239
2011,Sheffield 040F,E01033272,980,729,251,48,98,105
2011,Sheffield 041A,E01007955,961,647,314,209,51,54
2011,Sheffield 041B,E01007956,1477,1049,428,268,70,90
2011,Sheffield 041C,E01007957,1123,822,301,208,46,47
2011,Sheffield 041D,E01007958,1000,669,331,221,40,70
2011,Sheffield 041E,E01007959,1024,725,299,202,44,53
2011,Sheffield 042A,E01008108,1659,1129,530,45,339,146
2011,Sheffield 042B,E01008109,1641,988,653,134,365,154
2011,Sheffield 042D,E01008112,1288,823,465,69,166,230
2011,Sheffield 042E,E01008113,1317,929,388,89,132,167
2011,Sheffield 042F,E01033273,2232,1109,1123,28,978,117
2011,Sheffield 042G,E01033274,2353,1237,1116,5,1079,32
2011,Sheffield 043A,E01008095,1289,832,457,103,186,168
2011,Sheffield 043B,E01008096,1578,973,605,169,154,282
2011,Sheffield 043C,E01008097,1146,689,457,166,56,235
2011,Sheffield 043D,E01008101,1341,889,452,206,40,206
2011,Sheffield 044A,E01007965,1217,790,427,242,40,145
2011,Sheffield 044B,E01007969,1151,797,354,204,33,117
2011,Sheffield 044C,E01007972,1103,765,338,243,33,62
2011,Sheffield 044D,E01007974,1101,847,254,118,51,85
2011,Sheffield 045A,E01007963,1094,769,325,182,29,114
2011,Sheffield 045B,E01007967,1155,790,365,174,35,156
2011,Sheffield 045C,E01007999,1092,824,268,172,29,67
2011,Sheffield 045D,E01008008,1157,728,429,203,46,180
2011,Sheffield 045E,E01008009,1011,623,388,89,47,252
2011,Sheffield 046A,E01008043,1249,913,336,186,65,85
2011,Sheffield 046B,E01008044,1053,719,334,171,78,85
2011,Sheffield 046C,E01008047,1369,1004,365,52,281,32
2011,Sheffield 046D,E01008048,1326,939,387,79,256,52
2011,Sheffield 046E,E01008050,1238,1004,234,46,143,45
2011,Sheffield 047A,E01007931,1119,796,323,223,47,53
2011,Sheffield 047B,E01007934,1031,782,249,138,43,68
2011,Sheffield 047C,E01007935,1130,891,239,72,128,39
2011,Sheffield 047D,E01007936,1240,1040,200,76,74,50
2011,Sheffield 047E,E01007937,1004,755,249,137,62,50
2011,Sheffield 047F,E01007938,1057,759,298,206,37,55
2011,Sheffield 048A,E01008098,1091,674,417,124,77,216
2011,Sheffield 048B,E01008100,890,575,315,95,50,170
2011,Sheffield 048C,E01008102,778,476,302,111,52,139
2011,Sheffield 048D,E01008103,988,604,384,114,51,219
2011,Sheffield 049A,E01007964,1133,826,307,163,28,116
2011,Sheffield 049B,E01007966,1207,876,331,147,55,129
2011,Sheffield 049C,E01007968,984,647,337,155,51,131
2011,Sheffield 049D,E01007970,1141,632,509,222,29,258
2011,Sheffield 050A,E01008042,1200,850,350,118,67,165
2011,Sheffield 050B,E01008045,1035,729,306,118,65,123
2011,Sheffield 050C,E01008046,1250,983,267,74,62,131
2011,Sheffield 050D,E01008049,1177,851,326,163,93,70
2011,Sheffield 050E,E01008051,1346,990,356,97,85,174
2011,Sheffield 050F,E01008052,1472,1179,293,122,66,105
2011,Sheffield 051A,E01007975,1218,796,422,189,48,185
2011,Sheffield 051B,E01007976,1108,750,358,169,42,147
2011,Sheffield 051C,E01007977,1091,662,429,154,60,215
2011,Sheffield 051D,E01007979,1103,612,491,101,148,242
2011,Sheffield 051E,E01008099,1232,968,264,99,72,93
2011,Sheffield 052A,E01008000,1112,787,325,209,30,86
2011,Sheffield 052B,E01008001,1062,746,316,177,34,105
2011,Sheffield 052C,E01008004,1124,737,387,218,42,127
2011,Sheffield 052D,E01008005,1135,785,350,212,38,100
2011,Sheffield 052E,E01008010,1012,702,310,135,41,134
2011,Sheffield 053A,E01007978,1323,1068,255,73,72,110
2011,Sheffield 053B,E01007980,1192,987,205,68,51,86
2011,Sheffield 053C,E01007981,1098,853,245,86,57,102
2011,Sheffield 053D,E01007983,1152,960,192,62,48,82
2011,Sheffield 053E,E01007985,1118,858,260,146,40,74
2011,Sheffield 054A,E01007982,1318,915,403,155,79,169
2011,Sheffield 054B,E01008002,1174,817,357,235,35,87
2011,Sheffield 054C,E01008003,1079,769,310,196,41,73
2011,Sheffield 054D,E01008006,1001,707,294,215,27,52
2011,Sheffield 055A,E01007927,1130,755,375,268,53,54
2011,Sheffield 055B,E01007928,1244,862,382,255,70,57
2011,Sheffield 055C,E01007929,1181,875,306,193,49,64
2011,Sheffield 055D,E01007930,1003,716,287,172,58,57
2011,Sheffield 055E,E01007932,991,706,285,187,61,37
2011,Sheffield 055F,E01007939,1055,780,275,185,50,40
2011,Sheffield 056A,E01008028,1167,842,325,164,42,119
2011,Sheffield 056B,E01008029,1053,724,329,153,43,133
2011,Sheffield 056C,E01008032,1017,704,313,168,28,117
2011,Sheffield 056D,E01008034,1298,941,357,154,84,119
2011,Sheffield 059A,E01007828,1208,880,328,138,59,131
2011,Sheffield 059B,E01007829,1216,980,236,142,33,61
2011,Sheffield 059C,E01007831,1139,899,240,133,47,60
2011,Sheffield 059D,E01007832,1152,909,243,145,40,58
2011,Sheffield 059E,E01007986,1088,883,205,107,33,65
2011,Sheffield 060A,E01008007,1148,678,470,201,52,217
2011,Sheffield 060B,E01008075,992,632,360,91,84,185
2011,Sheffield 060C,E01008076,919,610,309,119,33,157
2011,Sheffield 060D,E01008077,1060,705,355,162,38,155
2011,Sheffield 061A,E01008031,1074,761,313,158,40,115
2011,Sheffield 061B,E01008033,1046,725,321,195,31,95
2011,Sheffield 061C,E01008038,1153,747,406,322,30,54
2011,Sheffield 061D,E01008040,1303,996,307,158,44,105
2011,Sheffield 062A,E01007835,995,691,304,194,39,71
2011,Sheffield 062B,E01007836,1124,759,365,233,36,96
2011,Sheffield 062C,E01007843,1092,743,349,190,34,125
2011,Sheffield 062D,E01007846,1083,779,304,189,44,71
2011,Sheffield 063A,E01008030,1017,787,230,135,28,67
2011,Sheffield 063B,E01008035,927,707,220,146,43,31
2011,Sheffield 063C,E01008036,1129,915,214,109,48,57
2011,Sheffield 063D,E01008041,1144,959,185,83,41,61
2011,Sheffield 064A,E01007827,1173,873,300,218,25,57
2011,Sheffield 064B,E01007830,1067,738,329,209,43,77
2011,Sheffield 064C,E01007833,1159,760,399,294,39,66
2011,Sheffield 064D,E01007984,1062,791,271,184,39,48
2011,Sheffield 064E,E01008078,1000,668,332,214,41,77
2011,Sheffield 064F,E01008079,883,633,250,155,39,56
2011,Sheffield 065A,E01008019,1397,1029,368,206,41,121
2011,Sheffield 065B,E01008020,1121,838,283,169,26,88
2011,Sheffield 065C,E01008022,1131,737,394,149,41,204
2011,Sheffield 065D,E01008027,1085,737,348,189,32,127
2011,Sheffield 065E,E01008037,1029,611,418,271,27,120
2011,Sheffield 065F,E01008039,1020,715,305,213,32,60
2011,Sheffield 066A,E01007824,991,738,253,173,36,44
2011,Sheffield 066B,E01007825,1024,692,332,241,32,59
2011,Sheffield 066C,E01007826,1082,818,264,173,48,43
2011,Sheffield 066D,E01007834,1133,808,325,209,29,87
2011,Sheffield 068A,E01007920,1139,725,414,271,63,80
2011,Sheffield 068B,E01007921,1070,688,382,253,46,83
2011,Sheffield 068C,E01007923,1257,906,351,234,53,64
2011,Sheffield 068D,E01007925,1120,786,334,209,42,83
2011,Sheffield 068E,E01007926,1187,827,360,250,47,63
2011,Sheffield 068F,E01007933,1180,829,351,200,76,75
2011,Sheffield 069A,E01007823,1191,786,405,252,44,109
2011,Sheffield 069B,E01007916,1023,634,389,129,42,218
2011,Sheffield 069C,E01007919,1097,722,375,112,59,204
2011,Sheffield 069D,E01008080,1079,750,329,189,49,91
2011,Sheffield 070A,E01008081,1133,742,391,181,51,159
2011,Sheffield 070B,E01008082,1023,636,387,181,19,187
2011,Sheffield 070C,E01008083,1027,658,369,134,42,193
2011,Sheffield 070D,E01008084,1159,710,449,145,52,252
2011,Sheffield 071A,E01007915,962,695,267,208,22,37
2011,Sheffield 071B,E01007917,996,638,358,252,34,72
2011,Sheffield 071C,E01007918,1149,788,361,228,44,89
2011,Sheffield 071D,E01007922,1063,767,296,204,43,49
2011,Sheffield 071E,E01007924,1106,781,325,185,35,105
2011,Sheffield 072A,E01008021,1133,869,264,163,51,50
2011,Sheffield 072B,E01008023,1620,1362,258,151,37,70
2011,Sheffield 072C,E01008024,1298,977,321,182,30,109
2011,Sheffield 072D,E01008025,1474,1115,359,223,39,97
2011,Sheffield 072E,E01032585,1093,728,365,289,15,61
2011,Sheffield 073A,E01033261,1712,630,1082,13,1035,34
2011,Sheffield 073B,E01033262,1709,778,931,7,890,34
2011,Sheffield 073C,E01033263,1174,717,457,14,352,91
2011,Sheffield 073D,E01033264,1448,896,552,3,518,31
2011,Sheffield 073E,E01033276,2881,775,2106,0,2080,26
2011,Sheffield 074A,E01008114,2214,892,1322,47,991,284
2011,Sheffield 074B,E01008115,1623,714,909,39,767,103
2011,Sheffield 074C,E01033265,1279,680,599,18,511,70
2011,Sheffield 074D,E01033266,1529,617,912,12,846,54
2011,Sheffield 074E,E01033267,1362,561,801,9,748,44
2011,Sheffield 075A,E01007878,1307,877,430,137,73,220
2011,Sheffield 075B,E01007879,1246,791,455,116,219,120
2011,Sheffield 075C,E01007881,1183,784,399,149,75,175
2011,Sheffield 075D,E01007882,1316,897,419,130,189,100
2011,Sheffield 075E,E01007885,1171,715,456,113,78,265
2011,Sheffield 075F,E01007886,1096,678,418,127,52,239
2011,Sheffield 075G,E01033268,1837,1061,776,154,401,221
2011,Sheffield 076A,E01007838,1130,862,268,160,29,79
2011,Sheffield 076B,E01007839,1216,982,234,134,38,62
2011,Sheffield 076C,E01007841,1194,913,281,169,42,70
2011,Sheffield 076D,E01007842,1132,784,348,186,52,110
2011,Sheffield 076E,E01033278,1691,1099,592,296,48,248
2011,Sheffield 076F,E01033279,1660,1111,549,240,59,250
2011,Bradford 001A,E01010646,911,652,259,189,19,51
2011,Bradford 001B,E01010647,778,522,256,190,22,44
2011,Bradford 001C,E01010648,939,640,299,239,26,34
2011,Bradford 001D,E01010692,1297,882,415,269,52,94
2011,Bradford 002A,E01010691,1024,663,361,256,49,56
2011,Bradford 002B,E01010693,1010,652,358,248,39,71
2011,Bradford 002C,E01010694,1065,666,399,272,42,85
2011,Bradford 002D,E01010695,1052,788,264,142,37,85
2011,Bradford 002E,E01010696,1046,750,296,200,41,55
2011,Bradford 002F,E01010697,963,657,306,216,32,58
2011,Bradford 002G,E01010698,1314,1037,277,162,48,67
2011,Bradford 002H,E01010699,1180,877,303,165,47,91
2011,Bradford 003A,E01010767,950,679,271,174,34,63
2011,Bradford 003B,E01010768,1162,886,276,182,40,54
2011,Bradford 003C,E01010769,1131,873,258,158,23,77
2011,Bradford 003D,E01010771,894,636,258,192,26,40
2011,Bradford 004A,E01010638,1144,807,337,241,26,70
2011,Bradford 004B,E01010639,1278,928,350,233,34,83
2011,Bradford 004C,E01010640,1292,1021,271,155,38,78
2011,Bradford 004D,E01010641,1101,766,335,220,33,82
2011,Bradford 004E,E01010642,1315,920,395,285,40,70
2011,Bradford 004F,E01010643,1078,834,244,138,40,66
2011,Bradford 004G,E01010644,1151,856,295,173,38,84
2011,Bradford 004H,E01010645,990,679,311,190,29,92
2011,Bradford 005A,E01010770,1182,856,326,196,55,75
2011,Bradford 005B,E01010772,865,581,284,211,38,35
2011,Bradford 005C,E01010773,981,740,241,156,39,46
2011,Bradford 005D,E01010774,1128,846,282,197,30,55
2011,Bradford 006A,E01010706,1206,894,312,214,34,64
2011,Bradford 006B,E01010707,1282,917,365,247,30,88
2011,Bradford 006C,E01010708,1169,820,349,176,36,137
2011,Bradford 006D,E01010709,1886,1414,472,288,55,129
2011,Bradford 007A,E01010719,1080,632,448,89,79,280
2011,Bradford 007B,E01010727,1311,920,391,233,57,101
2011,Bradford 007C,E01010728,1194,745,449,93,88,268
2011,Bradford 007D,E01010729,999,644,355,151,55,149
2011,Bradford 008A,E01010700,997,592,405,64,75,266
2011,Bradford 008B,E01010701,908,495,413,67,61,285
2011,Bradford 008C,E01010702,1330,699,631,93,115,423
2011,Bradford 008D,E01010703,1162,818,344,153,42,149
2011,Bradford 008E,E01010704,1071,776,295,128,47,120
2011,Bradford 008F,E01010705,1238,846,392,246,49,97
2011,Bradford 008G,E01010710,1510,881,629,106,103,420
2011,Bradford 009A,E01010712,1069,682,387,43,54,290
2011,Bradford 009B,E01010720,1027,669,358,115,48,195
2011,Bradford 009C,E01010721,1028,618,410,179,47,184
2011,Bradford 009D,E01010723,1004,592,412,52,65,295
2011,Bradford 009E,E01010724,1004,662,342,134,55,153
2011,Bradford 009F,E01010725,1071,766,305,152,31,122
2011,Bradford 010A,E01010579,1113,759,354,255,49,50
2011,Bradford 010B,E01010580,1784,1384,400,276,56,68
2011,Bradford 010C,E01010764,1215,855,360,257,43,60
2011,Bradford 010D,E01010765,1661,1200,461,288,52,121
2011,Bradford 010E,E01010766,952,715,237,170,26,41
2011,Bradford 011A,E01010711,1003,513,490,173,58,259
2011,Bradford 011B,E01010713,973,629,344,160,47,137
2011,Bradford 011C,E01010714,992,712,280,128,39,113
2011,Bradford 011D,E01010716,1366,1004,362,162,53,147
2011,Bradford 012A,E01010715,802,531,271,137,34,100
2011,Bradford 012B,E01010717,1107,822,285,131,41,113
2011,Bradford 012C,E01010718,1136,796,340,124,46,170
2011,Bradford 012D,E01010726,1138,815,323,226,40,57
2011,Bradford 012E,E01010859,1265,931,334,237,39,58
2011,Bradford 013A,E01010573,1344,987,357,238,42,77
2011,Bradford 013B,E01010574,1034,699,335,250,31,54
2011,Bradford 013C,E01010575,1166,861,305,203,36,66
2011,Bradford 013D,E01010577,1154,867,287,191,43,53
2011,Bradford 014A,E01010722,1112,760,352,136,52,164
2011,Bradford 014B,E01010860,1196,925,271,176,44,51
2011,Bradford 014C,E01010862,1279,1025,254,151,36,67
2011,Bradford 014D,E01010863,1138,845,293,182,43,68
2011,Bradford 015A,E01010578,1209,907,302,147,47,108
2011,Bradford 015B,E01010581,1203,908,295,178,33,84
2011,Bradford 015C,E01010582,1250,1009,241,118,48,75
2011,Bradford 015D,E01010584,1322,1011,311,141,51,119
2011,Bradford 015E,E01010585,1327,939,388,210,102,76
2011,Bradford 016A,E01010568,1324,948,376,275,38,63
2011,Bradford 016B,E01010569,1240,831,409,217,48,144
2011,Bradford 016C,E01010571,1258,989,269,135,26,108
2011,Bradford 016D,E01010572,1055,772,283,194,26,63
2011,Bradford 016E,E01010576,1134,813,321,212,41,68
2011,Bradford 017A,E01010683,1290,1033,257,148,41,68
2011,Bradford 017B,E01010684,1156,876,280,184,36,60
2011,Bradford 017C,E01010685,1279,975,304,192,37,75
2011,Bradford 017D,E01010686,1187,844,343,247,37,59
2011,Bradford 018A,E01010570,1046,711,335,226,48,61
2011,Bradford 018B,E01010583,1195,793,402,172,62,168
2011,Bradford 018C,E01010784,1250,929,321,139,60,122
2011,Bradford 018D,E01010785,1128,908,220,111,40,69
2011,Bradford 018E,E01010786,1074,674,400,198,64,138
2011,Bradford 018F,E01010790,1037,707,330,229,45,56
2011,Bradford 019A,E01010680,1313,902,411,156,38,217
2011,Bradford 019B,E01010681,1032,779,253,145,35,73
2011,Bradford 019C,E01010682,1037,720,317,142,45,130
2011,Bradford 019D,E01010687,1394,1155,239,143,30,66
2011,Bradford 019E,E01010688,1418,1134,284,147,41,96
2011,Bradford 019F,E01010689,1293,1042,251,137,45,69
2011,Bradford 019G,E01010690,1398,1055,343,198,43,102
2011,Bradford 020B,E01010782,1333,956,377,140,47,190
2011,Bradford 020C,E01010787,1122,801,321,182,60,79
2011,Bradford 020D,E01010788,1047,809,238,108,49,81
2011,Bradford 020E,E01033689,1005,807,198,62,35,101
2011,Bradford 020F,E01033694,832,695,137,55,26,56
2011,Bradford 021A,E01010776,1197,882,315,113,51,151
2011,Bradford 021B,E01010777,1079,714,365,105,45,215
2011,Bradford 021C,E01010779,1029,720,309,131,37,141
2011,Bradford 021D,E01010781,1074,790,284,109,58,117
2011,Bradford 021E,E01010783,1118,792,326,191,34,101
2011,Bradford 022A,E01010586,1186,858,328,238,38,52
2011,Bradford 022B,E01010587,1414,1095,319,196,55,68
2011,Bradford 022C,E01010588,1224,867,357,215,47,95
2011,Bradford 022D,E01010589,1151,831,320,232,38,50
2011,Bradford 022E,E01010591,1102,774,328,180,40,108
2011,Bradford 022F,E01010593,1232,872,360,233,46,81
2011,Bradford 022G,E01010596,1072,757,315,203,45,67
2011,Bradford 023A,E01010854,1328,1006,322,174,32,116
2011,Bradford 023B,E01010855,1288,912,376,242,35,99
2011,Bradford 023C,E01010856,1207,905,302,155,30,117
2011,Bradford 023D,E01010857,1255,896,359,252,32,75
2011,Bradford 023E,E01010858,1180,894,286,152,50,84
2011,Bradford 023F,E01010861,1383,1048,335,229,31,75
2011,Bradford 024A,E01010603,1186,877,309,163,43,103
2011,Bradford 024B,E01010604,1321,928,393,240,52,101
2011,Bradford 024C,E01010605,1092,758,334,144,56,134
2011,Bradford 024D,E01010775,1335,1021,314,172,55,87
2011,Bradford 024E,E01010778,1347,970,377,158,61,158
2011,Bradford 025A,E01010789,1248,856,392,118,81,193
2011,Bradford 025B,E01010791,1153,743,410,108,104,198
2011,Bradford 025C,E01010792,1276,782,494,89,130,275
2011,Bradford 025D,E01010793,1319,812,507,104,172,231
2011,Bradford 026A,E01010652,1142,836,306,191,35,80
2011,Bradford 026B,E01010653,1103,743,360,145,46,169
2011,Bradford 026C,E01010655,953,632,321,88,67,166
2011,Bradford 026D,E01010656,1078,781,297,172,47,78
2011,Bradford 026E,E01010657,1134,873,261,129,39,93
2011,Bradford 027A,E01010649,1012,742,270,129,30,111
2011,Bradford 027B,E01010650,1057,670,387,80,64,243
2011,Bradford 027C,E01010654,955,579,376,142,25,209
2011,Bradford 027D,E01010826,962,570,392,77,68,247
2011,Bradford 028A,E01010597,1052,738,314,114,64,136
2011,Bradford 028B,E01010598,1281,908,373,198,70,105
2011,Bradford 028C,E01010599,981,698,283,98,70,115
2011,Bradford 028D,E01010600,991,704,287,89,58,140
2011,Bradford 028E,E01010602,1076,768,308,149,51,108
2011,Bradford 029A,E01010670,1196,724,472,91,101,280
2011,Bradford 029B,E01010671,1105,656,449,101,108,240
2011,Bradford 029C,E01010673,1171,684,487,72,110,305
2011,Bradford 029D,E01010675,1350,805,545,175,121,249
2011,Bradford 030A,E01010669,1226,749,477,140,93,244
2011,Bradford 030B,E01010674,997,580,417,93,85,239
2011,Bradford 030C,E01010677,1243,744,499,81,88,330
2011,Bradford 030D,E01010805,1095,673,422,105,79,238
2011,Bradford 031A,E01010590,1356,1037,319,182,61,76
2011,Bradford 031B,E01010592,1099,704,395,267,41,87
2011,Bradford 031C,E01010594,1273,912,361,217,47,97
2011,Bradford 031D,E01010595,1311,981,330,155,49,126
2011,Bradford 032A,E01010601,1235,942,293,134,45,114
2011,Bradford 032B,E01010651,1118,824,294,174,38,82
2011,Bradford 032C,E01010825,972,738,234,105,36,93
2011,Bradford 032D,E01010827,904,641,263,108,48,107
2011,Bradford 033A,E01010804,1625,883,742,94,209,439
2011,Bradford 033B,E01010806,1049,578,471,100,100,271
2011,Bradford 033C,E01010807,1496,773,723,113,201,409
2011,Bradford 033D,E01010808,1408,730,678,67,139,472
2011,Bradford 033E,E01010809,1506,821,685,79,153,453
2011,Bradford 034A,E01010676,1551,794,757,96,159,502
2011,Bradford 034B,E01010679,1224,630,594,99,139,356
2011,Bradford 034C,E01010824,1277,742,535,79,112,344
2011,Bradford 034D,E01010840,1088,479,609,116,98,395
2011,Bradford 034E,E01010841,1233,613,620,90,98,432
2011,Bradford 035A,E01010828,1134,780,354,140,46,168
2011,Bradford 035B,E01010829,1107,700,407,78,65,264
2011,Bradford 035C,E01010830,1195,754,441,89,82,270
2011,Bradford 035D,E01010831,1268,732,536,73,124,339
2011,Bradford 035E,E01010832,1059,615,444,69,89,286
2011,Bradford 036A,E01010672,964,754,210,112,33,65
2011,Bradford 036B,E01010678,997,687,310,167,43,100
2011,Bradford 036C,E01010799,1087,743,344,160,44,140
2011,Bradford 036D,E01010800,1111,674,437,145,55,237
2011,Bradford 036E,E01010801,1218,831,387,112,87,188
2011,Bradford 036F,E01010802,1115,751,364,121,53,190
2011,Bradford 037A,E01010803,1199,695,504,76,102,326
2011,Bradford 037B,E01010810,1269,687,582,95,128,359
2011,Bradford 037C,E01010811,1354,794,560,59,126,375
2011,Bradford 037D,E01010813,1125,608,517,72,108,337
2011,Bradford 038A,E01010618,1098,567,531,80,126,325
2011,Bradford 038B,E01010619,1488,884,604,88,145,371
2011,Bradford 038C,E01010625,1095,549,546,111,111,324
2011,Bradford 038D,E01010626,1235,693,542,65,120,357
2011,Bradford 038E,E01010627,1107,717,390,70,86,234
2011,Bradford 039A,E01010606,1272,699,573,60,116,397
2011,Bradford 039B,E01010607,1315,705,610,64,165,381
2011,Bradford 039C,E01010617,940,484,456,99,60,297
2011,Bradford 039E,E01010842,1273,633,640,67,166,407
2011,Bradford 039G,E01033690,1036,693,343,4,250,89
2011,Bradford 039H,E01033691,1126,602,524,88,171,265
2011,Bradford 039I,E01033692,889,582,307,23,161,123
2011,Bradford 039J,E01033693,1590,806,784,64,203,517
2011,Bradford 040A,E01010628,1169,785,384,179,50,155
2011,Bradford 040B,E01010629,1251,805,446,122,107,217
2011,Bradford 040C,E01010630,1002,665,337,116,55,166
2011,Bradford 040D,E01010631,994,604,390,92,64,234
2011,Bradford 040E,E01010632,904,585,319,53,49,217
2011,Bradford 041A,E01010658,1326,812,514,108,105,301
2011,Bradford 041B,E01010812,1317,770,547,58,112,377
2011,Bradford 041C,E01010833,1144,573,571,76,163,332
2011,Bradford 041D,E01010843,1319,637,682,67,136,479
2011,Bradford 042A,E01010620,1157,627,530,75,118,337
2011,Bradford 042B,E01010621,1437,738,699,48,163,488
2011,Bradford 042C,E01010622,1526,790,736,74,148,514
2011,Bradford 042D,E01010623,1135,586,549,97,102,350
2011,Bradford 042E,E01010624,1435,738,697,74,135,488
2011,Bradford 043A,E01010794,1256,811,445,223,58,164
2011,Bradford 043B,E01010795,1367,1088,279,136,52,91
2011,Bradford 043C,E01010796,1184,798,386,188,50,148
2011,Bradford 043D,E01010797,1105,869,236,144,36,56
2011,Bradford 043E,E01010798,1166,834,332,151,47,134
2011,Bradford 044A,E01010834,3431,1301,2130,45,1890,195
2011,Bradford 044B,E01010835,2128,1143,985,125,306,554
2011,Bradford 044C,E01010836,1793,850,943,48,620,275
2011,Bradford 044D,E01010837,1455,786,669,79,192,398
2011,Bradford 044E,E01010838,1211,657,554,66,155,333
2011,Bradford 044F,E01010839,1109,598,511,73,162,276
2011,Bradford 045A,E01010608,1135,597,538,50,117,371
2011,Bradford 045B,E01010613,1043,658,385,157,45,183
2011,Bradford 045C,E01010730,1201,670,531,128,80,323
2011,Bradford 045D,E01010734,1028,694,334,47,72,215
2011,Bradford 046A,E01010609,1081,723,358,149,57,152
2011,Bradford 046B,E01010610,1064,624,440,105,61,274
2011,Bradford 046C,E01010611,1507,1005,502,131,83,288
2011,Bradford 046D,E01010614,1037,664,373,104,97,172
2011,Bradford 047A,E01010633,1165,849,316,152,49,115
2011,Bradford 047B,E01010634,1061,811,250,158,35,57
2011,Bradford 047C,E01010635,1003,617,386,132,54,200
2011,Bradford 047D,E01010636,1272,964,308,181,41,86
2011,Bradford 047E,E01010637,1177,771,406,94,204,108
2011,Bradford 048A,E01010731,1334,767,567,67,221,279
2011,Bradford 048B,E01010732,1415,842,573,72,126,375
2011,Bradford 048C,E01010733,1299,729,570,83,94,393
2011,Bradford 048D,E01010736,1360,858,502,60,102,340
2011,Bradford 048E,E01010737,1126,555,571,79,126,366
2011,Bradford 049A,E01010659,1197,668,529,109,83,337
2011,Bradford 049D,E01010662,1007,730,277,109,54,114
2011,Bradford 049E,E01010664,1063,707,356,120,84,152
2011,Bradford 049G,E01010761,1141,787,354,168,49,137
2011,Bradford 049H,E01033695,1379,1059,320,81,74,165
2011,Bradford 049I,E01033696,1121,864,257,109,49,99
2011,Bradford 049J,E01033697,1863,1090,773,114,165,494
2011,Bradford 050A,E01010663,1136,680,456,103,90,263
2011,Bradford 050B,E01010665,1157,752,405,143,75,187
2011,Bradford 050C,E01010666,1007,612,395,119,58,218
2011,Bradford 050D,E01010667,1069,686,383,94,70,219
2011,Bradford 051A,E01010735,1046,534,512,67,97,348
2011,Bradford 051B,E01010738,1257,727,530,62,113,355
2011,Bradford 051C,E01010739,1096,597,499,95,82,322
2011,Bradford 051D,E01010740,1197,665,532,110,111,311
2011,Bradford 051E,E01010744,1143,666,477,65,90,322
2011,Bradford 052A,E01010612,923,554,369,80,48,241
2011,Bradford 052B,E01010819,996,531,465,129,66,270
2011,Bradford 052C,E01010820,997,554,443,131,53,259
2011,Bradford 052D,E01010821,1366,900,466,75,75,316
2011,Bradford 052E,E01010822,945,555,390,125,52,213
2011,Bradford 053A,E01010615,1014,738,276,104,56,116
2011,Bradford 053B,E01010616,1237,743,494,121,100,273
2011,Bradford 053C,E01010742,1246,719,527,85,93,349
2011,Bradford 053D,E01010743,1221,714,507,112,61,334
2011,Bradford 054A,E01010847,1116,846,270,126,29,115
2011,Bradford 054B,E01010848,1095,797,298,148,57,93
2011,Bradford 054C,E01010852,1014,643,371,163,39,169
2011,Bradford 054D,E01010853,946,660,286,135,52,99
2011,Bradford 055A,E01010668,973,653,320,161,50,109
2011,Bradford 055B,E01010755,1129,771,358,87,63,208
2011,Bradford 055C,E01010762,1106,787,319,112,78,129
2011,Bradford 055D,E01010763,1079,780,299,164,34,101
2011,Bradford 055E,E01010846,1536,1113,423,165,80,178
2011,Bradford 056A,E01010745,1101,716,385,84,68,233
2011,Bradford 056B,E01010747,1107,745,362,129,68,165
2011,Bradford 056C,E01010748,1055,700,355,141,56,158
2011,Bradford 056D,E01010749,986,675,311,154,26,131
2011,Bradford 057A,E01010814,1221,861,360,153,35,172
2011,Bradford 057B,E01010815,1682,1196,486,121,89,276
2011,Bradford 057C,E01010816,1373,1047,326,179,43,104
2011,Bradford 057D,E01010817,1497,994,503,167,44,292
2011,Bradford 057E,E01010818,1348,997,351,147,61,143
2011,Bradford 058A,E01010752,1338,1006,332,157,50,125
2011,Bradford 058B,E01010753,1114,775,339,244,34,61
2011,Bradford 058C,E01010754,1153,938,215,104,46,65
2011,Bradford 058D,E01010756,1122,875,247,106,49,92
2011,Bradford 058E,E01010758,1001,793,208,105,47,56
2011,Bradford 058F,E01010759,1128,763,365,170,63,132
2011,Bradford 058G,E01010760,1166,893,273,158,39,76
2011,Bradford 059A,E01010741,1121,806,315,160,43,112
2011,Bradford 059B,E01010845,1370,870,500,171,61,268
2011,Bradford 059C,E01010849,1049,732,317,208,33,76
2011,Bradford 059D,E01010850,946,628,318,72,59,187
2011,Bradford 059E,E01010851,1196,897,299,142,38,119
2011,Bradford 059F,E01010864,909,642,267,79,37,151
2011,Bradford 059G,E01010867,1014,757,257,89,44,124
2011,Bradford 059H,E01010874,818,527,291,101,27,163
2011,Bradford 060A,E01010746,1233,799,434,271,51,112
2011,Bradford 060B,E01010750,1196,870,326,195,45,86
2011,Bradford 060C,E01010751,1109,743,366,212,36,118
2011,Bradford 060D,E01010865,1221,927,294,177,32,85
2011,Bradford 060E,E01010866,1025,780,245,129,50,66
2011,Bradford 061A,E01010868,1186,796,390,121,64,205
2011,Bradford 061B,E01010869,1254,845,409,184,58,167
2011,Bradford 061C,E01010870,1179,827,352,245,31,76
2011,Bradford 061D,E01010871,1284,932,352,156,64,132
2011,Bradford 061E,E01010872,1132,711,421,156,46,219
2011,Bradford 061F,E01010873,904,633,271,175,33,63
2011,Calderdale 001A,E01010911,1318,984,334,218,49,67
2011,Calderdale 001B,E01010912,1079,701,378,203,52,123
2011,Calderdale 001C,E01010913,984,701,283,211,30,42
2011,Calderdale 001D,E01010915,1061,825,236,148,30,58
2011,Calderdale 002A,E01010914,1321,938,383,176,49,158
2011,Calderdale 002B,E01010924,927,588,339,131,29,179
2011,Calderdale 002C,E01010925,1008,672,336,131,61,144
2011,Calderdale 002D,E01010926,779,474,305,74,63,168
2011,Calderdale 003A,E01010931,1022,771,251,153,41,57
2011,Calderdale 003B,E01010932,1197,873,324,232,29,63
2011,Calderdale 003C,E01010933,1197,876,321,227,47,47
2011,Calderdale 003D,E01010935,1172,837,335,262,37,36
2011,Calderdale 003E,E01010936,1372,1088,284,200,37,47
2011,Calderdale 003F,E01010937,1139,847,292,202,23,67
2011,Calderdale 004A,E01010881,1227,923,304,164,56,84
2011,Calderdale 004B,E01010882,1026,721,305,188,48,69
2011,Calderdale 004C,E01010883,1143,846,297,193,51,53
2011,Calderdale 004D,E01010887,1227,919,308,202,49,57
2011,Calderdale 004E,E01010888,1200,887,313,167,50,96
2011,Calderdale 004F,E01010923,1212,883,329,136,59,134
2011,Calderdale 005A,E01010916,1003,656,347,152,45,150
2011,Calderdale 005B,E01010939,1328,996,332,198,48,86
2011,Calderdale 005C,E01010941,959,664,295,123,40,132
2011,Calderdale 005D,E01010942,1193,826,367,139,47,181
2011,Calderdale 005E,E01010944,964,606,358,146,51,161
2011,Calderdale 006A,E01010938,990,648,342,118,44,180
2011,Calderdale 006B,E01010940,1068,806,262,135,43,84
2011,Calderdale 006C,E01010943,1077,685,392,129,62,201
2011,Calderdale 006D,E01010961,879,692,187,83,31,73
2011,Calderdale 007A,E01010917,1343,964,379,236,52,91
2011,Calderdale 007B,E01010918,1228,891,337,207,48,82
2011,Calderdale 007C,E01010919,1092,750,342,194,44,104
2011,Calderdale 007D,E01010920,1318,946,372,227,53,92
2011,Calderdale 007E,E01010921,1176,840,336,185,49,102
2011,Calderdale 008A,E01010934,1530,1123,407,254,39,114
2011,Calderdale 008D,E01010967,1085,759,326,124,28,174
2011,Calderdale 008E,E01010994,1333,884,449,186,41,222
2011,Calderdale 008F,E01032923,1738,1252,486,205,67,214
2011,Calderdale 009A,E01010927,1223,893,330,243,27,60
2011,Calderdale 009B,E01010928,1005,641,364,140,64,160
2011,Calderdale 009C,E01010997,1097,737,360,253,47,60
2011,Calderdale 009D,E01010999,1119,794,325,219,26,80
2011,Calderdale 010A,E01010929,1552,1103,449,113,63,273
2011,Calderdale 010B,E01010930,1081,738,343,139,47,157
2011,Calderdale 010C,E01010998,1111,765,346,164,56,126
2011,Calderdale 010D,E01011000,1287,759,528,90,107,331
2011,Calderdale 011A,E01010904,1064,809,255,172,36,47
2011,Calderdale 011B,E01010906,1008,708,300,225,33,42
2011,Calderdale 011C,E01010907,1068,804,264,171,32,61
2011,Calderdale 011D,E01010909,1085,795,290,189,25,76
2011,Calderdale 012A,E01010960,1051,615,436,74,76,286
2011,Calderdale 012B,E01010964,1071,544,527,71,109,347
2011,Calderdale 012C,E01010965,1009,534,475,110,75,290
2011,Calderdale 012D,E01010966,1073,571,502,85,90,327
2011,Calderdale 012E,E01010995,940,512,428,65,87,276
2011,Calderdale 013A,E01010982,1001,678,323,170,45,108
2011,Calderdale 013B,E01010983,1171,812,359,139,53,167
2011,Calderdale 013C,E01010985,1098,781,317,159,42,116
2011,Calderdale 013D,E01010986,1266,889,377,139,53,185
2011,Calderdale 013E,E01010987,1252,891,361,205,50,106
2011,Calderdale 013F,E01010988,1097,661,436,181,58,197
2011,Calderdale 014A,E01010996,1033,555,478,59,122,297
2011,Calderdale 014B,E01011001,1073,621,452,53,115,284
2011,Calderdale 014C,E01011002,1221,789,432,125,96,211
2011,Calderdale 014D,E01011003,853,545,308,91,42,175
2011,Calderdale 015A,E01010878,1322,1031,291,164,41,86
2011,Calderdale 015B,E01010879,1406,1020,386,264,49,73
2011,Calderdale 015C,E01010905,1338,989,349,214,44,91
2011,Calderdale 015D,E01010908,1542,1175,367,230,49,88
2011,Calderdale 015E,E01010910,912,576,336,167,33,136
2011,Calderdale 016A,E01010969,1282,961,321,189,46,86
2011,Calderdale 016B,E01010970,1341,997,344,172,78,94
2011,Calderdale 016C,E01010974,1051,695,356,123,73,160
2011,Calderdale 016D,E01010977,1165,873,292,206,38,48
2011,Calderdale 017A,E01010975,1074,657,417,299,39,79
2011,Calderdale 017B,E01010976,1358,990,368,226,49,93
2011,Calderdale 017C,E01010978,995,764,231,93,41,97
2011,Calderdale 017D,E01010979,1218,850,368,164,42,162
2011,Calderdale 017E,E01010980,1116,858,258,113,35,110
2011,Calderdale 017F,E01010981,1141,866,275,122,40,113
2011,Calderdale 018A,E01010989,1137,836,301,166,37,98
2011,Calderdale 018B,E01010990,1221,897,324,196,39,89
2011,Calderdale 018C,E01010991,1157,830,327,218,27,82
2011,Calderdale 018D,E01010992,1228,965,263,152,34,77
2011,Calderdale 018E,E01010993,1234,860,374,166,58,150
2011,Calderdale 019A,E01010875,1203,860,343,260,32,51
2011,Calderdale 019B,E01010876,1192,884,308,211,38,59
2011,Calderdale 019C,E01010877,1126,805,321,189,42,90
2011,Calderdale 019D,E01010880,1083,680,403,146,51,206
2011,Calderdale 019E,E01010949,1163,863,300,163,34,103
2011,Calderdale 020A,E01010922,1441,1101,340,169,56,115
2011,Calderdale 020B,E01010956,1223,917,306,182,45,79
2011,Calderdale 020C,E01010958,1010,613,397,194,39,164
2011,Calderdale 020D,E01010959,1305,869,436,226,52,158
2011,Calderdale 021A,E01010968,1305,967,338,207,55,76
2011,Calderdale 021B,E01010971,1335,975,360,241,53,66
2011,Calderdale 021C,E01010972,1114,780,334,201,53,80
2011,Calderdale 021D,E01010973,1220,827,393,259,42,92
2011,Calderdale 022A,E01010884,1144,767,377,228,42,107
2011,Calderdale 022B,E01010885,1075,788,287,166,33,88
2011,Calderdale 022C,E01010886,821,563,258,140,33,85
2011,Calderdale 022D,E01010984,969,705,264,106,39,119
2011,Calderdale 023A,E01010946,1002,641,361,285,43,33
2011,Calderdale 023B,E01010947,1113,809,304,203,39,62
2011,Calderdale 023C,E01010950,1109,761,348,157,43,148
2011,Calderdale 023D,E01010951,1105,795,310,166,25,119
2011,Calderdale 024A,E01010891,1275,841,434,208,52,174
2011,Calderdale 024B,E01010892,1407,1090,317,182,50,85
2011,Calderdale 024C,E01010895,1056,668,388,207,47,134
2011,Calderdale 024D,E01010945,1232,847,385,246,31,108
2011,Calderdale 024E,E01010948,1016,674,342,225,44,73
2011,Calderdale 025A,E01010889,1278,814,464,211,54,199
2011,Calderdale 025B,E01010890,1389,1044,345,159,53,133
2011,Calderdale 025C,E01010893,1011,734,277,148,43,86
2011,Calderdale 025D,E01010894,1169,825,344,134,41,169
2011,Calderdale 025E,E01010901,1206,858,348,235,26,87
2011,Calderdale 025F,E01010903,1173,824,349,216,42,91
2011,Calderdale 026A,E01010896,1233,924,309,189,46,74
2011,Calderdale 026B,E01010897,1313,990,323,204,52,67
2011,Calderdale 026C,E01010898,1252,980,272,160,41,71
2011,Calderdale 026D,E01010899,1013,737,276,166,31,79
2011,Calderdale 026E,E01010900,1210,888,322,237,37,48
2011,Calderdale 026F,E01010902,1114,795,319,123,54,142
2011,Calderdale 027A,E01010952,1164,861,303,199,32,72
2011,Calderdale 027B,E01010953,1088,807,281,192,38,51
2011,Calderdale 027C,E01010954,1723,1420,303,172,36,95
2011,Calderdale 027D,E01010955,1156,835,321,155,95,71
2011,Calderdale 027E,E01010957,1168,891,277,191,32,54
2011,Kirklees 001A,E01011051,1186,889,297,192,44,61
2011,Kirklees 001B,E01011055,935,672,263,165,38,60
2011,Kirklees 001C,E01011056,1151,862,289,191,27,71
2011,Kirklees 001D,E01011057,1014,737,277,175,43,59
2011,Kirklees 001E,E01011058,858,611,247,146,28,73
2011,Kirklees 002A,E01011048,1234,844,390,232,27,131
2011,Kirklees 002B,E01011049,1214,871,343,184,43,116
2011,Kirklees 002C,E01011050,1168,822,346,254,34,58
2011,Kirklees 002D,E01011052,1226,895,331,163,39,129
2011,Kirklees 002E,E01011053,1154,827,327,237,32,58
2011,Kirklees 002F,E01011059,1021,685,336,87,38,211
2011,Kirklees 003A,E01011062,1273,974,299,176,41,82
2011,Kirklees 003B,E01011064,1050,683,367,176,32,159
2011,Kirklees 003C,E01011068,1243,940,303,201,36,66
2011,Kirklees 003D,E01011069,1016,731,285,208,22,55
2011,Kirklees 004A,E01011241,1222,928,294,194,35,65
2011,Kirklees 004B,E01011242,1149,807,342,185,38,119
2011,Kirklees 004C,E01011243,1261,928,333,226,32,75
2011,Kirklees 004D,E01011244,1509,1177,332,184,61,87
2011,Kirklees 005A,E01011060,1275,842,433,243,45,145
2011,Kirklees 005B,E01011061,1267,893,374,178,46,150
2011,Kirklees 005C,E01011063,1498,1122,376,230,44,102
2011,Kirklees 005D,E01011065,1231,983,248,112,46,90
2011,Kirklees 005E,E01011066,1112,799,313,217,37,59
2011,Kirklees 006A,E01011027,921,650,271,130,30,111
2011,Kirklees 006B,E01011028,1077,765,312,140,52,120
2011,Kirklees 006C,E01011030,1042,715,327,118,39,170
2011,Kirklees 006D,E01011031,1217,835,382,228,54,100
2011,Kirklees 006E,E01011054,1055,716,339,254,29,56
2011,Kirklees 007A,E01011013,1058,666,392,270,32,90
2011,Kirklees 007B,E01011014,1113,755,358,84,59,215
2011,Kirklees 007C,E01011023,1187,788,399,164,63,172
2011,Kirklees 007D,E01011024,1213,801,412,118,65,229
2011,Kirklees 008A,E01011067,1198,872,326,209,43,74
2011,Kirklees 008B,E01011247,1200,938,262,166,26,70
2011,Kirklees 008C,E01011249,1129,723,406,208,43,155
2011,Kirklees 008D,E01011251,1143,755,388,150,57,181
2011,Kirklees 009A,E01011245,1156,791,365,192,47,126
2011,Kirklees 009B,E01011246,1074,743,331,111,55,165
2011,Kirklees 009C,E01011248,1096,750,346,216,34,96
2011,Kirklees 009D,E01011250,1258,907,351,152,41,158
2011,Kirklees 010A,E01011015,1066,535,531,140,74,317
2011,Kirklees 010B,E01011029,1002,604,398,125,44,229
2011,Kirklees 010C,E01011032,1008,625,383,105,71,207
2011,Kirklees 010D,E01011034,1088,614,474,96,79,299
2011,Kirklees 011A,E01011157,1170,777,393,102,71,220
2011,Kirklees 011B,E01011161,975,731,244,139,34,71
2011,Kirklees 011C,E01011163,937,613,324,116,46,162
2011,Kirklees 011D,E01011164,1224,859,365,213,42,110
2011,Kirklees 011E,E01011165,1271,822,449,107,99,243
2011,Kirklees 011F,E01011166,1179,765,414,131,58,225
2011,Kirklees 011G,E01011167,1287,809,478,144,72,262
2011,Kirklees 012A,E01011033,1245,868,377,153,60,164
2011,Kirklees 012B,E01011035,1116,650,466,97,90,279
2011,Kirklees 012C,E01011036,1096,649,447,100,61,286
2011,Kirklees 012D,E01011037,1462,1046,416,150,61,205
2011,Kirklees 013A,E01011016,1154,731,423,98,77,248
2011,Kirklees 013B,E01011017,1186,596,590,92,116,382
2011,Kirklees 013C,E01011018,1018,574,444,83,83,278
2011,Kirklees 013D,E01011019,1278,793,485,142,80,263
2011,Kirklees 013E,E01011020,898,480,418,63,73,282
2011,Kirklees 014A,E01011021,1243,937,306,200,37,69
2011,Kirklees 014B,E01011022,1068,792,276,143,46,87
2011,Kirklees 014C,E01011126,1149,751,398,205,36,157
2011,Kirklees 014D,E01011127,1042,766,276,180,31,65
2011,Kirklees 015A,E01011156,1124,780,344,234,33,77
2011,Kirklees 015B,E01011158,1312,962,350,155,58,137
2011,Kirklees 015C,E01011159,1287,939,348,232,53,63
2011,Kirklees 015D,E01011160,1052,813,239,154,41,44
2011,Kirklees 015E,E01011162,1088,758,330,228,39,63
2011,Kirklees 016A,E01011025,1093,777,316,88,55,173
2011,Kirklees 016B,E01011026,1049,685,364,117,68,179
2011,Kirklees 016C,E01011136,1002,628,374,122,55,197
2011,Kirklees 016D,E01011137,1106,827,279,84,46,149
2011,Kirklees 017A,E01011128,1426,927,499,118,85,296
2011,Kirklees 017B,E01011130,1435,935,500,155,64,281
2011,Kirklees 017E,E01033542,2049,1345,704,220,143,341
2011,Kirklees 018A,E01011121,1106,799,307,102,44,161
2011,Kirklees 018B,E01011122,940,584,356,95,53,208
2011,Kirklees 018C,E01011123,1138,755,383,167,59,157
2011,Kirklees 018D,E01011124,1410,1098,312,179,36,97
2011,Kirklees 018E,E01011125,1106,767,339,173,59,107
2011,Kirklees 018F,E01011129,986,708,278,127,53,98
2011,Kirklees 019A,E01011138,1130,662,468,99,80,289
2011,Kirklees 019B,E01011139,1014,659,355,103,63,189
2011,Kirklees 019C,E01011140,997,513,484,63,89,332
2011,Kirklees 019D,E01011141,1172,745,427,65,95,267
2011,Kirklees 020A,E01011132,1055,716,339,236,52,51
2011,Kirklees 020B,E01011142,1177,874,303,202,46,55
2011,Kirklees 020C,E01011217,1203,792,411,320,23,68
2011,Kirklees 020D,E01011218,1180,804,376,244,37,95
2011,Kirklees 021A,E01011216,1052,717,335,222,59,54
2011,Kirklees 021B,E01011219,1223,856,367,246,30,91
2011,Kirklees 021C,E01011220,1270,848,422,165,55,202
2011,Kirklees 021D,E01011221,1272,898,374,255,50,69
2011,Kirklees 022A,E01011046,993,697,296,188,59,49
2011,Kirklees 022B,E01011100,1078,711,367,171,51,145
2011,Kirklees 022C,E01011102,1043,806,237,118,46,73
2011,Kirklees 022D,E01011108,1129,818,311,163,51,97
2011,Kirklees 023A,E01011133,926,515,411,67,66,278
2011,Kirklees 023B,E01011134,1206,657,549,63,104,382
2011,Kirklees 023C,E01011143,1032,590,442,51,71,320
2011,Kirklees 023D,E01011144,970,529,441,87,62,292
2011,Kirklees 023E,E01011260,924,626,298,103,45,150
2011,Kirklees 024A,E01011257,1553,790,763,110,155,498
2011,Kirklees 024B,E01011258,1514,697,817,116,314,387
2011,Kirklees 024C,E01011259,1179,671,508,97,103,308
2011,Kirklees 024D,E01011261,847,514,333,52,57,224
2011,Kirklees 024E,E01011262,1043,552,491,96,95,300
2011,Kirklees 024F,E01011263,1165,787,378,138,67,173
2011,Kirklees 025A,E01011101,1184,742,442,105,84,253
2011,Kirklees 025B,E01011103,988,654,334,146,51,137
2011,Kirklees 025C,E01011104,1150,759,391,189,41,161
2011,Kirklees 025D,E01011105,1375,954,421,110,87,224
2011,Kirklees 026A,E01011212,1125,720,405,232,45,128
2011,Kirklees 026B,E01011213,1147,734,413,310,36,67
2011,Kirklees 026C,E01011214,1161,851,310,201,42,67
2011,Kirklees 026D,E01011215,1542,1128,414,248,58,108
2011,Kirklees 027A,E01011039,1278,793,485,219,86,180
2011,Kirklees 027B,E01011042,1176,885,291,138,63,90
2011,Kirklees 027C,E01011047,1120,746,374,259,44,71
2011,Kirklees 027D,E01011210,1437,1074,363,176,69,118
2011,Kirklees 028A,E01011252,924,635,289,193,47,49
2011,Kirklees 028B,E01011253,919,547,372,167,55,150
2011,Kirklees 028C,E01011254,1137,753,384,281,32,71
2011,Kirklees 028D,E01011255,1041,696,345,130,50,165
2011,Kirklees 028E,E01011256,987,670,317,144,41,132
2011,Kirklees 029A,E01011038,1080,597,483,119,112,252
2011,Kirklees 029B,E01011041,1090,732,358,116,73,169
2011,Kirklees 029C,E01011106,1053,684,369,109,65,195
2011,Kirklees 029D,E01011107,1424,796,628,95,261,272
2011,Kirklees 030A,E01011201,1228,882,346,174,51,121
2011,Kirklees 030B,E01011203,1282,931,351,194,64,93
2011,Kirklees 030C,E01011209,1096,803,293,212,44,37
2011,Kirklees 030D,E01011211,1164,771,393,267,37,89
2011,Kirklees 031A,E01011040,1350,882,468,78,152,238
2011,Kirklees 031B,E01011043,1759,1083,676,136,220,320
2011,Kirklees 031C,E01011044,1088,720,368,113,88,167
2011,Kirklees 031D,E01011045,1348,766,582,138,115,329
2011,Kirklees 032A,E01011089,936,647,289,183,33,73
2011,Kirklees 032B,E01011091,1085,812,273,187,37,49
2011,Kirklees 032C,E01011092,985,686,299,221,26,52
2011,Kirklees 032D,E01011200,1748,1429,319,161,60,98
2011,Kirklees 033A,E01011204,1039,681,358,209,52,97
2011,Kirklees 033B,E01011206,1211,910,301,151,60,90
2011,Kirklees 033C,E01011208,1191,894,297,140,41,116
2011,Kirklees 033D,E01011240,1227,876,351,156,64,131
2011,Kirklees 034A,E01011231,1145,816,329,157,74,98
2011,Kirklees 034B,E01011236,1446,886,560,72,272,216
2011,Kirklees 034C,E01011238,1238,873,365,130,120,115
2011,Kirklees 034D,E01011239,1212,865,347,134,84,129
2011,Kirklees 035A,E01011093,1030,688,342,86,62,194
2011,Kirklees 035B,E01011094,1035,600,435,138,94,203
2011,Kirklees 035C,E01011096,1129,799,330,139,73,118
2011,Kirklees 035D,E01011098,1201,854,347,97,134,116
2011,Kirklees 036A,E01011146,1205,959,246,150,35,61
2011,Kirklees 036B,E01011151,1233,945,288,192,45,51
2011,Kirklees 036C,E01011202,1129,758,371,218,45,108
2011,Kirklees 036D,E01011205,1246,967,279,182,45,52
2011,Kirklees 037A,E01011090,1145,802,343,162,63,118
2011,Kirklees 037B,E01011095,1040,719,321,193,34,94
2011,Kirklees 037C,E01011097,1166,788,378,169,70,139
2011,Kirklees 037D,E01011099,1091,762,329,186,38,105
2011,Kirklees 038A,E01011150,1217,935,282,145,52,85
2011,Kirklees 038B,E01011155,1451,1130,321,223,34,64
2011,Kirklees 038C,E01011207,1062,743,319,217,43,59
2011,Kirklees 038D,E01011234,1108,797,311,121,49,141
2011,Kirklees 039A,E01011232,1201,711,490,136,123,231
2011,Kirklees 039B,E01011233,1154,847,307,132,50,125
2011,Kirklees 039C,E01011235,1469,838,631,163,258,210
2011,Kirklees 039D,E01011237,1141,700,441,104,99,238
2011,Kirklees 040A,E01011004,956,569,387,174,52,161
2011,Kirklees 040B,E01011006,1109,768,341,193,70,78
2011,Kirklees 040C,E01011008,1192,897,295,93,123,79
2011,Kirklees 040D,E01011012,1227,863,364,142,122,100
2011,Kirklees 041A,E01011145,1131,796,335,194,52,89
2011,Kirklees 041B,E01011147,1153,886,267,136,40,91
2011,Kirklees 041C,E01011148,1188,705,483,180,67,236
2011,Kirklees 041D,E01011152,1319,1061,258,128,42,88
2011,Kirklees 042A,E01011007,1177,818,359,129,149,81
2011,Kirklees 042B,E01011223,1422,869,553,115,229,209
2011,Kirklees 042C,E01011225,1379,844,535,114,249,172
2011,Kirklees 042D,E01011229,2600,1323,1277,111,972,194
2011,Kirklees 043A,E01011080,1344,841,503,104,101,298
2011,Kirklees 043B,E01011081,1307,780,527,112,97,318
2011,Kirklees 043C,E01011082,1226,601,625,66,165,394
2011,Kirklees 043D,E01011230,1333,630,703,87,211,405
2011,Kirklees 044A,E01011005,1098,743,355,246,37,72
2011,Kirklees 044B,E01011009,972,626,346,219,39,88
2011,Kirklees 044C,E01011010,1079,727,352,129,56,167
2011,Kirklees 044D,E01011011,1140,810,330,228,44,58
2011,Kirklees 045A,E01011077,1224,940,284,147,55,82
2011,Kirklees 045B,E01011149,1461,1108,353,115,43,195
2011,Kirklees 045C,E01011153,1284,970,314,170,36,108
2011,Kirklees 045D,E01011154,1107,796,311,122,54,135
2011,Kirklees 046A,E01011191,1151,846,305,211,39,55
2011,Kirklees 046B,E01011192,1127,752,375,208,39,128
2011,Kirklees 046C,E01011193,1426,1073,353,232,39,82
2011,Kirklees 046D,E01011194,1034,678,356,285,24,47
2011,Kirklees 047A,E01011079,1381,952,429,168,65,196
2011,Kirklees 047B,E01011083,1222,875,347,169,50,128
2011,Kirklees 047C,E01011084,1176,684,492,79,95,318
2011,Kirklees 047D,E01011085,1098,630,468,231,66,171
2011,Kirklees 048A,E01011224,1269,828,441,144,108,189
2011,Kirklees 048B,E01011226,1151,798,353,204,75,74
2011,Kirklees 048C,E01011227,1181,711,470,220,69,181
2011,Kirklees 048D,E01011228,1158,810,348,206,46,96
2011,Kirklees 049A,E01011071,1246,934,312,199,42,71
2011,Kirklees 049B,E01011072,1198,921,277,151,44,82
2011,Kirklees 049C,E01011073,1098,798,300,145,49,106
2011,Kirklees 049D,E01011078,1268,978,290,171,33,86
2011,Kirklees 050A,E01011086,1189,759,430,307,45,78
2011,Kirklees 050B,E01011087,1162,801,361,207,36,118
2011,Kirklees 050C,E01011088,1042,729,313,229,40,44
2011,Kirklees 050D,E01011222,1439,1014,425,193,53,179
2011,Kirklees 051A,E01011190,1244,901,343,247,47,49
2011,Kirklees 051B,E01011195,1953,1049,904,179,689,36
2011,Kirklees 051C,E01011196,1365,978,387,245,57,85
2011,Kirklees 051D,E01011197,1161,825,336,186,51,99
2011,Kirklees 052A,E01011070,1185,865,320,206,30,84
2011,Kirklees 052B,E01011074,1418,1035,383,203,40,140
2011,Kirklees 052C,E01011075,1079,781,298,178,24,96
2011,Kirklees 052D,E01011076,1109,759,350,214,35,101
2011,Kirklees 053A,E01011169,1095,757,338,233,32,73
2011,Kirklees 053B,E01011170,1356,1004,352,242,37,73
2011,Kirklees 053C,E01011171,1060,795,265,152,50,63
2011,Kirklees 053D,E01011172,667,431,236,137,26,73
2011,Kirklees 053E,E01011173,917,632,285,194,36,55
2011,Kirklees 053F,E01011176,1066,735,331,209,49,73
2011,Kirklees 054A,E01011109,1339,995,344,194,53,97
2011,Kirklees 054B,E01011113,1282,897,385,285,46,54
2011,Kirklees 054C,E01011114,1092,671,421,259,41,121
2011,Kirklees 054D,E01011119,1096,735,361,249,28,84
2011,Kirklees 055A,E01011168,1186,846,340,222,51,67
2011,Kirklees 055B,E01011174,1333,968,365,253,52,60
2011,Kirklees 055C,E01011175,1019,696,323,125,50,148
2011,Kirklees 055D,E01011177,1297,937,360,224,38,98
2011,Kirklees 055E,E01011178,1346,953,393,207,69,117
2011,Kirklees 056A,E01011118,1149,880,269,144,43,82
2011,Kirklees 056B,E01011120,1158,888,270,168,51,51
2011,Kirklees 056C,E01011198,1152,824,328,219,46,63
2011,Kirklees 056D,E01011199,1084,749,335,216,50,69
2011,Kirklees 057A,E01011110,1027,747,280,191,30,59
2011,Kirklees 057B,E01011111,1171,861,310,202,36,72
2011,Kirklees 057C,E01011112,1183,864,319,193,28,98
2011,Kirklees 057D,E01011115,1352,1005,347,229,31,87
2011,Kirklees 057E,E01011116,1269,849,420,303,49,68
2011,Kirklees 057F,E01011117,1315,955,360,243,38,79
2011,Kirklees 058A,E01011180,1452,1070,382,250,53,79
2011,Kirklees 058B,E01011182,1286,935,351,221,42,88
2011,Kirklees 058C,E01011186,1168,802,366,233,44,89
2011,Kirklees 058D,E01011188,1224,852,372,241,51,80
2011,Kirklees 059A,E01011179,1355,1001,354,225,59,70
2011,Kirklees 059B,E01011181,1376,1067,309,190,35,84
2011,Kirklees 059C,E01011183,1501,1183,318,181,60,77
2011,Kirklees 059D,E01011184,1031,709,322,167,42,113
2011,Kirklees 059E,E01011185,1141,818,323,214,37,72
2011,Kirklees 059F,E01011187,1291,902,389,234,70,85
2011,Kirklees 059G,E01011189,1209,851,358,274,36,48
2011,Leeds 001A,E01011698,1130,789,341,247,35,59
2011,Leeds 001B,E01011699,1021,709,312,230,24,58
2011,Leeds 001C,E01011701,916,669,247,164,39,44
2011,Leeds 001D,E01011702,855,583,272,202,32,38
2011,Leeds 001E,E01011703,954,563,391,305,35,51
2011,Leeds 002A,E01011697,1749,783,966,171,36,759
2011,Leeds 002B,E01011700,1031,591,440,178,55,207
2011,Leeds 002C,E01011704,1245,885,360,269,16,75
2011,Leeds 002D,E01011705,947,659,288,177,24,87
2011,Leeds 003A,E01011581,1055,712,343,237,33,73
2011,Leeds 003B,E01011582,1121,764,357,174,35,148
2011,Leeds 003C,E01011583,1082,770,312,211,44,57
2011,Leeds 003D,E01011584,896,630,266,188,35,43
2011,Leeds 004A,E01011569,1259,977,282,173,41,68
2011,Leeds 004B,E01011571,1182,882,300,201,41,58
2011,Leeds 004C,E01011572,1346,1059,287,190,29,68
2011,Leeds 004D,E01011573,1003,772,231,154,35,42
2011,Leeds 004E,E01011574,984,700,284,219,16,49
2011,Leeds 005A,E01011707,961,649,312,229,36,47
2011,Leeds 005B,E01011709,1085,697,388,283,46,59
2011,Leeds 005C,E01011710,1030,806,224,147,27,50
2011,Leeds 005D,E01011711,990,690,300,222,28,50
2011,Leeds 005E,E01011712,1036,766,270,176,28,66
2011,Leeds 006A,E01011561,915,687,228,122,38,68
2011,Leeds 006B,E01011696,1011,667,344,244,28,72
2011,Leeds 006C,E01011706,1054,761,293,194,28,71
2011,Leeds 006D,E01011708,1105,752,353,213,53,87
2011,Leeds 006E,E01011713,1336,932,404,240,51,113
2011,Leeds 007A,E01011570,1580,1194,386,241,46,99
2011,Leeds 007C,E01011576,1012,695,317,210,53,54
2011,Leeds 007E,E01032503,1046,752,294,183,38,73
2011,Leeds 007F,E01032504,1078,713,365,256,42,67
2011,Leeds 008A,E01011266,1574,1272,302,174,49,79
2011,Leeds 008B,E01011270,1154,745,409,301,45,63
2011,Leeds 008C,E01011279,932,701,231,162,28,41
2011,Leeds 008D,E01011280,1294,1012,282,199,34,49
2011,Leeds 009A,E01011265,1114,885,229,141,32,56
2011,Leeds 009B,E01011267,1022,736,286,169,31,86
2011,Leeds 009C,E01011271,1560,1191,369,245,56,68
2011,Leeds 009D,E01011272,1115,832,283,196,33,54
2011,Leeds 010A,E01011268,983,692,291,121,32,138
2011,Leeds 010B,E01011273,1106,841,265,160,40,65
2011,Leeds 010C,E01011274,1003,666,337,163,33,141
2011,Leeds 010D,E01011275,976,719,257,161,35,61
2011,Leeds 011A,E01011264,950,678,272,194,24,54
2011,Leeds 011B,E01011269,1122,811,311,197,34,80
2011,Leeds 011C,E01011276,1029,777,252,170,32,50
2011,Leeds 011D,E01011578,1008,719,289,200,35,54
2011,Leeds 012A,E01011554,1022,755,267,160,48,59
2011,Leeds 012B,E01011562,1159,780,379,215,79,85
2011,Leeds 012C,E01011563,1006,701,305,207,44,54
2011,Leeds 012D,E01011564,1053,792,261,161,43,57
2011,Leeds 012E,E01011567,1002,760,242,137,50,55
2011,Leeds 013A,E01011376,1103,767,336,242,35,59
2011,Leeds 013B,E01011377,973,662,311,224,33,54
2011,Leeds 013C,E01011378,1044,703,341,127,64,150
2011,Leeds 013D,E01011382,1062,755,307,219,38,50
2011,Leeds 014A,E01011277,1121,925,196,126,24,46
2011,Leeds 014B,E01011278,1215,938,277,182,31,64
2011,Leeds 014C,E01011579,919,710,209,121,30,58
2011,Leeds 014D,E01011580,964,695,269,184,34,51
2011,Leeds 015A,E01011556,1122,882,240,115,33,92
2011,Leeds 015B,E01011557,1097,804,293,151,61,81
2011,Leeds 015C,E01011565,1017,748,269,158,42,69
2011,Leeds 015D,E01011566,954,689,265,143,37,85
2011,Leeds 015E,E01011568,1363,1004,359,217,59,83
2011,Leeds 016A,E01011380,1117,748,369,247,48,74
2011,Leeds 016B,E01011381,942,670,272,166,51,55
2011,Leeds 016C,E01011385,880,593,287,178,43,66
2011,Leeds 016D,E01011386,1033,752,281,169,39,73
2011,Leeds 017A,E01011379,1040,728,312,136,39,137
2011,Leeds 017B,E01011384,1113,794,319,183,44,92
2011,Leeds 017E,E01032501,853,609,244,173,27,44
2011,Leeds 017F,E01032502,1300,909,391,135,68,188
2011,Leeds 018A,E01011555,1049,726,323,203,53,67
2011,Leeds 018B,E01011558,1073,750,323,110,52,161
2011,Leeds 018C,E01011559,864,553,311,76,59,176
2011,Leeds 018D,E01011560,1287,850,437,126,66,245
2011,Leeds 019A,E01011383,1096,765,331,183,49,99
2011,Leeds 019B,E01011388,982,701,281,166,44,71
2011,Leeds 019C,E01011684,1121,808,313,153,63,97
2011,Leeds 019D,E01011695,1056,703,353,107,54,192
2011,Leeds 020A,E01011650,1052,758,294,159,49,86
2011,Leeds 020B,E01011651,1059,816,243,114,44,85
2011,Leeds 020C,E01011653,1016,812,204,92,47,65
2011,Leeds 020D,E01011655,983,725,258,161,31,66
2011,Leeds 021A,E01011455,1059,693,366,206,127,33
2011,Leeds 021B,E01011456,1219,835,384,223,91,70
2011,Leeds 021C,E01011459,1146,831,315,192,42,81
2011,Leeds 021D,E01011461,1089,741,348,259,50,39
2011,Leeds 022A,E01011311,881,629,252,134,37,81
2011,Leeds 022B,E01011649,1067,731,336,243,48,45
2011,Leeds 022C,E01011715,958,681,277,181,41,55
2011,Leeds 022D,E01011719,1006,679,327,241,36,50
2011,Leeds 023A,E01011509,956,703,253,175,29,49
2011,Leeds 023B,E01011511,918,661,257,114,55,88
2011,Leeds 023C,E01011512,1156,857,299,134,57,108
2011,Leeds 023D,E01011515,1099,851,248,135,57,56
2011,Leeds 023E,E01011516,1266,999,267,141,65,61
2011,Leeds 024A,E01011508,1025,787,238,84,72,82
2011,Leeds 024B,E01011517,1211,922,289,117,63,109
2011,Leeds 024C,E01011652,1006,770,236,111,49,76
2011,Leeds 024D,E01011654,1007,764,243,145,43,55
2011,Leeds 025A,E01011505,1134,802,332,158,66,108
2011,Leeds 025B,E01011506,1008,748,260,100,51,109
2011,Leeds 025C,E01011507,1167,879,288,157,51,80
2011,Leeds 025D,E01011510,1052,667,385,175,44,166
2011,Leeds 025E,E01011514,1212,915,297,135,59,103
2011,Leeds 027A,E01011452,1116,850,266,196,37,33
2011,Leeds 027B,E01011454,1146,923,223,141,34,48
2011,Leeds 027C,E01011457,1115,789,326,169,92,65
2011,Leeds 027D,E01011458,990,702,288,221,31,36
2011,Leeds 027E,E01011465,1119,848,271,164,33,74
2011,Leeds 028A,E01011453,1090,818,272,187,36,49
2011,Leeds 028B,E01011460,1053,838,215,95,49,71
2011,Leeds 028C,E01011462,1213,885,328,159,58,111
2011,Leeds 028D,E01011463,1162,834,328,176,47,105
2011,Leeds 028E,E01011464,1368,1126,242,142,37,63
2011,Leeds 029A,E01011714,1088,784,304,180,44,80
2011,Leeds 029B,E01011716,1114,767,347,216,50,81
2011,Leeds 029C,E01011717,1081,763,318,186,27,105
2011,Leeds 029D,E01011718,1017,730,287,127,36,124
2011,Leeds 029E,E01011720,1086,710,376,181,40,155
2011,Leeds 030A,E01011296,1191,787,404,319,31,54
2011,Leeds 030B,E01011297,1159,857,302,180,36,86
2011,Leeds 030C,E01011309,1104,790,314,215,26,73
2011,Leeds 030D,E01011310,1175,828,347,236,46,65
2011,Leeds 031A,E01011513,1629,1336,293,155,60,78
2011,Leeds 031B,E01011688,1110,869,241,84,59,98
2011,Leeds 031C,E01011689,1148,813,335,199,49,87
2011,Leeds 031D,E01011691,1086,757,329,109,82,138
2011,Leeds 032A,E01011504,1015,687,328,99,57,172
2011,Leeds 032B,E01011641,1081,821,260,144,50,66
2011,Leeds 032C,E01011642,945,686,259,102,65,92
2011,Leeds 032D,E01011645,1043,803,240,90,49,101
2011,Leeds 033A,E01011484,1061,697,364,110,52,202
2011,Leeds 033B,E01011485,1138,785,353,121,58,174
2011,Leeds 033E,E01011686,1086,728,358,139,39,180
2011,Leeds 033F,E01032493,1036,806,230,130,34,66
2011,Leeds 033G,E01032494,1258,901,357,101,66,190
2011,Leeds 034A,E01011350,1252,943,309,161,64,84
2011,Leeds 034B,E01011351,1406,1158,248,129,37,82
2011,Leeds 034C,E01011352,1455,1253,202,89,45,68
2011,Leeds 034D,E01011353,1461,1202,259,138,53,68
2011,Leeds 035A,E01011656,1021,741,280,85,55,140
2011,Leeds 035B,E01011657,959,655,304,99,40,165
2011,Leeds 035C,E01011659,1009,629,380,139,41,200
2011,Leeds 035D,E01011661,1084,658,426,170,47,209
2011,Leeds 037A,E01011643,957,654,303,181,43,79
2011,Leeds 037B,E01011644,845,604,241,130,39,72
2011,Leeds 037C,E01011646,1165,884,281,126,54,101
2011,Leeds 037D,E01011647,1160,749,411,105,93,213
2011,Leeds 037E,E01011648,1181,780,401,145,82,174
2011,Leeds 038A,E01011354,1006,684,322,74,74,174
2011,Leeds 038B,E01011355,992,677,315,109,64,142
2011,Leeds 038C,E01011357,1337,872,465,107,85,273
2011,Leeds 038D,E01011450,925,641,284,94,57,133
2011,Leeds 039A,E01011588,1239,970,269,147,49,73
2011,Leeds 039B,E01011589,1129,893,236,158,25,53
2011,Leeds 039C,E01011590,1144,801,343,226,33,84
2011,Leeds 039D,E01011592,1099,839,260,190,23,47
2011,Leeds 039E,E01011593,1360,1051,309,198,47,64
2011,Leeds 040A,E01011421,1036,702,334,133,54,147
2011,Leeds 040B,E01011425,1160,885,275,137,49,89
2011,Leeds 040C,E01011658,890,527,363,160,40,163
2011,Leeds 040D,E01011660,922,614,308,114,30,164
2011,Leeds 040E,E01011662,823,525,298,60,50,188
2011,Leeds 041A,E01011721,1052,694,358,177,39,142
2011,Leeds 041B,E01011722,1342,977,365,131,63,171
2011,Leeds 041C,E01011723,947,598,349,157,44,148
2011,Leeds 041D,E01011724,1283,911,372,141,51,180
2011,Leeds 042A,E01011356,1528,1183,345,143,82,120
2011,Leeds 042B,E01011358,1046,672,374,140,56,178
2011,Leeds 042C,E01011359,1299,957,342,92,98,152
2011,Leeds 042D,E01011360,1344,800,544,87,150,307
2011,Leeds 042E,E01011361,1720,1064,656,112,179,365
2011,Leeds 044A,E01011435,1738,1024,714,33,660,21
2011,Leeds 044D,E01011440,1536,918,618,53,523,42
2011,Leeds 044E,E01011441,1808,1032,776,59,630,87
2011,Leeds 044F,E01032945,3036,1727,1309,60,1173,76
2011,Leeds 045A,E01011477,1497,1018,479,118,193,168
2011,Leeds 045B,E01011480,1247,872,375,183,117,75
2011,Leeds 045C,E01011488,1199,971,228,83,61,84
2011,Leeds 045D,E01011489,1327,971,356,121,102,133
2011,Leeds 046A,E01011324,1848,1048,800,56,529,215
2011,Leeds 046B,E01011325,1097,819,278,124,39,115
2011,Leeds 046C,E01011326,955,660,295,109,35,151
2011,Leeds 046D,E01011332,915,616,299,110,43,146
2011,Leeds 047A,E01011423,1069,702,367,121,47,199
2011,Leeds 047B,E01011424,996,670,326,71,61,194
2011,Leeds 047C,E01011427,1116,632,484,91,99,294
2011,Leeds 047D,E01011431,1222,789,433,117,78,238
2011,Leeds 048A,E01011422,1039,659,380,53,97,230
2011,Leeds 048B,E01011426,1067,611,456,73,100,283
2011,Leeds 048C,E01011428,1277,787,490,67,118,305
2011,Leeds 048D,E01011429,1340,756,584,86,150,348
2011,Leeds 050A,E01011663,782,510,272,43,47,182
2011,Leeds 050B,E01011664,771,501,270,122,40,108
2011,Leeds 050C,E01011665,1048,715,333,132,46,155
2011,Leeds 050D,E01011667,877,499,378,61,71,246
2011,Leeds 051A,E01011323,895,636,259,164,30,65
2011,Leeds 051B,E01011329,1152,915,237,159,33,45
2011,Leeds 051C,E01011330,925,676,249,138,27,84
2011,Leeds 051D,E01011333,927,684,243,134,23,86
2011,Leeds 052A,E01011327,1036,764,272,88,53,131
2011,Leeds 052B,E01011328,1065,767,298,133,40,125
2011,Leeds 052C,E01011335,1282,1004,278,124,43,111
2011,Leeds 052D,E01011591,1317,1094,223,143,24,56
2011,Leeds 053A,E01011430,986,581,405,69,80,256
2011,Leeds 053B,E01011432,1019,643,376,53,72,251
2011,Leeds 053C,E01011433,1064,703,361,40,71,250
2011,Leeds 053D,E01011434,967,638,329,43,68,218
2011,Leeds 054A,E01011445,1640,662,978,10,946,22
2011,Leeds 054B,E01011446,1484,706,778,23,700,55
2011,Leeds 054C,E01011447,1338,639,699,28,612,59
2011,Leeds 054D,E01011448,1409,581,828,36,693,99
2011,Leeds 054E,E01011449,1205,712,493,31,371,91
2011,Leeds 055A,E01011670,2232,1129,1103,132,763,208
2011,Leeds 055B,E01011671,1098,667,431,88,167,176
2011,Leeds 055F,E01033002,1069,596,473,85,276,112
2011,Leeds 055G,E01033003,1506,1071,435,37,171,227
2011,Leeds 055H,E01033005,3249,1322,1927,60,1673,194
2011,Leeds 056A,E01011478,1466,1032,434,81,248,105
2011,Leeds 056B,E01011479,1410,886,524,31,443,50
2011,Leeds 056C,E01011481,1319,803,516,49,327,140
2011,Leeds 056D,E01011482,1441,1181,260,59,124,77
2011,Leeds 056E,E01011483,1259,738,521,71,275,175
2011,Leeds 057A,E01011406,1021,756,265,186,37,42
2011,Leeds 057B,E01011407,1018,771,247,167,25,55
2011,Leeds 057C,E01011408,1007,639,368,285,20,63
2011,Leeds 057D,E01011409,1077,809,268,157,36,75
2011,Leeds 057E,E01011410,991,680,311,221,23,67
2011,Leeds 057F,E01011412,968,675,293,207,32,54
2011,Leeds 058A,E01011331,931,715,216,126,27,63
2011,Leeds 058B,E01011334,1023,779,244,113,26,105
2011,Leeds 058C,E01011336,1078,682,396,187,29,180
2011,Leeds 058D,E01011337,893,569,324,57,59,208
2011,Leeds 059A,E01011281,1403,1048,355,130,56,169
2011,Leeds 059B,E01011282,1001,726,275,107,33,135
2011,Leeds 059C,E01011283,911,598,313,98,47,168
2011,Leeds 059D,E01011286,958,744,214,118,27,69
2011,Leeds 059E,E01011295,1135,863,272,85,37,150
2011,Leeds 060A,E01011339,1269,802,467,178,51,238
2011,Leeds 060B,E01011340,1104,728,376,137,65,174
2011,Leeds 060C,E01011342,941,567,374,107,71,196
2011,Leeds 060D,E01011346,1208,733,475,203,59,213
2011,Leeds 061A,E01011341,1062,774,288,130,35,123
2011,Leeds 061B,E01011343,1300,965,335,149,33,153
2011,Leeds 061C,E01011345,987,665,322,132,39,151
2011,Leeds 061D,E01011666,1104,815,289,168,48,73
2011,Leeds 062A,E01011585,1031,777,254,134,22,98
2011,Leeds 062B,E01011587,1310,1057,253,149,34,70
2011,Leeds 062C,E01011594,1043,749,294,126,38,130
2011,Leeds 062D,E01011596,1306,1033,273,171,38,64
2011,Leeds 062E,E01011598,1189,977,212,126,25,61
2011,Leeds 063B,E01011678,4015,1912,2103,50,1962,91
2011,Leeds 063D,E01011681,1473,836,637,49,393,195
2011,Leeds 063E,E01033006,3213,1210,2003,31,1851,121
2011,Leeds 064A,E01011338,1113,692,421,90,97,234
2011,Leeds 064B,E01011673,1233,819,414,58,93,263
2011,Leeds 064D,E01011677,1128,731,397,117,59,221
2011,Leeds 064E,E01033031,1098,816,282,78,63,141
2011,Leeds 064F,E01033035,1048,717,331,29,75,227
2011,Leeds 065A,E01011344,1273,869,404,90,54,260
2011,Leeds 065B,E01011347,1188,789,399,95,68,236
2011,Leeds 065C,E01011348,1073,644,429,101,70,258
2011,Leeds 065D,E01011349,1301,809,492,185,58,249
2011,Leeds 066A,E01011586,1045,738,307,172,40,95
2011,Leeds 066B,E01011595,1255,880,375,184,70,121
2011,Leeds 066C,E01011597,1070,737,333,133,70,130
2011,Leeds 066D,E01011599,1099,827,272,140,47,85
2011,Leeds 067B,E01011287,1013,748,265,156,33,76
2011,Leeds 067G,E01032499,1306,995,311,173,56,82
2011,Leeds 067H,E01032500,899,695,204,65,26,113
2011,Leeds 067I,E01032606,1492,1144,348,163,55,130
2011,Leeds 067J,E01032607,818,623,195,83,26,86
2011,Leeds 067K,E01032608,893,714,179,50,32,97
2011,Leeds 068A,E01011608,1009,717,292,158,26,108
2011,Leeds 068B,E01011609,1056,747,309,131,39,139
2011,Leeds 068C,E01011610,1067,790,277,172,41,64
2011,Leeds 068D,E01011611,950,655,295,121,42,132
2011,Leeds 068E,E01011614,1394,1079,315,199,28,88
2011,Leeds 069A,E01011413,1134,873,261,153,45,63
2011,Leeds 069B,E01011415,1200,913,287,177,32,78
2011,Leeds 069C,E01011416,1077,818,259,149,37,73
2011,Leeds 069D,E01011417,1078,708,370,265,26,79
2011,Leeds 069E,E01011420,940,561,379,292,25,62
2011,Leeds 070A,E01011615,1094,831,263,123,45,95
2011,Leeds 070B,E01011617,1119,743,376,129,40,207
2011,Leeds 070C,E01011618,1144,831,313,99,56,158
2011,Leeds 070D,E01011621,1025,657,368,123,55,190
2011,Leeds 071A,E01011284,1405,1097,308,83,54,171
2011,Leeds 071B,E01011292,1200,771,429,155,50,224
2011,Leeds 071C,E01011293,1247,841,406,109,70,227
2011,Leeds 071D,E01011294,1203,547,656,79,34,543
2011,Leeds 071E,E01011363,1116,728,388,118,52,218
2011,Leeds 072A,E01011616,1027,619,408,163,65,180
2011,Leeds 072B,E01011620,872,542,330,112,38,180
2011,Leeds 072C,E01011622,1136,708,428,104,74,250
2011,Leeds 072D,E01011624,1183,708,475,133,85,257
2011,Leeds 073A,E01011411,1160,902,258,157,47,54
2011,Leeds 073B,E01011414,1122,835,287,204,40,43
2011,Leeds 073C,E01011418,1124,884,240,145,34,61
2011,Leeds 073D,E01011419,952,683,269,195,22,52
2011,Leeds 074A,E01011396,1360,995,365,172,108,85
2011,Leeds 074B,E01011399,1064,757,307,185,46,76
2011,Leeds 074C,E01011400,1048,732,316,198,43,75
2011,Leeds 074D,E01011403,913,565,348,269,37,42
2011,Leeds 075B,E01011623,1076,738,338,82,45,211
2011,Leeds 075C,E01011625,1082,757,325,100,49,176
2011,Leeds 075D,E01011626,1375,942,433,130,91,212
2011,Leeds 075E,E01033021,942,640,302,121,47,134
2011,Leeds 075F,E01033033,1486,1091,395,58,276,61
2011,Leeds 075G,E01033034,998,894,104,9,70,25
2011,Leeds 076A,E01011602,1063,780,283,189,22,72
2011,Leeds 076B,E01011603,1116,841,275,154,68,53
2011,Leeds 076C,E01011605,1092,786,306,218,38,50
2011,Leeds 076D,E01011606,1140,810,330,164,48,118
2011,Leeds 076E,E01011613,914,684,230,97,31,102
2011,Leeds 077A,E01011397,1132,855,277,172,48,57
2011,Leeds 077B,E01011398,990,760,230,152,34,44
2011,Leeds 077C,E01011401,1094,799,295,218,24,53
2011,Leeds 077D,E01011404,980,722,258,167,29,62
2011,Leeds 077E,E01011405,1060,624,436,351,26,59
2011,Leeds 078A,E01011725,1059,705,354,92,61,201
2011,Leeds 078B,E01011729,1149,850,299,92,44,163
2011,Leeds 078C,E01011730,1097,815,282,88,44,150
2011,Leeds 078D,E01011735,1169,769,400,151,61,188
2011,Leeds 079A,E01011600,1138,878,260,163,27,70
2011,Leeds 079B,E01011601,1083,810,273,113,35,125
2011,Leeds 079C,E01011604,981,762,219,129,37,53
2011,Leeds 079D,E01011607,1184,891,293,158,23,112
2011,Leeds 079E,E01011612,863,565,298,213,9,76
2011,Leeds 080A,E01011726,1037,750,287,108,45,134
2011,Leeds 080B,E01011727,1158,905,253,145,31,77
2011,Leeds 080C,E01011728,1018,710,308,202,42,64
2011,Leeds 080D,E01011739,1127,759,368,158,51,159
2011,Leeds 081A,E01011362,1431,1070,361,101,49,211
2011,Leeds 081B,E01011731,1079,785,294,200,31,63
2011,Leeds 081C,E01011732,1355,1029,326,182,37,107
2011,Leeds 081D,E01011733,1100,839,261,166,30,65
2011,Leeds 082A,E01011366,1159,755,404,108,64,232
2011,Leeds 082C,E01011368,970,633,337,66,49,222
2011,Leeds 082D,E01011370,1270,909,361,90,70,201
2011,Leeds 082E,E01033013,993,716,277,84,81,112
2011,Leeds 082F,E01033032,1164,975,189,41,66,82
2011,Leeds 083A,E01011734,1737,1416,321,181,45,95
2011,Leeds 083B,E01011736,1126,846,280,178,32,70
2011,Leeds 083C,E01011737,1156,828,328,137,42,149
2011,Leeds 083D,E01011738,1094,808,286,179,34,73
2011,Leeds 085A,E01011364,1216,785,431,129,80,222
2011,Leeds 085B,E01011371,997,546,451,204,47,200
2011,Leeds 085C,E01011373,965,608,357,82,48,227
2011,Leeds 085D,E01011374,933,693,240,67,31,142
2011,Leeds 086A,E01011312,1101,733,368,57,59,252
2011,Leeds 086B,E01011316,1196,829,367,56,39,272
2011,Leeds 086C,E01011372,913,558,355,57,66,232
2011,Leeds 086D,E01011375,1239,789,450,63,95,292
2011,Leeds 087A,E01011390,1039,724,315,187,35,93
2011,Leeds 087B,E01011391,1205,737,468,329,47,92
2011,Leeds 087C,E01011392,1101,724,377,269,29,79
2011,Leeds 087D,E01011402,1271,846,425,322,25,78
2011,Leeds 088A,E01011298,1106,803,303,164,25,114
2011,Leeds 088B,E01011299,1655,1263,392,233,47,112
2011,Leeds 088C,E01011302,1106,718,388,302,25,61
2011,Leeds 088D,E01011303,823,584,239,165,17,57
2011,Leeds 089A,E01011300,1032,723,309,164,41,104
2011,Leeds 089B,E01011301,1027,753,274,191,21,62
2011,Leeds 089C,E01011304,1115,813,302,144,31,127
2011,Leeds 089D,E01011305,1130,872,258,134,37,87
2011,Leeds 089E,E01011306,1033,752,281,188,35,58
2011,Leeds 090A,E01011315,1125,829,296,136,42,118
2011,Leeds 090B,E01011317,1195,790,405,141,55,209
2011,Leeds 090C,E01011318,1039,665,374,109,57,208
2011,Leeds 090D,E01011321,1066,723,343,104,62,177
2011,Leeds 090E,E01011369,1100,787,313,169,23,121
2011,Leeds 091A,E01011313,1125,870,255,90,46,119
2011,Leeds 091B,E01011314,1095,863,232,96,39,97
2011,Leeds 091C,E01011319,1081,769,312,115,39,158
2011,Leeds 091D,E01011320,1212,871,341,167,58,116
2011,Leeds 091E,E01011322,1115,774,341,169,42,130
2011,Leeds 092A,E01011471,1011,663,348,132,51,165
2011,Leeds 092B,E01011472,1043,663,380,129,51,200
2011,Leeds 092C,E01011473,1006,615,391,93,68,230
2011,Leeds 092D,E01011474,1035,660,375,135,50,190
2011,Leeds 093A,E01011518,1648,1325,323,141,56,126
2011,Leeds 093B,E01011524,960,719,241,167,31,43
2011,Leeds 093C,E01011526,984,817,167,104,27,36
2011,Leeds 093D,E01011531,1072,700,372,287,29,56
2011,Leeds 094A,E01011466,1070,722,348,157,42,149
2011,Leeds 094B,E01011469,1128,814,314,164,35,115
2011,Leeds 094C,E01011475,1088,792,296,89,44,163
2011,Leeds 094D,E01011476,814,555,259,103,33,123
2011,Leeds 095A,E01011519,1065,756,309,148,31,130
2011,Leeds 095B,E01011522,1061,788,273,215,21,37
2011,Leeds 095C,E01011525,1181,917,264,170,24,70
2011,Leeds 095D,E01011528,1191,971,220,120,33,67
2011,Leeds 095E,E01011532,1123,803,320,159,37,124
2011,Leeds 096A,E01011520,1100,800,300,219,20,61
2011,Leeds 096B,E01011521,1505,1136,369,248,31,90
2011,Leeds 096C,E01011523,1248,918,330,207,27,96
2011,Leeds 096D,E01011527,1359,929,430,306,37,87
2011,Leeds 096E,E01011529,1029,742,287,163,24,100
2011,Leeds 097B,E01011635,1149,835,314,216,42,56
2011,Leeds 097C,E01011637,1326,1017,309,166,49,94
2011,Leeds 097D,E01011638,1051,783,268,185,32,51
2011,Leeds 097F,E01032487,700,438,262,139,26,97
2011,Leeds 097G,E01032488,1353,965,388,250,40,98
2011,Leeds 098A,E01011627,1008,682,326,173,37,116
2011,Leeds 098B,E01011628,961,660,301,220,30,51
2011,Leeds 098C,E01011629,964,696,268,159,30,79
2011,Leeds 098D,E01011632,903,610,293,123,37,133
2011,Leeds 098E,E01011633,1096,795,301,197,23,81
2011,Leeds 099A,E01011490,1962,1618,344,153,46,145
2011,Leeds 099C,E01011502,931,660,271,121,32,118
2011,Leeds 099E,E01032497,1023,706,317,113,35,169
2011,Leeds 099F,E01032498,1115,740,375,233,36,106
2011,Leeds 100A,E01011496,1134,961,173,84,25,64
2011,Leeds 100B,E01011630,1585,1267,318,191,34,93
2011,Leeds 100C,E01011634,1083,714,369,222,39,108
2011,Leeds 100D,E01011636,1161,800,361,233,42,86
2011,Leeds 100E,E01011639,1066,695,371,182,40,149
2011,Leeds 101A,E01011491,956,633,323,131,38,154
2011,Leeds 101B,E01011492,903,544,359,117,52,190
2011,Leeds 101C,E01011493,1054,677,377,124,56,197
2011,Leeds 101D,E01011494,923,626,297,107,42,148
2011,Leeds 101E,E01011497,1113,702,411,127,51,233
2011,Leeds 102B,E01011540,1009,650,359,153,34,172
2011,Leeds 102F,E01032489,1523,1238,285,124,35,126
2011,Leeds 102G,E01032490,1048,864,184,101,26,57
2011,Leeds 102H,E01032491,931,775,156,98,18,40
2011,Leeds 102I,E01032492,1512,1078,434,154,41,239
2011,Leeds 103A,E01011307,1094,742,352,175,48,129
2011,Leeds 103B,E01011308,1078,726,352,239,35,78
2011,Leeds 103C,E01011393,1199,865,334,202,42,90
2011,Leeds 103D,E01011394,892,613,279,177,28,74
2011,Leeds 103E,E01011395,860,695,165,71,19,75
2011,Leeds 104A,E01011533,1006,754,252,144,21,87
2011,Leeds 104B,E01011541,1270,938,332,208,19,105
2011,Leeds 104C,E01011545,1066,836,230,129,23,78
2011,Leeds 104D,E01011547,1326,982,344,160,37,147
2011,Leeds 105C,E01011499,1919,1550,369,114,66,189
2011,Leeds 105D,E01011500,1172,846,326,209,33,84
2011,Leeds 105E,E01032495,1722,1408,314,95,62,157
2011,Leeds 105F,E01032496,1528,1220,308,172,43,93
2011,Leeds 106A,E01011530,1105,843,262,190,27,45
2011,Leeds 106B,E01011534,1058,811,247,142,24,81
2011,Leeds 106C,E01011546,1251,946,305,160,34,111
2011,Leeds 106D,E01011548,1039,758,281,182,34,65
2011,Leeds 106E,E01011550,1045,801,244,141,42,61
2011,Leeds 107A,E01011537,1549,1030,519,313,44,162
2011,Leeds 107B,E01011538,1086,743,343,178,31,134
2011,Leeds 107C,E01011551,1190,972,218,104,40,74
2011,Leeds 107D,E01011552,1008,682,326,122,38,166
2011,Leeds 108A,E01011535,1227,903,324,225,28,71
2011,Leeds 108B,E01011536,1185,848,337,210,44,83
2011,Leeds 108C,E01011549,1179,987,192,73,51,68
2011,Leeds 108D,E01011553,1112,845,267,161,41,65
2011,Leeds 109A,E01011685,1815,1298,517,107,351,59
2011,Leeds 109B,E01011687,1094,816,278,135,67,76
2011,Leeds 109C,E01011690,1059,777,282,136,102,44
2011,Leeds 109D,E01011692,1134,873,261,88,117,56
2011,Leeds 109E,E01011693,1359,1069,290,71,141,78
2011,Leeds 109F,E01011694,1492,1030,462,78,322,62
2011,Leeds 109G,E01032876,2393,1031,1362,126,1190,46
2011,Leeds 110A,E01011442,1550,808,742,29,657,56
2011,Leeds 110B,E01011443,1310,562,748,26,665,57
2011,Leeds 110C,E01011444,1770,739,1031,14,944,73
2011,Leeds 110D,E01011451,1963,937,1026,55,930,41
2011,Leeds 110E,E01011668,1511,760,751,29,658,64
2011,Leeds 110F,E01011669,1337,849,488,19,420,49
2011,Leeds 110G,E01032946,2193,1091,1102,80,964,58
2011,Leeds 111A,E01033008,1079,864,215,6,179,30
2011,Leeds 111B,E01033010,2778,1237,1541,11,1467,63
2011,Leeds 111C,E01033011,1351,1082,269,11,225,33
2011,Leeds 111D,E01033015,1133,997,136,6,107,23
2011,Leeds 111E,E01033016,994,881,113,15,73,25
2011,Leeds 112A,E01011467,1067,732,335,125,34,176
2011,Leeds 112B,E01011468,1096,651,445,158,59,228
2011,Leeds 112C,E01011470,968,693,275,139,32,104
2011,Leeds 112D,E01033018,1104,974,130,3,94,33
2011,Leeds 112E,E01033019,1663,1205,458,2,425,31
2011,Wakefield 001A,E01011740,1059,653,406,147,39,220
2011,Wakefield 001B,E01011741,1115,745,370,236,33,101
2011,Wakefield 001C,E01011742,1139,716,423,164,45,214
2011,Wakefield 001D,E01011745,1185,691,494,137,43,314
2011,Wakefield 001E,E01011746,1073,565,508,133,37,338
2011,Wakefield 002A,E01011752,1185,866,319,144,41,134
2011,Wakefield 002B,E01011753,1047,726,321,176,30,115
2011,Wakefield 002C,E01011756,1089,611,478,256,28,194
2011,Wakefield 002D,E01011760,1308,988,320,148,36,136
2011,Wakefield 002E,E01011762,1219,891,328,175,24,129
2011,Wakefield 003A,E01011743,1148,809,339,259,26,54
2011,Wakefield 003B,E01011744,1197,877,320,205,29,86
2011,Wakefield 003C,E01011747,1155,743,412,143,30,239
2011,Wakefield 003D,E01011750,1044,596,448,130,35,283
2011,Wakefield 003E,E01011754,1058,649,409,214,35,160
2011,Wakefield 004A,E01011757,1328,957,371,213,33,125
2011,Wakefield 004B,E01011759,1451,948,503,207,55,241
2011,Wakefield 004C,E01011761,1411,985,426,243,39,144
2011,Wakefield 004D,E01011763,1041,697,344,173,28,143
2011,Wakefield 004E,E01011764,1101,721,380,163,31,186
2011,Wakefield 005A,E01011748,1257,870,387,231,38,118
2011,Wakefield 005B,E01011749,1661,1300,361,159,36,166
2011,Wakefield 005C,E01011751,1020,772,248,129,37,82
2011,Wakefield 005D,E01011755,1286,973,313,191,30,92
2011,Wakefield 006A,E01011873,1222,998,224,133,36,55
2011,Wakefield 006B,E01011877,1194,804,390,189,33,168
2011,Wakefield 006C,E01011894,1071,816,255,155,40,60
2011,Wakefield 006D,E01011895,1138,864,274,126,59,89
2011,Wakefield 007A,E01011875,1020,729,291,156,38,97
2011,Wakefield 007B,E01011876,1025,710,315,158,43,114
2011,Wakefield 007C,E01011878,1227,923,304,167,48,89
2011,Wakefield 007D,E01011880,1160,883,277,187,26,64
2011,Wakefield 008A,E01011881,1124,774,350,229,23,98
2011,Wakefield 008B,E01011887,902,655,247,161,39,47
2011,Wakefield 008C,E01011893,1080,792,288,178,46,64
2011,Wakefield 008D,E01011896,1006,688,318,186,41,91
2011,Wakefield 008E,E01011897,1005,655,350,188,36,126
2011,Wakefield 009A,E01011874,1232,854,378,260,39,79
2011,Wakefield 009B,E01011879,1123,837,286,175,35,76
2011,Wakefield 009C,E01011882,1119,741,378,263,44,71
2011,Wakefield 009D,E01011883,1044,718,326,196,43,87
2011,Wakefield 010A,E01011805,1066,709,357,171,27,159
2011,Wakefield 010B,E01011807,1066,767,299,139,26,134
2011,Wakefield 010C,E01011808,1267,863,404,235,43,126
2011,Wakefield 010D,E01011810,1148,835,313,149,41,123
2011,Wakefield 011A,E01011803,1011,654,357,132,41,184
2011,Wakefield 011B,E01011804,1188,787,401,206,35,160
2011,Wakefield 011C,E01011806,1178,822,356,176,32,148
2011,Wakefield 011D,E01011809,1102,698,404,215,40,149
2011,Wakefield 011E,E01011811,1130,695,435,151,45,239
2011,Wakefield 012A,E01011835,1161,800,361,263,23,75
2011,Wakefield 012B,E01011836,1076,843,233,119,28,86
2011,Wakefield 012C,E01011839,1208,779,429,247,41,141
2011,Wakefield 012D,E01011843,1163,795,368,162,37,169
2011,Wakefield 012E,E01011844,1408,1140,268,129,38,101
2011,Wakefield 013A,E01011758,1036,723,313,145,32,136
2011,Wakefield 013B,E01011812,1960,1527,433,233,84,116
2011,Wakefield 013C,E01011820,1104,853,251,133,23,95
2011,Wakefield 013D,E01011821,981,643,338,186,42,110
2011,Wakefield 014A,E01011885,1092,731,361,234,33,94
2011,Wakefield 014B,E01011886,1122,817,305,199,31,75
2011,Wakefield 014C,E01011888,1108,784,324,228,37,59
2011,Wakefield 014D,E01011890,963,705,258,154,37,67
2011,Wakefield 014E,E01011891,1095,739,356,209,28,119
2011,Wakefield 015A,E01011834,1112,795,317,138,37,142
2011,Wakefield 015B,E01011837,1131,745,386,179,42,165
2011,Wakefield 015C,E01011838,1529,1088,441,178,33,230
2011,Wakefield 015D,E01011841,1153,769,384,239,36,109
2011,Wakefield 015E,E01011842,1006,581,425,177,33,215
2011,Wakefield 016A,E01011813,1098,730,368,167,43,158
2011,Wakefield 016B,E01011814,1288,911,377,128,38,211
2011,Wakefield 016C,E01011815,1122,714,408,195,48,165
2011,Wakefield 016D,E01011816,985,612,373,186,26,161
2011,Wakefield 016E,E01011819,1238,971,267,146,29,92
2011,Wakefield 016F,E01011822,1056,739,317,173,42,102
2011,Wakefield 017A,E01011884,1753,1385,368,187,64,117
2011,Wakefield 017B,E01011912,1171,787,384,102,57,225
2011,Wakefield 017C,E01011913,1189,747,442,107,91,244
2011,Wakefield 017D,E01011916,1667,1163,504,189,51,264
2011,Wakefield 018A,E01011840,1108,733,375,169,27,179
2011,Wakefield 018B,E01011850,1073,665,408,173,42,193
2011,Wakefield 018C,E01011852,1089,699,390,161,38,191
2011,Wakefield 018D,E01011853,1019,672,347,162,55,130
2011,Wakefield 019A,E01011920,1947,1146,801,143,84,574
2011,Wakefield 019B,E01011923,1262,948,314,187,53,74
2011,Wakefield 019C,E01011924,1162,831,331,166,47,118
2011,Wakefield 019D,E01011925,1151,772,379,138,47,194
2011,Wakefield 020A,E01011909,1078,676,402,221,46,135
2011,Wakefield 020B,E01011910,1043,614,429,189,34,206
2011,Wakefield 020C,E01011911,1047,682,365,118,37,210
2011,Wakefield 020D,E01011914,1117,733,384,113,60,211
2011,Wakefield 020E,E01011915,1175,853,322,83,57,182
2011,Wakefield 021A,E01011823,1046,777,269,170,24,75
2011,Wakefield 021B,E01011824,1042,750,292,118,39,135
2011,Wakefield 021C,E01011825,1321,1060,261,161,29,71
2011,Wakefield 021D,E01011826,1026,749,277,198,36,43
2011,Wakefield 021E,E01011827,903,589,314,227,28,59
2011,Wakefield 021F,E01011828,1079,814,265,171,18,76
2011,Wakefield 022A,E01011889,946,746,200,116,26,58
2011,Wakefield 022B,E01011892,1291,942,349,179,46,124
2011,Wakefield 022C,E01011919,1373,1008,365,131,51,183
2011,Wakefield 022D,E01011921,1081,765,316,195,40,81
2011,Wakefield 022E,E01011926,1163,763,400,116,52,232
2011,Wakefield 022F,E01011927,953,659,294,127,36,131
2011,Wakefield 023A,E01011845,1039,637,402,327,19,56
2011,Wakefield 023B,E01011846,1003,707,296,187,32,77
2011,Wakefield 023C,E01011847,1066,767,299,210,37,52
2011,Wakefield 023D,E01011848,1016,657,359,260,36,63
2011,Wakefield 023E,E01011851,1043,712,331,173,27,131
2011,Wakefield 024A,E01011775,2155,1692,463,227,70,166
2011,Wakefield 024B,E01011776,1138,724,414,181,42,191
2011,Wakefield 024C,E01011777,1000,660,340,203,31,106
2011,Wakefield 024D,E01011778,1169,783,386,214,28,144
2011,Wakefield 024E,E01011817,975,670,305,125,35,145
2011,Wakefield 024F,E01011818,1013,694,319,185,31,103
2011,Wakefield 025A,E01011829,1078,836,242,140,39,63
2011,Wakefield 025B,E01011830,894,585,309,226,24,59
2011,Wakefield 025C,E01011831,1305,948,357,191,35,131
2011,Wakefield 025D,E01011832,1038,710,328,165,37,126
2011,Wakefield 025E,E01011833,1162,842,320,190,33,97
2011,Wakefield 026A,E01011899,1029,646,383,103,75,205
2011,Wakefield 026B,E01011900,1089,724,365,168,42,155
2011,Wakefield 026C,E01011901,1091,642,449,136,78,235
2011,Wakefield 026D,E01011904,922,567,355,97,40,218
2011,Wakefield 026E,E01011918,1066,679,387,139,46,202
2011,Wakefield 026F,E01011922,1051,641,410,130,54,226
2011,Wakefield 027A,E01011779,1113,711,402,197,49,156
2011,Wakefield 027B,E01011780,1258,653,605,249,48,308
2011,Wakefield 027C,E01011781,1262,841,421,208,36,177
2011,Wakefield 027D,E01011782,1107,770,337,215,35,87
2011,Wakefield 027E,E01011783,1026,689,337,162,34,141
2011,Wakefield 028A,E01011902,1061,718,343,222,29,92
2011,Wakefield 028B,E01011903,931,609,322,190,32,100
2011,Wakefield 028C,E01011905,1153,811,342,240,45,57
2011,Wakefield 028D,E01011907,1364,974,390,167,42,181
2011,Wakefield 029A,E01011793,1234,823,411,269,37,105
2011,Wakefield 029B,E01011794,1051,750,301,163,34,104
2011,Wakefield 029C,E01011795,953,662,291,182,20,89
2011,Wakefield 029D,E01011796,1082,816,266,162,26,78
2011,Wakefield 029E,E01011799,1094,713,381,245,41,95
2011,Wakefield 029F,E01011800,1218,916,302,189,33,80
2011,Wakefield 030A,E01011898,1162,899,263,100,36,127
2011,Wakefield 030B,E01011906,1074,645,429,124,46,259
2011,Wakefield 030C,E01011908,1638,1185,453,163,77,213
2011,Wakefield 030D,E01011917,1184,783,401,98,42,261
2011,Wakefield 030E,E01011944,1045,778,267,104,44,119
2011,Wakefield 031A,E01011797,1238,934,304,224,38,42
2011,Wakefield 031B,E01011798,1015,757,258,147,28,83
2011,Wakefield 031C,E01011801,1151,852,299,152,35,112
2011,Wakefield 031D,E01011802,1106,791,315,201,33,81
2011,Wakefield 032A,E01011765,1170,833,337,193,49,95
2011,Wakefield 032B,E01011766,1113,805,308,158,48,102
2011,Wakefield 032C,E01011773,1170,781,389,263,46,80
2011,Wakefield 032D,E01011774,1054,711,343,210,39,94
2011,Wakefield 033A,E01011939,1077,725,352,261,45,46
2011,Wakefield 033B,E01011945,1052,705,347,222,47,78
2011,Wakefield 033C,E01011947,1189,716,473,360,51,62
2011,Wakefield 033D,E01011948,1181,805,376,271,44,61
2011,Wakefield 034A,E01011767,1308,888,420,285,49,86
2011,Wakefield 034B,E01011768,1046,705,341,226,42,73
2011,Wakefield 034C,E01011769,1645,1281,364,194,47,123
2011,Wakefield 034D,E01011770,1384,934,450,220,85,145
2011,Wakefield 034E,E01011849,1174,723,451,353,29,69
2011,Wakefield 034F,E01011857,1249,804,445,323,40,82
2011,Wakefield 035A,E01011928,1019,680,339,239,25,75
2011,Wakefield 035B,E01011931,1120,795,325,219,26,80
2011,Wakefield 035C,E01011932,1102,796,306,213,41,52
2011,Wakefield 035D,E01011938,1347,802,545,164,35,346
2011,Wakefield 036A,E01011929,1268,873,395,297,34,64
2011,Wakefield 036B,E01011930,1286,979,307,202,33,72
2011,Wakefield 036C,E01011933,1197,864,333,192,49,92
2011,Wakefield 036D,E01011937,1095,808,287,194,37,56
2011,Wakefield 037A,E01011934,1145,831,314,190,63,61
2011,Wakefield 037B,E01011936,1054,712,342,175,31,136
2011,Wakefield 037C,E01011940,1064,743,321,131,50,140
2011,Wakefield 037D,E01011943,1180,839,341,137,34,170
2011,Wakefield 038A,E01011935,1358,1036,322,196,48,78
2011,Wakefield 038B,E01011941,1048,686,362,234,43,85
2011,Wakefield 038C,E01011942,920,585,335,252,27,56
2011,Wakefield 038D,E01011946,1142,775,367,244,58,65
2011,Wakefield 039A,E01011785,1134,733,401,146,49,206
2011,Wakefield 039B,E01011789,907,513,394,139,45,210
2011,Wakefield 039C,E01011791,1067,619,448,197,44,207
2011,Wakefield 039D,E01011792,1065,509,556,187,56,313
2011,Wakefield 040A,E01011771,908,504,404,212,38,154
2011,Wakefield 040B,E01011772,1218,850,368,177,45,146
2011,Wakefield 040C,E01011784,1338,855,483,253,42,188
2011,Wakefield 040D,E01011786,1173,801,372,122,53,197
2011,Wakefield 041A,E01011854,910,596,314,117,30,167
2011,Wakefield 041B,E01011855,1170,817,353,192,33,128
2011,Wakefield 041C,E01011856,1082,677,405,199,35,171
2011,Wakefield 041D,E01011858,1128,803,325,151,40,134
2011,Wakefield 042A,E01011787,1294,875,419,228,50,141
2011,Wakefield 042B,E01011788,1307,864,443,284,39,120
2011,Wakefield 042C,E01011790,1227,792,435,209,39,187
2011,Wakefield 042D,E01011865,1199,693,506,230,47,229
2011,Wakefield 042E,E01011867,1219,796,423,182,40,201
2011,Wakefield 043A,E01011859,1018,566,452,232,48,172
2011,Wakefield 043B,E01011869,1079,740,339,134,36,169
2011,Wakefield 043C,E01011870,1115,684,431,277,30,124
2011,Wakefield 043D,E01011871,1169,824,345,136,44,165
2011,Wakefield 044A,E01011860,1124,753,371,196,57,118
2011,Wakefield 044B,E01011861,1459,1078,381,199,45,137
2011,Wakefield 044C,E01011862,1052,675,377,148,48,181
2011,Wakefield 044D,E01011863,936,535,401,142,41,218
2011,Wakefield 045A,E01011864,1169,658,511,172,66,273
2011,Wakefield 045B,E01011866,1136,664,472,205,55,212
2011,Wakefield 045C,E01011868,1348,849,499,194,51,254
2011,Wakefield 045D,E01011872,1132,740,392,172,49,171
2011,Derby 001A,E01013461,1190,819,371,255,62,54
2011,Derby 001B,E01013462,1041,770,271,159,37,75
2011,Derby 001C,E01013463,1110,797,313,211,47,55
2011,Derby 001D,E01013464,972,657,315,233,30,52
2011,Derby 002A,E01013465,1098,765,333,237,48,48
2011,Derby 002B,E01013466,1075,754,321,232,41,48
2011,Derby 002C,E01013467,943,620,323,243,34,46
2011,Derby 002D,E01013468,1082,744,338,239,45,54
2011,Derby 002E,E01013469,842,504,338,254,36,48
2011,Derby 003A,E01013574,1053,783,270,171,42,57
2011,Derby 003B,E01013575,1068,856,212,112,24,76
2011,Derby 003C,E01013576,1144,920,224,118,43,63
2011,Derby 003D,E01013577,1168,974,194,99,40,55
2011,Derby 003E,E01013578,1047,890,157,71,36,50
2011,Derby 003F,E01013579,1089,861,228,148,29,51
2011,Derby 003G,E01013580,1144,940,204,127,20,57
2011,Derby 004A,E01013530,1082,823,259,101,47,111
2011,Derby 004B,E01013531,964,695,269,110,36,123
2011,Derby 004C,E01013532,1005,674,331,144,46,141
2011,Derby 004D,E01013581,1037,718,319,116,50,153
2011,Derby 005A,E01013526,1180,832,348,218,50,80
2011,Derby 005B,E01013527,1045,760,285,178,42,65
2011,Derby 005C,E01013528,1199,850,349,164,92,93
2011,Derby 005D,E01013529,1679,1265,414,149,177,88
2011,Derby 006A,E01013505,1095,841,254,124,37,93
2011,Derby 006B,E01013506,1127,715,412,278,28,106
2011,Derby 006C,E01013513,896,593,303,137,41,125
2011,Derby 006D,E01013534,1156,862,294,143,33,118
2011,Derby 006E,E01013582,1133,798,335,190,27,118
2011,Derby 007A,E01013533,1116,659,457,132,47,278
2011,Derby 007B,E01013535,1005,656,349,62,63,224
2011,Derby 007C,E01013536,1139,718,421,100,51,270
2011,Derby 007D,E01013537,1179,790,389,200,47,142
2011,Derby 007E,E01013538,1122,775,347,144,38,165
2011,Derby 008A,E01013522,1431,894,537,166,202,169
2011,Derby 008B,E01013523,1310,910,400,127,145,128
2011,Derby 008C,E01013524,2373,1288,1085,67,910,108
2011,Derby 008D,E01013525,1669,1318,351,143,72,136
2011,Derby 009A,E01013548,1036,724,312,136,51,125
2011,Derby 009B,E01013549,966,682,284,124,36,124
2011,Derby 009C,E01013552,1093,706,387,165,68,154
2011,Derby 009D,E01013553,1003,699,304,124,55,125
2011,Derby 009E,E01013555,1054,776,278,107,64,107
2011,Derby 010A,E01013592,1065,759,306,206,33,67
2011,Derby 010B,E01013594,985,613,372,293,23,56
2011,Derby 010C,E01013596,1138,763,375,277,35,63
2011,Derby 010D,E01013599,1078,707,371,280,37,54
2011,Derby 011A,E01013547,1499,997,502,99,270,133
2011,Derby 011B,E01013550,918,624,294,108,48,138
2011,Derby 011C,E01013551,1669,1109,560,47,437,76
2011,Derby 011D,E01013554,1349,911,438,77,205,156
2011,Derby 012A,E01013507,1129,817,312,183,43,86
2011,Derby 012B,E01013508,869,597,272,109,36,127
2011,Derby 012C,E01013509,1243,891,352,205,37,110
2011,Derby 012D,E01013510,1023,709,314,133,39,142
2011,Derby 012E,E01013511,1151,797,354,234,39,81
2011,Derby 012F,E01013512,1082,732,350,148,53,149
2011,Derby 013A,E01013453,1984,1383,601,95,285,221
2011,Derby 013B,E01013454,1236,776,460,70,259,131
2011,Derby 013C,E01013456,1628,1091,537,124,132,281
2011,Derby 013D,E01013457,1438,1065,373,105,103,165
2011,Derby 013E,E01013460,1751,1240,511,45,354,112
2011,Derby 013F,E01013479,1811,1258,553,67,224,262
2011,Derby 014A,E01013593,1050,731,319,248,23,48
2011,Derby 014B,E01013595,1610,1191,419,199,56,164
2011,Derby 014C,E01013597,1038,680,358,205,34,119
2011,Derby 014D,E01013598,1109,753,356,166,47,143
2011,Derby 015A,E01013556,1068,795,273,194,29,50
2011,Derby 015B,E01013557,950,608,342,257,28,57
2011,Derby 015C,E01013558,1415,1007,408,226,72,110
2011,Derby 015D,E01013559,1021,724,297,200,40,57
2011,Derby 015E,E01013564,1484,1095,389,259,57,73
2011,Derby 016A,E01013480,1660,1008,652,124,163,365
2011,Derby 016B,E01013483,1487,957,530,102,129,299
2011,Derby 016C,E01013485,1371,862,509,72,94,343
2011,Derby 016D,E01013565,1108,721,387,76,96,215
2011,Derby 016E,E01013566,1369,793,576,88,108,380
2011,Derby 017A,E01013455,1400,997,403,169,91,143
2011,Derby 017B,E01013458,1148,754,394,167,81,146
2011,Derby 017C,E01013542,1203,833,370,153,63,154
2011,Derby 017D,E01013546,1167,834,333,193,61,79
2011,Derby 018A,E01013481,1264,724,540,82,100,358
2011,Derby 018C,E01013484,1289,737,552,94,101,357
2011,Derby 018D,E01013486,1305,756,549,76,123,350
2011,Derby 018E,E01013487,1518,927,591,87,95,409
2011,Derby 018F,E01033166,873,571,302,82,35,185
2011,Derby 018G,E01033167,887,526,361,94,49,218
2011,Derby 019A,E01013540,1136,825,311,191,50,70
2011,Derby 019B,E01013560,1142,826,316,198,48,70
2011,Derby 019C,E01013561,1103,774,329,245,28,56
2011,Derby 019D,E01013562,905,593,312,223,32,57
2011,Derby 019E,E01013563,1076,807,269,176,38,55
2011,Derby 020A,E01013459,1329,800,529,148,135,246
2011,Derby 020B,E01013567,1360,856,504,72,116,316
2011,Derby 020C,E01013568,1400,877,523,105,113,305
2011,Derby 020D,E01013569,1041,664,377,115,53,209
2011,Derby 021A,E01013539,1738,1351,387,136,125,126
2011,Derby 021B,E01013541,1133,881,252,78,58,116
2011,Derby 021C,E01013543,1267,938,329,159,75,95
2011,Derby 021D,E01013544,1354,1001,353,209,55,89
2011,Derby 021E,E01013545,1162,796,366,188,56,122
2011,Derby 022A,E01013488,1142,786,356,201,78,77
2011,Derby 022B,E01013489,1106,740,366,239,41,86
2011,Derby 022C,E01013490,1104,791,313,182,55,76
2011,Derby 022D,E01013491,1114,765,349,162,70,117
2011,Derby 023A,E01013570,1325,801,524,97,123,304
2011,Derby 023B,E01013571,1220,785,435,119,73,243
2011,Derby 023C,E01013572,1161,796,365,174,43,148
2011,Derby 023D,E01013573,1421,938,483,90,77,316
2011,Derby 024A,E01013470,1027,722,305,164,27,114
2011,Derby 024B,E01013474,1110,774,336,177,25,134
2011,Derby 024C,E01013476,1165,907,258,172,19,67
2011,Derby 024E,E01033171,1078,822,256,114,47,95
2011,Derby 024F,E01033172,1242,971,271,57,65,149
2011,Derby 025A,E01013471,1361,1027,334,118,45,171
2011,Derby 025B,E01013473,1086,763,323,130,50,143
2011,Derby 025C,E01013475,1096,723,373,78,80,215
2011,Derby 025D,E01013477,1326,950,376,163,40,173
2011,Derby 025E,E01013502,1008,686,322,161,49,112
2011,Derby 025F,E01013503,1103,813,290,146,45,99
2011,Derby 026A,E01013472,1429,937,492,137,62,293
2011,Derby 026B,E01013497,1044,723,321,100,63,158
2011,Derby 026C,E01013504,1311,920,391,127,66,198
2011,Derby 026D,E01013583,1092,663,429,103,67,259
2011,Derby 026E,E01013590,1161,711,450,93,81,276
2011,Derby 026F,E01013591,1406,935,471,101,61,309
2011,Derby 027A,E01013492,1116,774,342,196,55,91
2011,Derby 027B,E01013493,1070,720,350,179,49,122
2011,Derby 027C,E01013494,1264,865,399,199,55,145
2011,Derby 027D,E01013495,1257,899,358,164,56,138
2011,Derby 028A,E01013496,1046,670,376,130,48,198
2011,Derby 028B,E01013498,1092,730,362,211,52,99
2011,Derby 028C,E01013499,995,632,363,183,34,146
2011,Derby 028D,E01013500,1239,799,440,279,38,123
2011,Derby 028E,E01013501,1038,702,336,212,35,89
2011,Derby 029A,E01013584,1205,759,446,89,82,275
2011,Derby 029B,E01013585,1201,803,398,102,65,231
2011,Derby 029C,E01013586,1042,692,350,73,55,222
2011,Derby 029D,E01013587,1134,798,336,179,48,109
2011,Derby 029E,E01013588,1100,727,373,159,39,175
2011,Derby 029F,E01013589,1098,774,324,166,46,112
2011,Derby 030B,E01013517,998,606,392,266,28,98
2011,Derby 030C,E01013518,1011,707,304,178,45,81
2011,Derby 030D,E01013521,966,583,383,176,40,167
2011,Derby 030E,E01033168,905,704,201,100,30,71
2011,Derby 030F,E01033169,1154,981,173,42,44,87
2011,Derby 030G,E01033170,889,668,221,144,25,52
2011,Derby 031A,E01013514,1179,907,272,164,37,71
2011,Derby 031B,E01013515,1262,920,342,155,69,118
2011,Derby 031C,E01013519,1113,888,225,62,48,115
2011,Derby 031D,E01013520,1133,847,286,193,44,49
2011,Leicester 001A,E01013615,1180,929,251,81,64,106
2011,Leicester 001B,E01013616,1179,914,265,88,47,130
2011,Leicester 001C,E01013618,1188,862,326,128,46,152
2011,Leicester 001D,E01013619,1195,750,445,99,98,248
2011,Leicester 002A,E01013733,1165,909,256,72,42,142
2011,Leicester 002B,E01013734,1140,753,387,192,55,140
2011,Leicester 002C,E01013735,1071,698,373,189,78,106
2011,Leicester 002D,E01013736,1230,923,307,152,41,114
2011,Leicester 002E,E01013737,1109,792,317,125,57,135
2011,Leicester 003A,E01013600,1242,785,457,115,82,260
2011,Leicester 003B,E01013601,1132,731,401,115,74,212
2011,Leicester 003C,E01013602,1294,877,417,118,65,234
2011,Leicester 003D,E01013603,1222,731,491,128,85,278
2011,Leicester 003E,E01013604,1133,724,409,109,65,235
2011,Leicester 003F,E01013605,1261,888,373,116,76,181
2011,Leicester 004A,E01013617,1951,1450,501,133,114,254
2011,Leicester 004B,E01013620,1194,726,468,85,106,277
2011,Leicester 004C,E01013621,1276,821,455,80,108,267
2011,Leicester 004D,E01013622,1187,772,415,129,69,217
2011,Leicester 004E,E01013623,1634,1235,399,157,88,154
2011,Leicester 005A,E01013732,1493,1020,473,147,97,229
2011,Leicester 005B,E01013739,1110,670,440,193,77,170
2011,Leicester 005C,E01013740,1142,726,416,198,77,141
2011,Leicester 005D,E01013741,1245,888,357,116,100,141
2011,Leicester 006A,E01013625,1406,849,557,119,151,287
2011,Leicester 006B,E01013628,1136,671,465,123,80,262
2011,Leicester 006C,E01013715,1044,642,402,149,93,160
2011,Leicester 006D,E01013716,1393,859,534,153,113,268
2011,Leicester 006E,E01013738,1165,781,384,153,81,150
2011,Leicester 007A,E01013624,1052,678,374,130,78,166
2011,Leicester 007B,E01013626,1372,857,515,125,111,279
2011,Leicester 007C,E01013627,1036,704,332,127,82,123
2011,Leicester 007D,E01013629,1286,852,434,108,100,226
2011,Leicester 007E,E01013630,1340,856,484,116,100,268
2011,Leicester 008A,E01013606,1224,848,376,185,67,124
2011,Leicester 008B,E01013607,2074,1455,619,195,207,217
2011,Leicester 008C,E01013680,1574,1213,361,156,70,135
2011,Leicester 008D,E01013685,1105,838,267,158,39,70
2011,Leicester 008E,E01013686,1379,993,386,218,82,86
2011,Leicester 009A,E01013696,1699,1195,504,163,127,214
2011,Leicester 009B,E01013697,1871,1306,565,203,126,236
2011,Leicester 009C,E01013699,1266,911,355,155,69,131
2011,Leicester 009E,E01032862,1363,1015,348,55,120,173
2011,Leicester 009F,E01032863,1242,963,279,47,95,137
2011,Leicester 009G,E01032865,1530,1172,358,93,105,160
2011,Leicester 010A,E01013713,1212,783,429,135,99,195
2011,Leicester 010B,E01013714,1306,835,471,157,97,217
2011,Leicester 010C,E01013717,1137,751,386,95,100,191
2011,Leicester 010D,E01013718,1183,729,454,123,90,241
2011,Leicester 010E,E01013719,1231,742,489,141,101,247
2011,Leicester 010F,E01013720,976,477,499,212,63,224
2011,Leicester 011A,E01013651,1193,729,464,120,82,262
2011,Leicester 011B,E01013652,1161,718,443,85,104,254
2011,Leicester 011C,E01013653,1321,810,511,136,88,287
2011,Leicester 011D,E01013655,1456,909,547,97,104,346
2011,Leicester 012A,E01013721,1104,690,414,199,66,149
2011,Leicester 012B,E01013723,891,564,327,92,61,174
2011,Leicester 012C,E01013725,887,537,350,100,50,200
2011,Leicester 012D,E01013726,1151,608,543,154,73,316
2011,Leicester 012E,E01013728,1059,670,389,79,99,211
2011,Leicester 013A,E01013694,1099,730,369,118,60,191
2011,Leicester 013B,E01013700,1059,736,323,151,39,133
2011,Leicester 013C,E01013770,975,628,347,173,57,117
2011,Leicester 013D,E01013771,1176,847,329,130,64,135
2011,Leicester 013E,E01013773,1033,700,333,146,59,128
2011,Leicester 016A,E01013681,1404,1081,323,56,72,195
2011,Leicester 016B,E01013682,1336,1035,301,68,50,183
2011,Leicester 016C,E01013683,1646,1251,395,85,98,212
2011,Leicester 016D,E01013684,1538,1121,417,72,127,218
2011,Leicester 017A,E01013654,1476,828,648,165,113,370
2011,Leicester 017B,E01013656,1335,829,506,96,114,296
2011,Leicester 017C,E01013657,1255,672,583,109,126,348
2011,Leicester 017D,E01013658,1345,851,494,78,106,310
2011,Leicester 017E,E01013659,1373,811,562,111,125,326
2011,Leicester 017F,E01013743,1224,687,537,116,118,303
2011,Leicester 017G,E01013745,1176,671,505,108,135,262
2011,Leicester 018A,E01013742,1302,720,582,118,123,341
2011,Leicester 018B,E01013744,1407,788,619,130,127,362
2011,Leicester 018C,E01013746,1356,720,636,152,94,390
2011,Leicester 018D,E01013748,1448,718,730,143,181,406
2011,Leicester 018E,E01013754,1201,625,576,97,120,359
2011,Leicester 018F,E01013755,1268,693,575,103,116,356
2011,Leicester 019A,E01013660,1273,872,401,86,92,223
2011,Leicester 019B,E01013661,1166,734,432,104,77,251
2011,Leicester 019C,E01013664,1352,869,483,121,78,284
2011,Leicester 019D,E01013665,1326,861,465,135,97,233
2011,Leicester 019E,E01013667,1079,670,409,135,86,188
2011,Leicester 019F,E01013668,1066,763,303,116,62,125
2011,Leicester 020A,E01013729,942,675,267,138,31,98
2011,Leicester 020B,E01013780,1110,845,265,130,60,75
2011,Leicester 020C,E01013783,1143,872,271,143,42,86
2011,Leicester 020D,E01013785,1083,806,277,154,49,74
2011,Leicester 020E,E01013786,1180,898,282,133,55,94
2011,Leicester 021A,E01013662,1320,861,459,123,104,232
2011,Leicester 021B,E01013663,1262,820,442,139,95,208
2011,Leicester 021C,E01013747,1324,815,509,112,130,267
2011,Leicester 021D,E01013749,1101,718,383,90,91,202
2011,Leicester 021E,E01013750,1049,631,418,85,100,233
2011,Leicester 021F,E01013758,1137,662,475,101,156,218
2011,Leicester 022A,E01013751,1383,716,667,112,212,343
2011,Leicester 022B,E01013752,1094,615,479,116,122,241
2011,Leicester 022C,E01013753,1188,683,505,82,124,299
2011,Leicester 022D,E01013760,1578,810,768,73,430,265
2011,Leicester 022E,E01013761,1341,723,618,89,187,342
2011,Leicester 022F,E01013762,1346,750,596,121,212,263
2011,Leicester 023A,E01013774,1506,1034,472,68,279,125
2011,Leicester 023B,E01013776,1483,994,489,53,289,147
2011,Leicester 023C,E01013778,2150,1224,926,68,643,215
2011,Leicester 023D,E01013779,1699,1200,499,48,324,127
2011,Leicester 023E,E01013781,1393,964,429,73,203,153
2011,Leicester 023F,E01013782,1114,863,251,88,72,91
2011,Leicester 023G,E01013784,1146,822,324,65,177,82
2011,Leicester 025A,E01013666,1134,771,363,194,70,99
2011,Leicester 025B,E01013669,1018,748,270,127,56,87
2011,Leicester 025C,E01013670,1286,883,403,197,65,141
2011,Leicester 025D,E01013671,1237,846,391,149,84,158
2011,Leicester 025E,E01013672,920,592,328,179,53,96
2011,Leicester 026A,E01013631,1038,704,334,96,47,191
2011,Leicester 026B,E01013632,1248,670,578,161,84,333
2011,Leicester 026C,E01013638,1127,648,479,131,90,258
2011,Leicester 026D,E01013640,1182,762,420,69,84,267
2011,Leicester 027A,E01013756,1430,881,549,111,208,230
2011,Leicester 027B,E01013757,1186,742,444,138,111,195
2011,Leicester 027C,E01013759,1370,909,461,145,120,196
2011,Leicester 027D,E01013763,1671,889,782,77,494,211
2011,Leicester 027E,E01013764,1199,762,437,136,121,180
2011,Leicester 027F,E01013765,1348,741,607,73,340,194
2011,Leicester 027G,E01013766,1307,817,490,132,150,208
2011,Leicester 028A,E01013633,1145,693,452,124,80,248
2011,Leicester 028B,E01013634,1066,659,407,167,63,177
2011,Leicester 028C,E01013637,1297,779,518,154,85,279
2011,Leicester 028D,E01013639,986,716,270,53,60,157
2011,Leicester 028E,E01013641,1267,944,323,67,113,143
2011,Leicester 029A,E01013635,1180,854,326,137,76,113
2011,Leicester 029B,E01013636,1069,755,314,166,61,87
2011,Leicester 029C,E01013775,1838,1280,558,51,360,147
2011,Leicester 029D,E01013777,1283,1008,275,71,75,129
2011,Leicester 030A,E01013642,1507,982,525,82,362,81
2011,Leicester 030B,E01013643,1567,938,629,64,515,50
2011,Leicester 030C,E01013649,1363,753,610,90,451,69
2011,Leicester 030D,E01013650,1639,989,650,63,557,30
2011,Leicester 030E,E01013702,1191,812,379,121,179,79
2011,Leicester 030F,E01013710,1090,809,281,105,75,101
2011,Leicester 030G,E01013711,1189,775,414,167,111,136
2011,Leicester 031A,E01013613,1256,952,304,89,62,153
2011,Leicester 031B,E01013614,1167,898,269,116,40,113
2011,Leicester 031C,E01013687,1273,956,317,59,94,164
2011,Leicester 031D,E01013688,1138,820,318,70,108,140
2011,Leicester 032A,E01013703,939,683,256,132,65,59
2011,Leicester 032B,E01013704,1047,809,238,125,48,65
2011,Leicester 032C,E01013706,1176,907,269,132,82,55
2011,Leicester 032D,E01013707,1120,841,279,132,79,68
2011,Leicester 032E,E01013712,1096,672,424,143,207,74
2011,Leicester 034A,E01013608,1131,839,292,161,40,91
2011,Leicester 034B,E01013609,1173,874,299,174,43,82
2011,Leicester 034C,E01013610,1216,845,371,138,54,179
2011,Leicester 034D,E01013611,1078,761,317,131,50,136
2011,Leicester 034E,E01013612,1090,814,276,132,56,88
2011,Leicester 035A,E01013678,1118,781,337,131,55,151
2011,Leicester 035B,E01013679,1015,644,371,76,88,207
2011,Leicester 035C,E01013691,1084,610,474,92,88,294
2011,Leicester 035D,E01013692,886,504,382,67,69,246
2011,Leicester 035E,E01013693,970,522,448,92,93,263
2011,Leicester 036A,E01013673,1018,663,355,112,55,188
2011,Leicester 036B,E01013674,1064,629,435,187,53,195
2011,Leicester 036C,E01013675,1128,780,348,117,59,172
2011,Leicester 036D,E01013676,1336,938,398,123,66,209
2011,Leicester 036E,E01013677,1094,736,358,138,64,156
2011,Leicester 037A,E01013695,992,641,351,116,61,174
2011,Leicester 037B,E01013698,1022,714,308,112,65,131
2011,Leicester 037C,E01013767,1060,726,334,136,67,131
2011,Leicester 037D,E01013768,1010,615,395,199,33,163
2011,Leicester 037E,E01013772,1050,720,330,93,59,178
2011,Leicester 037F,E01032597,953,585,368,132,51,185
2011,Leicester 038A,E01013689,1680,712,968,49,839,80
2011,Leicester 038B,E01013690,1203,820,383,102,112,169
2011,Leicester 038C,E01013705,1149,805,344,143,71,130
2011,Leicester 038D,E01013709,1132,841,291,141,43,107
2011,Leicester 038E,E01032599,1103,800,303,147,57,99
2011,Leicester 039A,E01013722,1091,653,438,150,78,210
2011,Leicester 039B,E01013727,1045,698,347,117,40,190
2011,Leicester 039C,E01013730,1063,659,404,100,45,259
2011,Leicester 039D,E01013731,1149,798,351,84,79,188
2011,Leicester 039E,E01032602,1081,700,381,108,79,194
2011,Leicester 040A,E01013646,2560,1240,1320,72,1035,213
2011,Leicester 040B,E01013647,2313,1019,1294,72,983,239
2011,Leicester 040C,E01013648,2414,1074,1340,45,1165,130
2011,Leicester 040D,E01032875,1845,658,1187,12,1126,49
2011,Leicester 041A,E01032867,1688,881,807,36,690,81
2011,Leicester 041B,E01032868,1634,701,933,1,899,33
2011,Leicester 041C,E01032872,1161,787,374,6,293,75
2011,Leicester 041D,E01032873,1279,693,586,49,429,108
2011,Nottingham 001A,E01013887,1200,791,409,287,30,92
2011,Nottingham 001B,E01013892,1050,656,394,279,35,80
2011,Nottingham 001C,E01013893,954,685,269,87,39,143
2011,Nottingham 001D,E01013894,1132,747,385,252,54,79
2011,Nottingham 002A,E01013879,882,557,325,95,30,200
2011,Nottingham 002B,E01013880,1026,608,418,161,50,207
2011,Nottingham 002C,E01013881,1023,666,357,118,46,193
2011,Nottingham 002D,E01013882,991,622,369,134,47,188
2011,Nottingham 002E,E01013885,1167,778,389,126,51,212
2011,Nottingham 004A,E01013886,1130,794,336,142,48,146
2011,Nottingham 004B,E01013888,1093,754,339,176,38,125
2011,Nottingham 004C,E01013889,1227,823,404,219,51,134
2011,Nottingham 004D,E01013890,1170,888,282,150,27,105
2011,Nottingham 004E,E01013891,1233,829,404,134,47,223
2011,Nottingham 005A,E01013875,1051,804,247,145,27,75
2011,Nottingham 005B,E01013876,1291,832,459,147,64,248
2011,Nottingham 005C,E01013877,962,537,425,126,47,252
2011,Nottingham 005D,E01013878,883,603,280,95,39,146
2011,Nottingham 005E,E01013883,1155,784,371,140,56,175
2011,Nottingham 005F,E01013884,975,686,289,116,37,136
2011,Nottingham 006A,E01013853,1061,674,387,180,53,154
2011,Nottingham 006B,E01013854,1017,712,305,89,37,179
2011,Nottingham 006C,E01013855,1038,670,368,95,53,220
2011,Nottingham 006D,E01013856,1127,803,324,91,59,174
2011,Nottingham 006F,E01033397,1268,942,326,66,89,171
2011,Nottingham 006G,E01033398,932,753,179,32,34,113
2011,Nottingham 007A,E01013963,1084,734,350,111,58,181
2011,Nottingham 007B,E01013964,1210,834,376,151,57,168
2011,Nottingham 007C,E01013965,1053,725,328,107,62,159
2011,Nottingham 007D,E01013966,1014,674,340,84,73,183
2011,Nottingham 007E,E01013967,1475,831,644,112,47,485
2011,Nottingham 008A,E01013827,1037,704,333,92,66,175
2011,Nottingham 008B,E01013828,1264,965,299,121,50,128
2011,Nottingham 008C,E01013834,1067,717,350,100,61,189
2011,Nottingham 008D,E01013835,1163,810,353,123,58,172
2011,Nottingham 008E,E01013836,1363,964,399,133,58,208
2011,Nottingham 009A,E01013829,1232,895,337,143,57,137
2011,Nottingham 009B,E01013830,1227,810,417,180,69,168
2011,Nottingham 009C,E01013831,1172,889,283,168,31,84
2011,Nottingham 009D,E01013832,1394,886,508,124,192,192
2011,Nottingham 009E,E01013833,981,647,334,122,62,150
2011,Nottingham 010A,E01013935,1151,804,347,197,31,119
2011,Nottingham 010B,E01013968,887,585,302,195,38,69
2011,Nottingham 010C,E01013969,1347,1060,287,107,59,121
2011,Nottingham 010D,E01013970,1200,984,216,75,47,94
2011,Nottingham 010E,E01013971,1231,981,250,93,39,118
2011,Nottingham 011A,E01013817,1037,627,410,84,56,270
2011,Nottingham 011B,E01013818,1108,602,506,73,111,322
2011,Nottingham 011C,E01013822,1092,657,435,88,75,272
2011,Nottingham 011D,E01013825,1258,860,398,102,69,227
2011,Nottingham 011E,E01013826,1209,754,455,68,84,303
2011,Nottingham 012A,E01013837,1336,1032,304,110,68,126
2011,Nottingham 012B,E01013838,1374,953,421,154,175,92
2011,Nottingham 012C,E01013839,1320,922,398,92,71,235
2011,Nottingham 012D,E01013840,1694,1393,301,90,69,142
2011,Nottingham 012E,E01013841,1188,835,353,57,92,204
2011,Nottingham 013A,E01013819,1150,729,421,138,65,218
2011,Nottingham 013B,E01013820,1182,775,407,84,88,235
2011,Nottingham 013C,E01013821,1089,689,400,80,68,252
2011,Nottingham 013D,E01013823,1244,827,417,105,94,218
2011,Nottingham 013E,E01013824,1035,689,346,77,56,213
2011,Nottingham 014A,E01013864,1083,698,385,79,58,248
2011,Nottingham 014B,E01013865,1021,614,407,151,55,201
2011,Nottingham 014C,E01013866,1014,627,387,150,40,197
2011,Nottingham 014D,E01013867,1078,704,374,75,61,238
2011,Nottingham 015A,E01013937,1293,967,326,119,80,127
2011,Nottingham 015B,E01013938,1163,895,268,112,81,75
2011,Nottingham 015C,E01013941,1289,966,323,110,125,88
2011,Nottingham 015D,E01013943,1544,1037,507,60,273,174
2011,Nottingham 015E,E01013972,1172,882,290,83,50,157
2011,Nottingham 016A,E01013936,1755,1332,423,138,104,181
2011,Nottingham 016B,E01013939,1225,867,358,154,64,140
2011,Nottingham 016C,E01013940,1239,821,418,77,86,255
2011,Nottingham 016D,E01013942,1507,962,545,131,104,310
2011,Nottingham 017A,E01013843,1212,851,361,86,130,145
2011,Nottingham 017B,E01013844,1131,805,326,42,118,166
2011,Nottingham 017C,E01013845,1181,785,396,55,107,234
2011,Nottingham 017D,E01013847,1078,676,402,60,164,178
2011,Nottingham 018A,E01013810,1155,697,458,74,108,276
2011,Nottingham 018B,E01013811,1126,647,479,44,216,219
2011,Nottingham 018C,E01013812,1176,712,464,50,161,253
2011,Nottingham 018D,E01013842,1235,764,471,65,185,221
2011,Nottingham 018E,E01013846,1348,785,563,65,270,228
2011,Nottingham 019A,E01013930,1376,885,491,118,124,249
2011,Nottingham 019B,E01013931,1119,679,440,218,72,150
2011,Nottingham 019C,E01013932,1216,726,490,211,79,200
2011,Nottingham 019D,E01013933,1270,774,496,98,174,224
2011,Nottingham 019E,E01013934,1096,731,365,163,80,122
2011,Nottingham 020A,E01013859,1075,578,497,244,31,222
2011,Nottingham 020B,E01013861,1025,483,542,198,36,308
2011,Nottingham 020C,E01013868,1008,551,457,164,72,221
2011,Nottingham 020D,E01013929,1341,882,459,176,88,195
2011,Nottingham 021A,E01013954,973,628,345,71,77,197
2011,Nottingham 021B,E01013959,1296,795,501,140,77,284
2011,Nottingham 021C,E01013960,1142,721,421,98,72,251
2011,Nottingham 021D,E01013962,1337,926,411,114,81,216
2011,Nottingham 022A,E01013813,1995,933,1062,60,773,229
2011,Nottingham 022B,E01013814,1903,998,905,30,619,256
2011,Nottingham 022C,E01013815,1671,774,897,42,685,170
2011,Nottingham 022D,E01013816,2380,973,1407,67,1162,178
2011,Nottingham 023C,E01013958,1303,772,531,141,138,252
2011,Nottingham 023D,E01013961,1953,969,984,75,724,185
2011,Nottingham 023E,E01033399,1944,779,1165,45,1000,120
2011,Nottingham 023F,E01033401,936,452,484,20,396,68
2011,Nottingham 023G,E01033405,1248,624,624,26,500,98
2011,Nottingham 023H,E01033409,1504,693,811,54,633,124
2011,Nottingham 023I,E01033411,787,425,362,93,72,197
2011,Nottingham 024A,E01013913,1295,895,400,190,67,143
2011,Nottingham 024B,E01013914,1241,809,432,186,80,166
2011,Nottingham 024C,E01013915,1083,700,383,190,53,140
2011,Nottingham 024D,E01013916,1034,665,369,116,56,197
2011,Nottingham 024E,E01013917,1330,937,393,106,81,206
2011,Nottingham 025A,E01013858,999,659,340,131,55,154
2011,Nottingham 025B,E01013860,1067,583,484,217,45,222
2011,Nottingham 025C,E01013862,1040,628,412,120,81,211
2011,Nottingham 025D,E01013863,1040,731,309,132,51,126
2011,Nottingham 026A,E01013944,1241,776,465,115,137,213
2011,Nottingham 026B,E01013945,1454,789,665,49,417,199
2011,Nottingham 026D,E01013947,1555,832,723,70,428,225
2011,Nottingham 026E,E01013948,1046,640,406,53,96,257
2011,Nottingham 026F,E01013953,3183,970,2213,22,2146,45
2011,Nottingham 026G,E01033395,2109,591,1518,9,1454,55
2011,Nottingham 026H,E01033396,907,452,455,72,216,167
2011,Nottingham 027A,E01013977,1331,950,381,185,80,116
2011,Nottingham 027B,E01013978,1197,824,373,136,132,105
2011,Nottingham 027C,E01013979,1119,808,311,140,92,79
2011,Nottingham 027D,E01013981,1230,902,328,184,66,78
2011,Nottingham 028E,E01032520,1880,1279,601,116,413,72
2011,Nottingham 028F,E01032522,1858,1330,528,120,344,64
2011,Nottingham 028G,E01033404,3647,1333,2314,50,2080,184
2011,Nottingham 029A,E01013918,1441,993,448,82,78,288
2011,Nottingham 029B,E01013919,1577,1089,488,71,111,306
2011,Nottingham 029C,E01013920,1777,1204,573,166,81,326
2011,Nottingham 029D,E01013921,1500,921,579,91,113,375
2011,Nottingham 029E,E01013957,1122,753,369,81,80,208
2011,Nottingham 030A,E01013980,1142,802,340,182,74,84
2011,Nottingham 030B,E01013982,1105,748,357,212,74,71
2011,Nottingham 030C,E01013983,1037,703,334,116,55,163
2011,Nottingham 030D,E01013984,938,580,358,258,50,50
2011,Nottingham 030E,E01013985,1251,814,437,260,82,95
2011,Nottingham 031C,E01013924,1552,582,970,58,745,167
2011,Nottingham 031E,E01013926,1467,693,774,51,613,110
2011,Nottingham 031G,E01013928,1418,489,929,30,825,74
2011,Nottingham 031H,E01033408,3122,1147,1975,95,1737,143
2011,Nottingham 031I,E01033410,2478,771,1707,94,1532,81
2011,Nottingham 032A,E01013973,3700,855,2845,61,2671,113
2011,Nottingham 032B,E01013974,1721,593,1128,173,805,150
2011,Nottingham 032C,E01013975,2106,620,1486,117,1274,95
2011,Nottingham 032D,E01013976,1216,764,452,77,188,187
2011,Nottingham 034A,E01013895,1034,725,309,192,47,70
2011,Nottingham 034B,E01013896,900,636,264,98,35,131
2011,Nottingham 034C,E01013901,1115,849,266,149,56,61
2011,Nottingham 034D,E01013902,1094,808,286,198,33,55
2011,Nottingham 035A,E01013897,990,634,356,103,90,163
2011,Nottingham 035B,E01013898,1350,671,679,65,507,107
2011,Nottingham 035C,E01013899,888,650,238,70,50,118
2011,Nottingham 035D,E01013900,1072,763,309,121,38,150
2011,Nottingham 035E,E01013903,908,629,279,130,68,81
2011,Nottingham 035F,E01013907,962,653,309,117,48,144
2011,Nottingham 036A,E01013905,1063,713,350,99,71,180
2011,Nottingham 036B,E01013908,1057,648,409,199,43,167
2011,Nottingham 036C,E01013909,1103,719,384,163,52,169
2011,Nottingham 036D,E01013912,1175,873,302,130,46,126
2011,Nottingham 037A,E01013904,1035,752,283,116,36,131
2011,Nottingham 037B,E01013906,1139,812,327,118,62,147
2011,Nottingham 037C,E01013910,993,705,288,104,49,135
2011,Nottingham 037D,E01013911,1018,731,287,126,39,122
2011,Nottingham 038A,E01013849,1068,721,347,139,40,168
2011,Nottingham 038B,E01013850,1035,648,387,163,33,191
2011,Nottingham 038C,E01013851,1132,716,416,137,58,221
2011,Nottingham 038D,E01013852,1148,776,372,186,43,143
2011,Nottingham 038E,E01032621,1194,743,451,255,41,155
2011,Nottingham 039A,E01013874,1241,959,282,94,78,110
2011,Nottingham 039B,E01033400,1038,636,402,56,208,138
2011,Nottingham 039C,E01033402,1034,723,311,7,229,75
2011,Nottingham 039D,E01033403,998,623,375,30,263,82
2011,Nottingham 039E,E01033406,1031,573,458,9,402,47
2011,Nottingham 039F,E01033407,1020,653,367,12,314,41
2011,Nottingham 040A,E01013870,1585,1091,494,137,158,199
2011,Nottingham 040B,E01013871,1209,718,491,188,57,246
2011,Nottingham 040C,E01013872,1365,925,440,113,95,232
2011,Nottingham 040D,E01013873,1693,961,732,68,437,227
2011,Rutland 001A,E01013788,1929,1433,496,290,57,149
2011,Rutland 001B,E01013789,1078,734,344,215,45,84
2011,Rutland 001C,E01013790,1767,1049,718,148,39,531
2011,Rutland 001D,E01013796,1312,1039,273,164,29,80
2011,Rutland 002A,E01013793,973,663,310,221,28,61
2011,Rutland 002B,E01013800,1133,824,309,215,36,58
2011,Rutland 002C,E01013801,1170,869,301,157,31,113
2011,Rutland 002D,E01013809,939,647,292,202,32,58
2011,Rutland 003A,E01013798,1074,828,246,158,42,46
2011,Rutland 003B,E01013799,1162,722,440,119,246,75
2011,Rutland 003C,E01013802,1753,1152,601,434,54,113
2011,Rutland 003D,E01013803,1611,1148,463,319,52,92
2011,Rutland 004A,E01013791,773,499,274,192,34,48
2011,Rutland 004B,E01013792,1160,798,362,230,48,84
2011,Rutland 004C,E01013797,1237,894,343,216,43,84
2011,Rutland 004D,E01013804,1147,867,280,190,41,49
2011,Rutland 004E,E01013805,916,694,222,147,26,49
2011,Rutland 005A,E01013787,890,632,258,137,53,68
2011,Rutland 005B,E01013794,973,662,311,219,31,61
2011,Rutland 005C,E01013795,832,578,254,173,24,57
2011,Rutland 005D,E01013806,1357,665,692,103,537,52
2011,Rutland 005E,E01013807,960,697,263,182,23,58
2011,Rutland 005F,E01013808,906,664,242,148,17,77
2011,Amber Valley 001A,E01019400,1189,793,396,186,50,160
2011,Amber Valley 001B,E01019401,1209,797,412,205,32,175
2011,Amber Valley 001C,E01019402,1199,870,329,145,37,147
2011,Amber Valley 001D,E01019404,1235,811,424,225,37,162
2011,Amber Valley 002A,E01019406,761,494,267,197,27,43
2011,Amber Valley 002B,E01019423,916,605,311,238,16,57
2011,Amber Valley 002C,E01019424,895,587,308,192,25,91
2011,Amber Valley 002D,E01019477,1644,1101,543,377,60,106
2011,Amber Valley 003A,E01019403,1014,624,390,172,48,170
2011,Amber Valley 003B,E01019444,961,521,440,153,33,254
2011,Amber Valley 003C,E01019468,1141,794,347,153,36,158
2011,Amber Valley 003D,E01019469,1154,749,405,122,45,238
2011,Amber Valley 003E,E01019471,1003,668,335,128,41,166
2011,Amber Valley 004A,E01019443,1131,733,398,281,32,85
2011,Amber Valley 004B,E01019470,1266,948,318,161,45,112
2011,Amber Valley 004C,E01019473,1041,802,239,148,42,49
2011,Amber Valley 004D,E01019474,961,746,215,152,23,40
2011,Amber Valley 004E,E01019475,894,618,276,172,24,80
2011,Amber Valley 004F,E01019476,1012,661,351,254,29,68
2011,Amber Valley 005A,E01019420,1005,697,308,143,37,128
2011,Amber Valley 005B,E01019442,1221,859,362,201,48,113
2011,Amber Valley 005C,E01019445,1102,842,260,125,36,99
2011,Amber Valley 005D,E01019455,1054,773,281,148,29,104
2011,Amber Valley 005E,E01019456,1335,1005,330,174,35,121
2011,Amber Valley 005F,E01019457,986,701,285,171,44,70
2011,Amber Valley 006A,E01019429,1217,881,336,224,23,89
2011,Amber Valley 006B,E01019454,1095,703,392,294,26,72
2011,Amber Valley 006C,E01019460,1237,955,282,151,44,87
2011,Amber Valley 006D,E01019461,1041,716,325,217,29,79
2011,Amber Valley 006E,E01019462,948,618,330,249,24,57
2011,Amber Valley 007A,E01019405,1083,730,353,264,40,49
2011,Amber Valley 007B,E01019414,1205,805,400,298,28,74
2011,Amber Valley 007C,E01019428,1108,735,373,228,46,99
2011,Amber Valley 007D,E01019430,1449,1040,409,260,54,95
2011,Amber Valley 008A,E01019421,1497,1067,430,270,33,127
2011,Amber Valley 008B,E01019422,1173,770,403,289,25,89
2011,Amber Valley 008C,E01019432,1464,952,512,303,49,160
2011,Amber Valley 008D,E01019458,1207,891,316,160,32,124
2011,Amber Valley 008E,E01019459,1007,642,365,187,56,122
2011,Amber Valley 008F,E01019463,1057,651,406,163,60,183
2011,Amber Valley 009A,E01019408,1114,832,282,163,42,77
2011,Amber Valley 009B,E01019409,1287,844,443,309,49,85
2011,Amber Valley 009C,E01019412,1174,949,225,120,48,57
2011,Amber Valley 009D,E01019413,1039,825,214,108,48,58
2011,Amber Valley 009E,E01019416,1066,736,330,244,29,57
2011,Amber Valley 010A,E01019407,1566,1168,398,223,43,132
2011,Amber Valley 010B,E01019415,1308,952,356,213,35,108
2011,Amber Valley 010C,E01019417,1380,983,397,211,44,142
2011,Amber Valley 010D,E01019419,1490,1131,359,241,34,84
2011,Amber Valley 011A,E01019410,1115,876,239,135,43,61
2011,Amber Valley 011B,E01019411,1117,795,322,182,50,90
2011,Amber Valley 011C,E01019418,1287,973,314,176,42,96
2011,Amber Valley 011D,E01019447,1086,741,345,246,28,71
2011,Amber Valley 011E,E01019449,1358,1048,310,187,39,84
2011,Amber Valley 012A,E01019431,1114,800,314,166,37,111
2011,Amber Valley 012B,E01019433,1344,950,394,218,47,129
2011,Amber Valley 012C,E01019438,1253,925,328,124,60,144
2011,Amber Valley 012D,E01019451,1483,1086,397,203,50,144
2011,Amber Valley 012E,E01019464,1455,1061,394,260,53,81
2011,Amber Valley 013A,E01019434,913,619,294,197,21,76
2011,Amber Valley 013B,E01019435,1253,936,317,147,45,125
2011,Amber Valley 013C,E01019436,994,702,292,149,35,108
2011,Amber Valley 013D,E01019439,1000,766,234,123,34,77
2011,Amber Valley 013E,E01019440,1140,800,340,215,26,99
2011,Amber Valley 015A,E01019446,963,726,237,153,29,55
2011,Amber Valley 015B,E01019448,1258,928,330,209,38,83
2011,Amber Valley 015C,E01019450,1047,759,288,152,20,116
2011,Amber Valley 015D,E01019465,831,514,317,211,27,79
2011,Amber Valley 015E,E01019467,1109,756,353,235,31,87
2011,Amber Valley 016A,E01019425,1070,710,360,232,62,66
2011,Amber Valley 016B,E01019426,998,640,358,216,66,76
2011,Amber Valley 016C,E01019427,1259,855,404,210,78,116
2011,Amber Valley 016D,E01019472,2000,1357,643,427,81,135
2011,Amber Valley 017A,E01019437,1083,687,396,200,52,144
2011,Amber Valley 017B,E01019441,1094,711,383,164,45,174
2011,Amber Valley 017C,E01019452,1152,643,509,206,46,257
2011,Amber Valley 017D,E01019453,1330,954,376,151,40,185
2011,Amber Valley 017E,E01032613,911,587,324,209,32,83
2011,Bolsover 001A,E01019478,1130,854,276,180,32,64
2011,Bolsover 001B,E01019479,1247,875,372,221,52,99
2011,Bolsover 001C,E01019491,1670,1219,451,217,56,178
2011,Bolsover 001D,E01019493,1218,879,339,210,40,89
2011,Bolsover 001E,E01019494,1483,952,531,323,60,148
2011,Bolsover 002A,E01019492,1251,819,432,209,48,175
2011,Bolsover 002B,E01019495,1212,737,475,271,36,168
2011,Bolsover 002C,E01019524,1031,718,313,195,37,81
2011,Bolsover 002D,E01019525,1122,745,377,197,40,140
2011,Bolsover 003A,E01019496,1022,654,368,177,27,164
2011,Bolsover 003B,E01019497,1043,570,473,255,45,173
2011,Bolsover 003C,E01019498,1299,855,444,116,73,255
2011,Bolsover 003D,E01019523,801,467,334,151,22,161
2011,Bolsover 004A,E01019483,1529,1008,521,176,79,266
2011,Bolsover 004B,E01019484,1513,1012,501,269,56,176
2011,Bolsover 004C,E01019485,844,517,327,192,30,105
2011,Bolsover 004D,E01019488,1068,643,425,138,48,239
2011,Bolsover 005A,E01019486,821,589,232,138,39,55
2011,Bolsover 005B,E01019487,1075,650,425,194,53,178
2011,Bolsover 005C,E01019489,912,547,365,261,17,87
2011,Bolsover 005D,E01019490,862,616,246,144,28,74
2011,Bolsover 005E,E01019502,1104,720,384,261,25,98
2011,Bolsover 005F,E01019504,959,627,332,185,28,119
2011,Bolsover 006A,E01019508,1408,837,571,304,55,212
2011,Bolsover 006B,E01019509,830,481,349,141,39,169
2011,Bolsover 006C,E01019510,881,498,383,175,30,178
2011,Bolsover 006D,E01019512,1921,1335,586,268,66,252
2011,Bolsover 007A,E01019503,1741,1120,621,370,41,210
2011,Bolsover 007B,E01019505,1136,705,431,170,39,222
2011,Bolsover 007C,E01019506,1024,647,377,194,29,154
2011,Bolsover 007D,E01019507,1227,761,466,199,35,232
2011,Bolsover 007E,E01019511,1563,1064,499,204,55,240
2011,Bolsover 008A,E01019480,1106,749,357,230,30,97
2011,Bolsover 008B,E01019482,1127,772,355,231,29,95
2011,Bolsover 008C,E01019520,1299,910,389,180,59,150
2011,Bolsover 008D,E01019521,1128,817,311,183,37,91
2011,Bolsover 008E,E01019522,1109,794,315,131,34,150
2011,Bolsover 009A,E01019481,918,640,278,135,36,107
2011,Bolsover 009B,E01019514,1170,869,301,137,37,127
2011,Bolsover 009C,E01019515,1153,794,359,143,41,175
2011,Bolsover 009D,E01019516,1103,752,351,182,30,139
2011,Bolsover 009E,E01019519,1345,918,427,202,51,174
2011,Bolsover 010A,E01019499,997,698,299,163,32,104
2011,Bolsover 010B,E01019500,1067,710,357,159,42,156
2011,Bolsover 010C,E01019501,1093,722,371,217,32,122
2011,Bolsover 010D,E01019513,964,696,268,166,43,59
2011,Bolsover 010E,E01019517,1192,903,289,152,36,101
2011,Bolsover 010F,E01019518,1227,977,250,147,33,70
2011,Chesterfield 001A,E01019526,1032,747,285,140,38,107
2011,Chesterfield 001B,E01019528,1166,808,358,247,30,81
2011,Chesterfield 001C,E01019572,926,575,351,128,48,175
2011,Chesterfield 001D,E01019573,1170,829,341,154,36,151
2011,Chesterfield 001E,E01019574,980,654,326,206,27,93
2011,Chesterfield 002A,E01019563,1147,769,378,111,60,207
2011,Chesterfield 002B,E01019564,1117,735,382,241,39,102
2011,Chesterfield 002C,E01019565,1045,666,379,157,42,180
2011,Chesterfield 002D,E01019566,1191,749,442,155,49,238
2011,Chesterfield 002E,E01019568,1027,637,390,126,66,198
2011,Chesterfield 003A,E01019527,1055,647,408,153,34,221
2011,Chesterfield 003B,E01019529,1106,803,303,152,31,120
2011,Chesterfield 003C,E01019530,1117,815,302,113,38,151
2011,Chesterfield 003D,E01019531,1129,785,344,127,31,186
2011,Chesterfield 003E,E01019553,1290,1010,280,146,39,95
2011,Chesterfield 004A,E01019541,1104,718,386,196,55,135
2011,Chesterfield 004B,E01019542,1248,852,396,165,20,211
2011,Chesterfield 004C,E01019543,1132,714,418,177,39,202
2011,Chesterfield 004D,E01019544,1122,708,414,252,38,124
2011,Chesterfield 004E,E01019571,1012,604,408,173,60,175
2011,Chesterfield 005A,E01019532,934,660,274,138,37,99
2011,Chesterfield 005B,E01019533,1095,818,277,188,26,63
2011,Chesterfield 005C,E01019534,1019,613,406,241,31,134
2011,Chesterfield 005D,E01019535,1071,756,315,215,43,57
2011,Chesterfield 005E,E01019536,1214,837,377,181,35,161
2011,Chesterfield 006A,E01019549,965,595,370,167,46,157
2011,Chesterfield 006B,E01019550,1136,721,415,215,40,160
2011,Chesterfield 006C,E01019551,1254,757,497,359,35,103
2011,Chesterfield 006D,E01019552,971,647,324,144,51,129
2011,Chesterfield 006E,E01019567,1218,768,450,219,47,184
2011,Chesterfield 007A,E01019537,1075,713,362,225,55,82
2011,Chesterfield 007B,E01019569,1284,935,349,171,32,146
2011,Chesterfield 007C,E01019570,896,548,348,231,39,78
2011,Chesterfield 007D,E01019580,1069,690,379,186,45,148
2011,Chesterfield 007E,E01019581,1024,684,340,139,38,163
2011,Chesterfield 008A,E01019557,1074,792,282,134,50,98
2011,Chesterfield 008B,E01019558,1144,839,305,207,45,53
2011,Chesterfield 008C,E01019559,906,662,244,167,32,45
2011,Chesterfield 008D,E01019560,1010,635,375,223,35,117
2011,Chesterfield 008E,E01019561,968,572,396,156,30,210
2011,Chesterfield 008F,E01019562,885,540,345,177,34,134
2011,Chesterfield 009A,E01019539,1186,799,387,259,37,91
2011,Chesterfield 009B,E01019540,1059,764,295,188,44,63
2011,Chesterfield 009C,E01019555,1080,715,365,210,31,124
2011,Chesterfield 009D,E01019590,1339,859,480,346,58,76
2011,Chesterfield 009E,E01019591,1094,804,290,158,55,77
2011,Chesterfield 010A,E01019538,1282,963,319,146,50,123
2011,Chesterfield 010B,E01019554,1110,851,259,113,29,117
2011,Chesterfield 010C,E01019556,1118,760,358,150,32,176
2011,Chesterfield 010D,E01019579,1258,926,332,114,61,157
2011,Chesterfield 010F,E01033387,951,805,146,54,28,64
2011,Chesterfield 010G,E01033388,1025,743,282,112,41,129
2011,Chesterfield 011A,E01019586,1017,709,308,220,26,62
2011,Chesterfield 011B,E01019587,1140,807,333,225,49,59
2011,Chesterfield 011C,E01019588,1043,676,367,279,36,52
2011,Chesterfield 011D,E01019589,1024,684,340,245,34,61
2011,Chesterfield 011E,E01019592,1149,754,395,281,53,61
2011,Chesterfield 011F,E01019593,778,504,274,221,17,36
2011,Chesterfield 012A,E01019545,1034,699,335,254,21,60
2011,Chesterfield 012B,E01019546,1106,783,323,202,40,81
2011,Chesterfield 012C,E01019547,1024,704,320,123,35,162
2011,Chesterfield 012D,E01019548,1676,1233,443,277,49,117
2011,Chesterfield 012E,E01019582,1080,763,317,189,33,95
2011,Chesterfield 012F,E01019583,1067,796,271,169,30,72
2011,Chesterfield 012G,E01019585,1749,1328,421,216,85,120
2011,Chesterfield 013A,E01019575,1187,727,460,121,60,279
2011,Chesterfield 013B,E01019576,1180,746,434,218,35,181
2011,Chesterfield 013C,E01019577,1190,756,434,248,26,160
2011,Chesterfield 013D,E01019578,1135,644,491,154,41,296
2011,Derbyshire Dales 001A,E01019602,1394,967,427,310,40,77
2011,Derbyshire Dales 001B,E01019614,1230,889,341,247,37,57
2011,Derbyshire Dales 001C,E01019615,1532,1089,443,305,48,90
2011,Derbyshire Dales 001D,E01019631,1337,999,338,229,41,68
2011,Derbyshire Dales 002A,E01019600,1176,810,366,239,37,90
2011,Derbyshire Dales 002B,E01019604,1322,901,421,288,63,70
2011,Derbyshire Dales 002C,E01019606,1176,806,370,282,25,63
2011,Derbyshire Dales 002D,E01019618,1215,835,380,287,34,59
2011,Derbyshire Dales 003A,E01019599,1047,672,375,289,31,55
2011,Derbyshire Dales 003B,E01019601,1035,662,373,238,51,84
2011,Derbyshire Dales 003C,E01019613,1283,928,355,231,40,84
2011,Derbyshire Dales 003D,E01019617,1171,828,343,212,24,107
2011,Derbyshire Dales 004A,E01019608,1166,803,363,225,34,104
2011,Derbyshire Dales 004B,E01019610,1148,816,332,238,35,59
2011,Derbyshire Dales 004C,E01019630,1356,1009,347,220,42,85
2011,Derbyshire Dales 005A,E01019609,1592,1122,470,325,39,106
2011,Derbyshire Dales 005B,E01019621,990,712,278,182,32,64
2011,Derbyshire Dales 005C,E01019622,1170,862,308,200,49,59
2011,Derbyshire Dales 005D,E01019624,924,659,265,191,30,44
2011,Derbyshire Dales 005E,E01019627,919,671,248,170,27,51
2011,Derbyshire Dales 005F,E01019628,837,538,299,204,23,72
2011,Derbyshire Dales 006A,E01019619,1113,705,408,270,43,95
2011,Derbyshire Dales 006B,E01019620,1205,918,287,181,31,75
2011,Derbyshire Dales 006C,E01019623,976,698,278,136,49,93
2011,Derbyshire Dales 006D,E01019625,1055,645,410,163,48,199
2011,Derbyshire Dales 006E,E01019626,1140,799,341,260,38,43
2011,Derbyshire Dales 006F,E01019632,1279,870,409,279,41,89
2011,Derbyshire Dales 007A,E01019633,1147,768,379,208,59,112
2011,Derbyshire Dales 007B,E01019634,1123,775,348,234,37,77
2011,Derbyshire Dales 007C,E01019635,918,611,307,240,23,44
2011,Derbyshire Dales 007D,E01019636,1102,822,280,159,36,85
2011,Derbyshire Dales 008A,E01019595,1479,1096,383,240,57,86
2011,Derbyshire Dales 008B,E01019605,1399,1050,349,226,29,94
2011,Derbyshire Dales 008C,E01019611,1317,967,350,222,37,91
2011,Derbyshire Dales 008D,E01019616,1306,893,413,299,36,78
2011,Derbyshire Dales 009A,E01019594,1220,834,386,238,46,102
2011,Derbyshire Dales 009B,E01019596,1075,744,331,215,33,83
2011,Derbyshire Dales 009C,E01019597,1092,838,254,160,26,68
2011,Derbyshire Dales 009D,E01019598,1232,943,289,109,44,136
2011,Derbyshire Dales 010A,E01019603,1190,850,340,233,31,76
2011,Derbyshire Dales 010B,E01019607,1364,958,406,285,44,77
2011,Derbyshire Dales 010C,E01019612,1993,1273,720,235,85,400
2011,Derbyshire Dales 010D,E01019629,1233,906,327,199,44,84
2011,Erewash 001A,E01019644,1114,762,352,175,28,149
2011,Erewash 001B,E01019646,1123,762,361,126,52,183
2011,Erewash 001C,E01019663,997,537,460,164,34,262
2011,Erewash 001D,E01019664,873,559,314,126,40,148
2011,Erewash 001E,E01019665,1019,687,332,211,18,103
2011,Erewash 003A,E01019657,1274,903,371,169,49,153
2011,Erewash 003B,E01019660,1435,1070,365,222,40,103
2011,Erewash 003C,E01019661,1021,732,289,148,25,116
2011,Erewash 003D,E01019662,1168,824,344,147,22,175
2011,Erewash 003E,E01019672,1209,857,352,173,47,132
2011,Erewash 003F,E01019690,903,689,214,104,39,71
2011,Erewash 004A,E01019670,1323,946,377,233,53,91
2011,Erewash 004B,E01019671,1323,912,411,252,55,104
2011,Erewash 004C,E01019701,1552,1050,502,297,56,149
2011,Erewash 005A,E01019673,916,630,286,183,31,72
2011,Erewash 005B,E01019702,1390,1024,366,263,43,60
2011,Erewash 005C,E01019703,1203,891,312,204,30,78
2011,Erewash 005D,E01019704,1115,783,332,234,31,67
2011,Erewash 006A,E01019658,1368,1047,321,132,44,145
2011,Erewash 006B,E01019659,1301,1005,296,182,45,69
2011,Erewash 006C,E01019674,900,631,269,169,34,66
2011,Erewash 006D,E01019688,1117,753,364,122,52,190
2011,Erewash 006E,E01019689,1130,791,339,200,41,98
2011,Erewash 007A,E01019666,1008,686,322,133,43,146
2011,Erewash 007B,E01019667,1139,742,397,168,47,182
2011,Erewash 007C,E01019668,956,544,412,177,52,183
2011,Erewash 007D,E01019669,1209,791,418,268,35,115
2011,Erewash 008A,E01019656,843,612,231,147,28,56
2011,Erewash 008B,E01019691,1157,836,321,186,52,83
2011,Erewash 008C,E01019692,1054,688,366,165,53,148
2011,Erewash 008D,E01019693,1322,998,324,134,52,138
2011,Erewash 008E,E01019694,920,666,254,181,29,44
2011,Erewash 008F,E01019696,997,695,302,217,28,57
2011,Erewash 009A,E01019683,971,677,294,195,34,65
2011,Erewash 009B,E01019684,1226,959,267,173,31,63
2011,Erewash 009C,E01019685,1118,777,341,223,31,87
2011,Erewash 009D,E01019686,1001,682,319,211,60,48
2011,Erewash 009E,E01019687,1001,654,347,173,35,139
2011,Erewash 010A,E01019648,1129,817,312,175,45,92
2011,Erewash 010B,E01019649,1331,1050,281,120,32,129
2011,Erewash 010C,E01019650,1114,720,394,154,44,196
2011,Erewash 010D,E01019651,1046,748,298,159,46,93
2011,Erewash 010E,E01019695,1071,806,265,154,35,76
2011,Erewash 011A,E01019641,1075,736,339,250,30,59
2011,Erewash 011B,E01019652,1243,850,393,150,146,97
2011,Erewash 011C,E01019653,1050,769,281,222,27,32
2011,Erewash 011D,E01019707,1171,935,236,127,35,74
2011,Erewash 011E,E01019708,1214,927,287,188,49,50
2011,Erewash 012A,E01019647,1439,1081,358,125,53,180
2011,Erewash 012B,E01019675,1178,879,299,135,30,134
2011,Erewash 012C,E01019679,1303,979,324,142,52,130
2011,Erewash 012D,E01019682,1145,825,320,124,32,164
2011,Erewash 013A,E01019642,1030,686,344,218,27,99
2011,Erewash 013B,E01019643,1159,789,370,270,34,66
2011,Erewash 013C,E01019654,1177,819,358,210,39,109
2011,Erewash 013D,E01019655,1159,892,267,127,43,97
2011,Erewash 014A,E01019676,1096,815,281,145,44,92
2011,Erewash 014B,E01019677,1097,769,328,223,30,75
2011,Erewash 014C,E01019678,1221,972,249,121,41,87
2011,Erewash 014D,E01019680,1112,854,258,162,32,64
2011,Erewash 014E,E01019681,1158,801,357,271,25,61
2011,Erewash 014F,E01019698,1071,807,264,163,31,70
2011,Erewash 015A,E01019697,1103,746,357,227,41,89
2011,Erewash 015B,E01019699,1026,603,423,218,39,166
2011,Erewash 015C,E01019700,1673,1175,498,302,61,135
2011,Erewash 015D,E01019705,1341,1044,297,159,42,96
2011,Erewash 015E,E01019706,933,661,272,177,29,66
2011,Erewash 015F,E01019709,917,678,239,73,53,113
2011,Erewash 016A,E01019638,1012,719,293,159,46,88
2011,Erewash 016B,E01019639,809,609,200,91,36,73
2011,Erewash 016C,E01019640,1124,926,198,86,35,77
2011,Erewash 016D,E01019645,1187,860,327,200,37,90
2011,Erewash 016E,E01032614,999,845,154,80,30,44
2011,High Peak 001A,E01019733,1093,767,326,183,46,97
2011,High Peak 001B,E01019752,978,758,220,80,59,81
2011,High Peak 001C,E01019753,1148,907,241,126,41,74
2011,High Peak 001D,E01019763,1588,1156,432,219,71,142
2011,High Peak 002A,E01019728,798,474,324,100,37,187
2011,High Peak 002B,E01019729,924,598,326,104,48,174
2011,High Peak 002C,E01019730,1426,983,443,179,72,192
2011,High Peak 002D,E01019731,969,745,224,131,42,51
2011,High Peak 002E,E01019732,1140,802,338,177,47,114
2011,High Peak 003A,E01019738,1042,797,245,130,39,76
2011,High Peak 003B,E01019739,1252,912,340,159,34,147
2011,High Peak 003C,E01019740,915,695,220,106,34,80
2011,High Peak 003D,E01019750,927,657,270,143,48,79
2011,High Peak 003E,E01019751,1617,1210,407,218,81,108
2011,High Peak 003F,E01019768,1622,1105,517,232,59,226
2011,High Peak 004A,E01019727,1274,795,479,359,69,51
2011,High Peak 004B,E01019749,963,698,265,176,44,45
2011,High Peak 004C,E01019754,1364,980,384,264,44,76
2011,High Peak 004D,E01019756,1349,1061,288,161,61,66
2011,High Peak 004E,E01019757,1027,741,286,197,45,44
2011,High Peak 004F,E01019758,1176,854,322,201,41,80
2011,High Peak 005A,E01019746,1246,900,346,210,64,72
2011,High Peak 005B,E01019747,904,641,263,178,38,47
2011,High Peak 005C,E01019748,1155,912,243,124,43,76
2011,High Peak 005D,E01019755,1573,1177,396,274,51,71
2011,High Peak 005E,E01019766,1105,816,289,169,41,79
2011,High Peak 006A,E01019711,1017,764,253,161,31,61
2011,High Peak 006B,E01019734,1529,1101,428,273,51,104
2011,High Peak 006C,E01019743,971,675,296,128,37,131
2011,High Peak 006D,E01019744,1115,782,333,193,33,107
2011,High Peak 006E,E01019745,781,544,237,102,43,92
2011,High Peak 008A,E01019712,1104,810,294,184,55,55
2011,High Peak 008B,E01019713,803,544,259,179,32,48
2011,High Peak 008C,E01019764,1135,813,322,217,41,64
2011,High Peak 008D,E01019765,1386,1051,335,193,58,84
2011,High Peak 008E,E01019767,1189,853,336,218,52,66
2011,High Peak 010A,E01019710,1486,1048,438,212,79,147
2011,High Peak 010B,E01019715,1168,842,326,106,102,118
2011,High Peak 010C,E01019717,1094,697,397,131,176,90
2011,High Peak 010D,E01019722,1386,1032,354,174,80,100
2011,High Peak 010E,E01019723,1265,786,479,305,43,131
2011,High Peak 011A,E01019716,946,676,270,149,48,73
2011,High Peak 011B,E01019724,870,617,253,116,40,97
2011,High Peak 011C,E01019759,1088,753,335,158,45,132
2011,High Peak 011D,E01019760,1073,791,282,174,35,73
2011,High Peak 011E,E01019761,1045,711,334,73,55,206
2011,High Peak 012A,E01019714,1833,1402,431,266,61,104
2011,High Peak 012B,E01019725,1052,808,244,160,22,62
2011,High Peak 012C,E01019726,975,739,236,130,27,79
2011,High Peak 012D,E01019762,1315,859,456,334,49,73
2011,High Peak 013E,E01019718,1651,1231,420,252,57,111
2011,High Peak 013F,E01019719,1130,804,326,200,44,82
2011,High Peak 013G,E01019720,1057,781,276,198,35,43
2011,High Peak 013H,E01019721,854,626,228,168,25,35
2011,High Peak 013A,E01019735,1135,796,339,238,36,65
2011,High Peak 013B,E01019736,907,695,212,142,29,41
2011,High Peak 013C,E01019737,800,557,243,168,23,52
2011,High Peak 013I,E01019741,822,593,229,143,26,60
2011,High Peak 013D,E01019742,832,638,194,116,24,54
2011,North East Derbyshire 001A,E01019801,883,677,206,105,35,66
2011,North East Derbyshire 001B,E01019802,1016,752,264,159,45,60
2011,North East Derbyshire 001C,E01019803,928,612,316,154,36,126
2011,North East Derbyshire 001D,E01019804,1077,848,229,124,44,61
2011,North East Derbyshire 001E,E01019805,1039,825,214,132,37,45
2011,North East Derbyshire 001F,E01019806,1196,897,299,175,41,83
2011,North East Derbyshire 001G,E01019807,1085,733,352,135,65,152
2011,North East Derbyshire 002A,E01019778,1209,727,482,378,37,67
2011,North East Derbyshire 002B,E01019779,1147,700,447,369,16,62
2011,North East Derbyshire 002C,E01019790,1560,1217,343,228,39,76
2011,North East Derbyshire 002D,E01019816,1337,935,402,262,39,101
2011,North East Derbyshire 004A,E01019780,1002,704,298,159,27,112
2011,North East Derbyshire 004B,E01019781,1020,718,302,205,36,61
2011,North East Derbyshire 004C,E01019782,896,631,265,162,32,71
2011,North East Derbyshire 004D,E01019786,1112,794,318,200,31,87
2011,North East Derbyshire 004E,E01019827,1360,935,425,258,58,109
2011,North East Derbyshire 005A,E01019770,1398,958,440,306,50,84
2011,North East Derbyshire 005B,E01019787,1262,902,360,258,36,66
2011,North East Derbyshire 005C,E01019788,1210,827,383,283,50,50
2011,North East Derbyshire 005D,E01019794,1083,648,435,358,35,42
2011,North East Derbyshire 006A,E01019783,956,684,272,212,28,32
2011,North East Derbyshire 006B,E01019784,923,681,242,170,25,47
2011,North East Derbyshire 006C,E01019785,975,677,298,233,33,32
2011,North East Derbyshire 006D,E01019793,1103,749,354,278,30,46
2011,North East Derbyshire 006E,E01019795,1624,1163,461,290,67,104
2011,North East Derbyshire 007A,E01019798,1081,734,347,226,29,92
2011,North East Derbyshire 007B,E01019821,1034,669,365,231,34,100
2011,North East Derbyshire 007C,E01019822,1207,789,418,231,43,144
2011,North East Derbyshire 007D,E01019823,818,518,300,171,31,98
2011,North East Derbyshire 008A,E01019771,1516,970,546,357,66,123
2011,North East Derbyshire 008B,E01019772,1143,792,351,237,41,73
2011,North East Derbyshire 008C,E01019828,1023,593,430,361,28,41
2011,North East Derbyshire 008D,E01019829,1089,738,351,251,44,56
2011,North East Derbyshire 009A,E01019796,789,453,336,129,33,174
2011,North East Derbyshire 009B,E01019797,1028,714,314,151,32,131
2011,North East Derbyshire 009C,E01019799,1411,821,590,220,50,320
2011,North East Derbyshire 009D,E01019800,1308,918,390,192,47,151
2011,North East Derbyshire 009E,E01019808,1128,682,446,181,37,228
2011,North East Derbyshire 009F,E01019826,987,668,319,148,29,142
2011,North East Derbyshire 010A,E01019769,1415,965,450,305,48,97
2011,North East Derbyshire 010B,E01019774,1150,663,487,385,28,74
2011,North East Derbyshire 010C,E01019824,916,566,350,233,29,88
2011,North East Derbyshire 010D,E01019830,947,631,316,235,36,45
2011,North East Derbyshire 010E,E01019831,1032,772,260,179,25,56
2011,North East Derbyshire 011A,E01019809,867,557,310,200,20,90
2011,North East Derbyshire 011B,E01019810,1135,801,334,154,29,151
2011,North East Derbyshire 011C,E01019811,1202,862,340,220,39,81
2011,North East Derbyshire 011D,E01019812,1384,1005,379,241,32,106
2011,North East Derbyshire 011E,E01019813,1218,842,376,198,46,132
2011,North East Derbyshire 011F,E01019825,1028,748,280,157,55,68
2011,North East Derbyshire 012A,E01019773,1770,1226,544,256,54,234
2011,North East Derbyshire 012B,E01019775,1303,825,478,185,48,245
2011,North East Derbyshire 012C,E01019776,1050,648,402,217,37,148
2011,North East Derbyshire 012D,E01019777,1732,1087,645,303,60,282
2011,North East Derbyshire 013A,E01019814,1270,877,393,274,37,82
2011,North East Derbyshire 013B,E01019817,854,527,327,152,30,145
2011,North East Derbyshire 013C,E01019818,1105,706,399,177,32,190
2011,North East Derbyshire 013D,E01019819,1115,764,351,225,26,100
2011,North East Derbyshire 013E,E01019820,1091,708,383,262,24,97
2011,North East Derbyshire 014A,E01019791,1289,878,411,216,60,135
2011,North East Derbyshire 014B,E01019792,1442,964,478,237,50,191
2011,North East Derbyshire 014C,E01019815,2005,1469,536,233,93,210
2011,North East Derbyshire 014D,E01032586,1177,775,402,236,32,134
2011,South Derbyshire 001A,E01019839,1376,1068,308,162,51,95
2011,South Derbyshire 001B,E01019845,986,748,238,128,34,76
2011,South Derbyshire 001C,E01019846,895,667,228,123,27,78
2011,South Derbyshire 001D,E01019866,1831,1258,573,280,54,239
2011,South Derbyshire 002A,E01019840,1112,749,363,237,39,87
2011,South Derbyshire 002B,E01019841,1078,700,378,267,31,80
2011,South Derbyshire 002C,E01019847,983,678,305,211,33,61
2011,South Derbyshire 002D,E01019848,1557,1313,244,88,68,88
2011,South Derbyshire 002F,E01033532,1034,877,157,63,33,61
2011,South Derbyshire 002G,E01033533,1163,955,208,92,47,69
2011,South Derbyshire 002H,E01033534,819,743,76,16,17,43
2011,South Derbyshire 003A,E01019873,1065,874,191,76,30,85
2011,South Derbyshire 003B,E01019874,1123,820,303,173,38,92
2011,South Derbyshire 003C,E01019875,1082,860,222,100,52,70
2011,South Derbyshire 003D,E01019881,1019,721,298,222,30,46
2011,South Derbyshire 003E,E01019882,1162,810,352,234,26,92
2011,South Derbyshire 004A,E01019832,1324,964,360,259,31,70
2011,South Derbyshire 004B,E01019833,1277,912,365,243,40,82
2011,South Derbyshire 004C,E01019834,1091,768,323,220,43,60
2011,South Derbyshire 004D,E01019835,1250,1003,247,120,48,79
2011,South Derbyshire 005A,E01019867,1122,762,360,237,52,71
2011,South Derbyshire 005B,E01019868,1187,876,311,198,39,74
2011,South Derbyshire 005C,E01019869,1166,679,487,157,273,57
2011,South Derbyshire 005D,E01019880,1195,862,333,218,47,68
2011,South Derbyshire 006A,E01019843,1118,789,329,208,38,83
2011,South Derbyshire 006B,E01019853,1117,831,286,173,37,76
2011,South Derbyshire 006C,E01019854,1247,886,361,218,30,113
2011,South Derbyshire 006D,E01019855,1125,833,292,186,47,59
2011,South Derbyshire 007A,E01019844,1092,662,430,254,35,141
2011,South Derbyshire 007B,E01019856,1059,676,383,159,52,172
2011,South Derbyshire 007C,E01019857,945,758,187,88,33,66
2011,South Derbyshire 007D,E01019858,1116,724,392,182,47,163
2011,South Derbyshire 007E,E01019859,1266,884,382,272,33,77
2011,South Derbyshire 008A,E01019860,997,745,252,149,38,65
2011,South Derbyshire 008B,E01019861,1329,957,372,198,41,133
2011,South Derbyshire 008C,E01019862,1128,740,388,243,25,120
2011,South Derbyshire 008D,E01019863,1134,712,422,150,57,215
2011,South Derbyshire 008E,E01019864,1133,822,311,136,35,140
2011,South Derbyshire 008F,E01019865,998,696,302,122,40,140
2011,South Derbyshire 009A,E01019876,1404,965,439,238,49,152
2011,South Derbyshire 009B,E01019877,1171,805,366,172,29,165
2011,South Derbyshire 009C,E01019878,1157,828,329,171,28,130
2011,South Derbyshire 009D,E01019879,1478,1125,353,206,52,95
2011,South Derbyshire 011A,E01019850,1194,839,355,246,39,70
2011,South Derbyshire 011B,E01019851,1220,829,391,214,37,140
2011,South Derbyshire 011C,E01019852,1351,958,393,189,61,143
2011,South Derbyshire 011D,E01019870,1158,743,415,239,38,138
2011,South Derbyshire 011E,E01019871,1288,851,437,275,40,122
2011,South Derbyshire 011F,E01019872,1421,1008,413,243,30,140
2011,South Derbyshire 012A,E01019837,1401,1051,350,156,38,156
2011,South Derbyshire 012B,E01019838,1207,838,369,168,37,164
2011,South Derbyshire 012C,E01033531,1204,1067,137,45,28,64
2011,South Derbyshire 012D,E01033536,1204,955,249,105,27,117
2011,South Derbyshire 012E,E01033537,1232,881,351,180,36,135
2011,South Derbyshire 013A,E01019842,1197,730,467,184,49,234
2011,South Derbyshire 013B,E01019883,2057,1577,480,183,57,240
2011,South Derbyshire 013C,E01019885,1314,1005,309,140,37,132
2011,South Derbyshire 013D,E01033535,1091,921,170,70,38,62
2011,Blaby 002A,E01025631,855,649,206,127,34,45
2011,Blaby 002B,E01025632,1058,866,192,87,53,52
2011,Blaby 002C,E01025633,1269,958,311,200,43,68
2011,Blaby 002D,E01025635,888,641,247,158,38,51
2011,Blaby 003A,E01025634,1012,754,258,162,41,55
2011,Blaby 003B,E01025638,1005,644,361,277,37,47
2011,Blaby 003C,E01025639,854,590,264,174,27,63
2011,Blaby 003D,E01025640,1102,805,297,166,46,85
2011,Blaby 003E,E01025645,873,659,214,122,32,60
2011,Blaby 004A,E01025666,1054,736,318,167,44,107
2011,Blaby 004B,E01025667,845,631,214,132,22,60
2011,Blaby 004C,E01025668,1788,1505,283,118,64,101
2011,Blaby 004D,E01025669,1584,1387,197,53,51,93
2011,Blaby 005A,E01025636,907,650,257,161,32,64
2011,Blaby 005B,E01025637,959,710,249,140,25,84
2011,Blaby 005C,E01025652,1025,762,263,139,47,77
2011,Blaby 005D,E01025653,1146,871,275,131,52,92
2011,Blaby 005E,E01025654,876,617,259,149,41,69
2011,Blaby 005F,E01025655,1144,828,316,177,35,104
2011,Blaby 005G,E01025656,972,749,223,121,45,57
2011,Blaby 006A,E01025625,854,621,233,119,32,82
2011,Blaby 006B,E01025626,965,754,211,106,40,65
2011,Blaby 006C,E01025627,1573,1182,391,217,63,111
2011,Blaby 006D,E01025651,1223,931,292,174,48,70
2011,Blaby 006E,E01025657,1364,1041,323,176,45,102
2011,Blaby 006F,E01025660,1197,864,333,216,43,74
2011,Blaby 007A,E01025641,1339,1008,331,231,35,65
2011,Blaby 007B,E01025642,1373,1072,301,162,56,83
2011,Blaby 007C,E01025643,1176,920,256,145,48,63
2011,Blaby 007D,E01025649,1195,880,315,233,42,40
2011,Blaby 007E,E01025650,1177,952,225,119,57,49
2011,Blaby 008A,E01025610,1096,789,307,175,40,92
2011,Blaby 008B,E01025611,1078,760,318,208,42,68
2011,Blaby 008C,E01025612,1197,813,384,266,39,79
2011,Blaby 008D,E01025658,1903,1158,745,185,66,494
2011,Blaby 008E,E01025659,1330,969,361,248,46,67
2011,Blaby 009A,E01025615,1156,948,208,109,55,44
2011,Blaby 009B,E01025646,1151,857,294,155,45,94
2011,Blaby 009C,E01025647,1171,854,317,193,32,92
2011,Blaby 009D,E01025648,1457,1211,246,124,61,61
2011,Blaby 010A,E01025613,1039,712,327,215,45,67
2011,Blaby 010B,E01025614,1295,989,306,199,41,66
2011,Blaby 010C,E01025620,768,544,224,133,27,64
2011,Blaby 010D,E01025621,796,583,213,162,10,41
2011,Blaby 010E,E01025644,1046,783,263,164,35,64
2011,Blaby 011A,E01025616,1224,910,314,208,46,60
2011,Blaby 011B,E01025617,1277,899,378,289,36,53
2011,Blaby 011C,E01025618,1180,832,348,200,45,103
2011,Blaby 011D,E01025619,1238,872,366,263,51,52
2011,Blaby 012A,E01025661,1279,1019,260,153,34,73
2011,Blaby 012B,E01025662,1100,774,326,185,35,106
2011,Blaby 012C,E01025663,1082,780,302,200,40,62
2011,Blaby 012D,E01025664,935,643,292,221,25,46
2011,Blaby 012E,E01025665,1119,779,340,259,27,54
2011,Blaby 013A,E01025622,1189,867,322,219,36,67
2011,Blaby 013B,E01025623,1110,815,295,201,34,60
2011,Blaby 013C,E01025624,1361,1023,338,182,62,94
2011,Blaby 013D,E01025629,1064,724,340,223,37,80
2011,Blaby 013E,E01025630,1209,832,377,242,49,86
2011,Blaby 013F,E01032603,1056,685,371,281,36,54
2011,Charnwood 001B,E01025692,1524,1184,340,161,84,95
2011,Charnwood 001C,E01025693,1439,1026,413,264,71,78
2011,Charnwood 001E,E01033386,1744,1274,470,254,74,142
2011,Charnwood 002A,E01025699,1093,649,444,131,77,236
2011,Charnwood 002B,E01025700,1315,879,436,81,101,254
2011,Charnwood 002C,E01025701,1150,743,407,129,80,198
2011,Charnwood 002D,E01025703,1554,1087,467,111,177,179
2011,Charnwood 002E,E01025704,1174,779,395,103,186,106
2011,Charnwood 002F,E01025705,984,740,244,51,74,119
2011,Charnwood 002G,E01025706,1255,892,363,139,61,163
2011,Charnwood 003A,E01025720,1864,762,1102,86,936,80
2011,Charnwood 003B,E01025721,1458,567,891,115,719,57
2011,Charnwood 003C,E01025722,784,540,244,122,75,47
2011,Charnwood 003D,E01025723,1897,813,1084,72,903,109
2011,Charnwood 003E,E01025724,1411,671,740,35,648,57
2011,Charnwood 003F,E01025725,954,556,398,145,85,168
2011,Charnwood 004A,E01025695,1200,809,391,239,98,54
2011,Charnwood 004B,E01025696,1079,787,292,167,57,68
2011,Charnwood 004C,E01025697,959,589,370,204,94,72
2011,Charnwood 004D,E01025698,1230,886,344,176,107,61
2011,Charnwood 005A,E01025744,1465,1089,376,240,55,81
2011,Charnwood 005B,E01025745,1096,744,352,238,35,79
2011,Charnwood 005C,E01025746,1291,930,361,200,47,114
2011,Charnwood 005D,E01025747,1317,948,369,186,43,140
2011,Charnwood 006A,E01025740,1175,853,322,178,34,110
2011,Charnwood 006B,E01025741,1198,923,275,176,40,59
2011,Charnwood 006C,E01025742,1163,772,391,200,51,140
2011,Charnwood 006D,E01025743,1377,1070,307,179,39,89
2011,Charnwood 007A,E01025689,2174,959,1215,170,881,164
2011,Charnwood 007B,E01025690,3527,1095,2432,92,2179,161
2011,Charnwood 007C,E01025707,1458,663,795,204,527,64
2011,Charnwood 007D,E01025709,2037,856,1181,129,1015,37
2011,Charnwood 008A,E01025760,984,729,255,169,34,52
2011,Charnwood 008B,E01025761,1290,995,295,188,54,53
2011,Charnwood 008C,E01025768,1037,740,297,204,48,45
2011,Charnwood 008D,E01025769,1118,799,319,174,88,57
2011,Charnwood 009A,E01025702,976,707,269,159,50,60
2011,Charnwood 009B,E01025715,1080,751,329,115,85,129
2011,Charnwood 009C,E01025716,1095,772,323,123,81,119
2011,Charnwood 009D,E01025717,1536,1090,446,140,101,205
2011,Charnwood 009E,E01025718,1087,592,495,98,289,108
2011,Charnwood 009F,E01025719,1167,699,468,175,235,58
2011,Charnwood 010A,E01025708,944,575,369,256,72,41
2011,Charnwood 010B,E01025710,854,592,262,161,47,54
2011,Charnwood 010C,E01025711,1054,714,340,227,59,54
2011,Charnwood 010D,E01025712,929,596,333,224,58,51
2011,Charnwood 010E,E01025713,1162,669,493,133,292,68
2011,Charnwood 010F,E01025714,1564,1275,289,115,95,79
2011,Charnwood 011A,E01025674,1148,838,310,190,51,69
2011,Charnwood 011B,E01025675,1131,826,305,196,61,48
2011,Charnwood 011C,E01025676,1549,1170,379,232,64,83
2011,Charnwood 011D,E01025677,971,681,290,168,40,82
2011,Charnwood 012A,E01025732,1186,907,279,157,39,83
2011,Charnwood 012B,E01025733,1107,798,309,206,39,64
2011,Charnwood 012C,E01025734,1087,722,365,231,67,67
2011,Charnwood 012D,E01025735,1359,1024,335,212,38,85
2011,Charnwood 013A,E01025748,1635,1273,362,161,66,135
2011,Charnwood 013B,E01025749,1138,802,336,160,57,119
2011,Charnwood 013C,E01025750,1083,828,255,170,34,51
2011,Charnwood 013D,E01025751,1560,1239,321,145,52,124
2011,Charnwood 014A,E01025726,1424,1182,242,118,51,73
2011,Charnwood 014B,E01025727,1135,796,339,142,55,142
2011,Charnwood 014C,E01025728,1327,978,349,217,47,85
2011,Charnwood 014D,E01025729,1215,955,260,169,40,51
2011,Charnwood 014E,E01025737,1301,1051,250,140,36,74
2011,Charnwood 014F,E01025739,1008,697,311,211,37,63
2011,Charnwood 015A,E01025685,996,724,272,180,38,54
2011,Charnwood 015B,E01025686,1113,847,266,156,41,69
2011,Charnwood 015C,E01025730,1113,826,287,208,36,43
2011,Charnwood 015D,E01025731,1104,810,294,200,41,53
2011,Charnwood 016A,E01025687,1170,789,381,252,59,70
2011,Charnwood 016B,E01025688,1432,826,606,174,347,85
2011,Charnwood 016C,E01025736,1056,743,313,216,39,58
2011,Charnwood 016D,E01025738,1061,744,317,201,56,60
2011,Charnwood 017A,E01025756,1433,1085,348,161,56,131
2011,Charnwood 017B,E01025757,1124,892,232,92,57,83
2011,Charnwood 017C,E01025758,1302,989,313,152,67,94
2011,Charnwood 017D,E01025759,997,679,318,214,40,64
2011,Charnwood 018A,E01025752,1498,1136,362,202,56,104
2011,Charnwood 018B,E01025753,1057,756,301,161,33,107
2011,Charnwood 018C,E01025754,989,710,279,172,49,58
2011,Charnwood 018D,E01025755,1089,814,275,150,58,67
2011,Charnwood 019A,E01025679,1725,1280,445,244,87,114
2011,Charnwood 019B,E01025680,1179,838,341,215,56,70
2011,Charnwood 019C,E01025681,1166,834,332,212,51,69
2011,Charnwood 019D,E01025682,1073,696,377,264,56,57
2011,Charnwood 020A,E01025678,1246,971,275,157,63,55
2011,Charnwood 020B,E01025683,1207,891,316,164,64,88
2011,Charnwood 020C,E01025684,1351,1028,323,188,72,63
2011,Charnwood 021A,E01025762,1110,784,326,187,48,91
2011,Charnwood 021B,E01025763,1169,820,349,186,45,118
2011,Charnwood 021C,E01025764,1043,735,308,159,64,85
2011,Charnwood 021D,E01025765,1196,790,406,206,92,108
2011,Charnwood 021E,E01025766,1488,1117,371,148,75,148
2011,Charnwood 021F,E01025767,1117,820,297,157,60,80
2011,Charnwood 022A,E01025670,957,671,286,171,30,85
2011,Charnwood 022B,E01025671,1353,994,359,233,42,84
2011,Charnwood 022C,E01025672,1308,959,349,220,46,83
2011,Charnwood 022D,E01025673,1158,814,344,227,39,78
2011,Harborough 002A,E01025770,1356,976,380,214,69,97
2011,Harborough 002B,E01025809,1613,1164,449,266,53,130
2011,Harborough 002C,E01025815,1545,1088,457,278,65,114
2011,Harborough 003A,E01025781,1134,837,297,160,58,79
2011,Harborough 003B,E01025782,914,640,274,192,41,41
2011,Harborough 003C,E01025783,1085,735,350,239,47,64
2011,Harborough 003D,E01025785,1518,1155,363,217,59,87
2011,Harborough 003E,E01025786,1118,827,291,171,49,71
2011,Harborough 003F,E01025787,1228,849,379,270,51,58
2011,Harborough 004A,E01025772,1657,1365,292,134,70,88
2011,Harborough 004B,E01025773,1085,895,190,103,39,48
2011,Harborough 004C,E01025774,984,796,188,96,45,47
2011,Harborough 004D,E01025775,1298,973,325,203,30,92
2011,Harborough 004E,E01025776,1483,1152,331,183,62,86
2011,Harborough 005A,E01025771,1873,1400,473,291,47,135
2011,Harborough 005B,E01025778,1428,1141,287,154,64,69
2011,Harborough 005C,E01025779,1194,938,256,154,40,62
2011,Harborough 005D,E01025780,1002,758,244,161,40,43
2011,Harborough 005E,E01025784,1028,734,294,140,48,106
2011,Harborough 005F,E01025788,885,662,223,125,42,56
2011,Harborough 006A,E01025777,1668,1237,431,278,64,89
2011,Harborough 006B,E01025808,1883,1447,436,275,50,111
2011,Harborough 006C,E01025810,1743,1321,422,274,59,89
2011,Harborough 006D,E01025816,1674,1214,460,276,55,129
2011,Harborough 007A,E01025789,1467,859,608,139,43,426
2011,Harborough 007B,E01025794,1345,1012,333,192,53,88
2011,Harborough 007C,E01025797,1217,867,350,243,31,76
2011,Harborough 007D,E01025802,947,658,289,214,26,49
2011,Harborough 007E,E01025803,1142,864,278,188,43,47
2011,Harborough 007F,E01025805,1135,781,354,254,31,69
2011,Harborough 008A,E01025795,1304,874,430,198,145,87
2011,Harborough 008B,E01025796,1412,1089,323,162,51,110
2011,Harborough 008C,E01025801,919,650,269,140,60,69
2011,Harborough 008D,E01025806,1028,729,299,144,48,107
2011,Harborough 009A,E01025798,1276,944,332,239,33,60
2011,Harborough 009B,E01025799,1419,1198,221,99,51,71
2011,Harborough 009C,E01025800,877,687,190,124,25,41
2011,Harborough 009D,E01025804,1323,937,386,271,27,88
2011,Harborough 009E,E01025807,1042,836,206,79,40,87
2011,Harborough 010A,E01025790,1673,1253,420,274,58,88
2011,Harborough 010B,E01025791,1551,1092,459,307,50,102
2011,Harborough 010C,E01025792,1662,1214,448,292,56,100
2011,Harborough 010D,E01025793,1864,1404,460,260,67,133
2011,Harborough 011A,E01025812,1181,869,312,208,36,68
2011,Harborough 011B,E01025813,1129,801,328,205,70,53
2011,Harborough 011C,E01025814,1090,744,346,254,47,45
2011,Harborough 011D,E01032598,1514,1125,389,229,77,83
2011,Hinckley and Bosworth 001A,E01025868,1101,762,339,227,39,73
2011,Hinckley and Bosworth 001B,E01025869,1101,764,337,236,35,66
2011,Hinckley and Bosworth 001C,E01025870,996,730,266,184,40,42
2011,Hinckley and Bosworth 001D,E01025871,920,669,251,160,32,59
2011,Hinckley and Bosworth 001E,E01025878,1860,1421,439,254,57,128
2011,Hinckley and Bosworth 002A,E01025846,1491,1113,378,259,62,57
2011,Hinckley and Bosworth 002B,E01025847,1271,1017,254,141,51,62
2011,Hinckley and Bosworth 002C,E01025848,1136,787,349,251,34,64
2011,Hinckley and Bosworth 003A,E01025845,1189,823,366,252,55,59
2011,Hinckley and Bosworth 003B,E01025877,1196,896,300,191,38,71
2011,Hinckley and Bosworth 003C,E01025879,887,627,260,141,30,89
2011,Hinckley and Bosworth 003D,E01025880,1161,905,256,173,42,41
2011,Hinckley and Bosworth 004A,E01025819,1228,850,378,245,46,87
2011,Hinckley and Bosworth 004B,E01025820,1245,952,293,167,48,78
2011,Hinckley and Bosworth 004C,E01025837,1503,1097,406,271,46,89
2011,Hinckley and Bosworth 004D,E01025838,1021,659,362,269,34,59
2011,Hinckley and Bosworth 004E,E01025882,1188,868,320,210,27,83
2011,Hinckley and Bosworth 005A,E01025872,1191,784,407,320,32,55
2011,Hinckley and Bosworth 005B,E01025873,1203,896,307,189,44,74
2011,Hinckley and Bosworth 005C,E01025874,1139,792,347,237,33,77
2011,Hinckley and Bosworth 005D,E01025875,1053,736,317,164,49,104
2011,Hinckley and Bosworth 005E,E01025876,1397,981,416,269,47,100
2011,Hinckley and Bosworth 006A,E01025839,1240,943,297,154,51,92
2011,Hinckley and Bosworth 006B,E01025840,1154,843,311,190,35,86
2011,Hinckley and Bosworth 006C,E01025841,1270,869,401,280,40,81
2011,Hinckley and Bosworth 006D,E01025842,1258,930,328,151,45,132
2011,Hinckley and Bosworth 006E,E01025843,1195,871,324,183,30,111
2011,Hinckley and Bosworth 006F,E01025844,1226,838,388,142,49,197
2011,Hinckley and Bosworth 007A,E01025821,1267,1016,251,126,29,96
2011,Hinckley and Bosworth 007B,E01025822,1033,716,317,171,33,113
2011,Hinckley and Bosworth 007C,E01025823,1140,834,306,149,43,114
2011,Hinckley and Bosworth 007D,E01025824,1094,797,297,162,43,92
2011,Hinckley and Bosworth 007E,E01025825,1132,806,326,207,32,87
2011,Hinckley and Bosworth 007F,E01025826,1072,835,237,127,44,66
2011,Hinckley and Bosworth 008A,E01025817,1485,1021,464,323,37,104
2011,Hinckley and Bosworth 008B,E01025818,1086,757,329,186,60,83
2011,Hinckley and Bosworth 008C,E01025864,1161,926,235,124,46,65
2011,Hinckley and Bosworth 008D,E01025881,1032,691,341,261,24,56
2011,Hinckley and Bosworth 009A,E01025859,1054,760,294,187,42,65
2011,Hinckley and Bosworth 009B,E01025860,1116,863,253,164,38,51
2011,Hinckley and Bosworth 009C,E01025861,1276,956,320,198,47,75
2011,Hinckley and Bosworth 009D,E01025862,1059,691,368,283,32,53
2011,Hinckley and Bosworth 010A,E01025850,1031,791,240,140,32,68
2011,Hinckley and Bosworth 010B,E01025852,1309,1012,297,108,37,152
2011,Hinckley and Bosworth 010C,E01025858,1432,1125,307,140,46,121
2011,Hinckley and Bosworth 010D,E01025863,1183,835,348,205,46,97
2011,Hinckley and Bosworth 010E,E01025865,1305,964,341,162,43,136
2011,Hinckley and Bosworth 011A,E01025853,2091,1678,413,207,60,146
2011,Hinckley and Bosworth 011B,E01025854,1329,1059,270,152,46,72
2011,Hinckley and Bosworth 011C,E01025855,1066,827,239,146,24,69
2011,Hinckley and Bosworth 011D,E01025866,1194,780,414,220,33,161
2011,Hinckley and Bosworth 011E,E01025867,1196,871,325,200,36,89
2011,Hinckley and Bosworth 012A,E01025849,1247,956,291,161,41,89
2011,Hinckley and Bosworth 012B,E01025851,953,654,299,202,32,65
2011,Hinckley and Bosworth 012C,E01025856,897,568,329,148,24,157
2011,Hinckley and Bosworth 012D,E01025857,1116,875,241,121,34,86
2011,Hinckley and Bosworth 013A,E01025827,943,596,347,224,29,94
2011,Hinckley and Bosworth 013B,E01025828,1051,692,359,253,38,68
2011,Hinckley and Bosworth 013C,E01025829,1004,678,326,156,48,122
2011,Hinckley and Bosworth 013D,E01025830,977,697,280,169,31,80
2011,Hinckley and Bosworth 014A,E01025831,972,710,262,179,32,51
2011,Hinckley and Bosworth 014B,E01025832,1188,908,280,172,39,69
2011,Hinckley and Bosworth 014C,E01025833,1143,844,299,191,39,69
2011,Hinckley and Bosworth 014D,E01025834,1117,852,265,196,24,45
2011,Hinckley and Bosworth 014E,E01025835,1153,756,397,294,49,54
2011,Hinckley and Bosworth 014F,E01025836,992,718,274,200,31,43
2011,Melton 001A,E01025885,1321,953,368,240,52,76
2011,Melton 001B,E01025886,1209,858,351,251,30,70
2011,Melton 001C,E01025887,1366,997,369,230,50,89
2011,Melton 001D,E01025890,913,678,235,127,27,81
2011,Melton 001E,E01025891,936,700,236,143,40,53
2011,Melton 001F,E01025892,1185,894,291,189,36,66
2011,Melton 002A,E01025901,1239,831,408,319,35,54
2011,Melton 002B,E01025902,1184,847,337,233,42,62
2011,Melton 002C,E01025903,1355,1117,238,123,33,82
2011,Melton 002D,E01025904,1396,1059,337,242,29,66
2011,Melton 002E,E01025906,1302,1057,245,151,38,56
2011,Melton 003A,E01025883,1242,913,329,231,39,59
2011,Melton 003B,E01025884,1207,958,249,152,32,65
2011,Melton 003C,E01025888,1345,1023,322,193,59,70
2011,Melton 003D,E01025909,1437,1079,358,236,38,84
2011,Melton 004A,E01025896,1208,863,345,254,31,60
2011,Melton 004B,E01025897,1486,1155,331,167,45,119
2011,Melton 004C,E01025898,972,737,235,132,39,64
2011,Melton 004D,E01025899,876,698,178,83,28,67
2011,Melton 004E,E01025900,1045,751,294,111,48,135
2011,Melton 004F,E01025905,1212,842,370,186,48,136
2011,Melton 005A,E01025893,1617,1194,423,294,49,80
2011,Melton 005B,E01025894,1081,754,327,187,27,113
2011,Melton 005C,E01025895,1299,1025,274,131,43,100
2011,Melton 005D,E01025907,1297,871,426,189,67,170
2011,Melton 005E,E01025908,1292,943,349,237,53,59
2011,Melton 006A,E01025889,1305,935,370,240,48,82
2011,Melton 006B,E01025910,1313,969,344,204,51,89
2011,Melton 006C,E01025911,1138,848,290,175,45,70
2011,Melton 006D,E01025912,1177,873,304,181,29,94
2011,North West Leicestershire 001A,E01025924,781,592,189,114,22,53
2011,North West Leicestershire 001B,E01025925,1948,1471,477,282,42,153
2011,North West Leicestershire 001C,E01025926,1183,830,353,211,50,92
2011,North West Leicestershire 001D,E01025927,1165,803,362,220,30,112
2011,North West Leicestershire 001E,E01025928,1149,877,272,189,29,54
2011,North West Leicestershire 002A,E01025923,1041,716,325,223,37,65
2011,North West Leicestershire 002B,E01025944,1132,823,309,208,46,55
2011,North West Leicestershire 002C,E01025945,1155,782,373,193,117,63
2011,North West Leicestershire 002D,E01025946,1274,803,471,183,186,102
2011,North West Leicestershire 003A,E01025915,904,653,251,151,65,35
2011,North West Leicestershire 003B,E01025916,1122,854,268,159,41,68
2011,North West Leicestershire 003C,E01025917,1507,1158,349,194,49,106
2011,North West Leicestershire 003D,E01025918,1113,778,335,154,48,133
2011,North West Leicestershire 004A,E01025960,1137,754,383,244,36,103
2011,North West Leicestershire 004B,E01025961,1102,770,332,233,27,72
2011,North West Leicestershire 004C,E01025962,1033,670,363,191,45,127
2011,North West Leicestershire 004D,E01025965,998,713,285,163,33,89
2011,North West Leicestershire 005A,E01025955,985,673,312,222,29,61
2011,North West Leicestershire 005B,E01025956,832,588,244,139,24,81
2011,North West Leicestershire 005C,E01025963,1124,812,312,185,26,101
2011,North West Leicestershire 005D,E01025964,1238,871,367,238,48,81
2011,North West Leicestershire 006A,E01025914,998,722,276,190,46,40
2011,North West Leicestershire 006B,E01025919,1073,725,348,196,47,105
2011,North West Leicestershire 006C,E01025920,1099,743,356,194,40,122
2011,North West Leicestershire 006D,E01025921,1151,780,371,252,49,70
2011,North West Leicestershire 007A,E01025966,1140,763,377,195,56,126
2011,North West Leicestershire 007B,E01025967,1205,750,455,334,32,89
2011,North West Leicestershire 007C,E01025968,1416,1051,365,224,50,91
2011,North West Leicestershire 007D,E01025969,1332,1041,291,158,49,84
2011,North West Leicestershire 008A,E01025950,1174,793,381,175,41,165
2011,North West Leicestershire 008B,E01025951,1303,964,339,189,56,94
2011,North West Leicestershire 008C,E01025952,1074,666,408,282,42,84
2011,North West Leicestershire 008D,E01025953,798,583,215,99,26,90
2011,North West Leicestershire 008E,E01025954,1094,840,254,128,38,88
2011,North West Leicestershire 009A,E01025932,1028,653,375,115,46,214
2011,North West Leicestershire 009B,E01025933,1045,703,342,174,47,121
2011,North West Leicestershire 009C,E01025934,1120,708,412,130,53,229
2011,North West Leicestershire 009D,E01025935,821,487,334,261,18,55
2011,North West Leicestershire 009E,E01025936,873,555,318,199,26,93
2011,North West Leicestershire 010A,E01025929,1570,1221,349,155,70,124
2011,North West Leicestershire 010B,E01025930,1208,920,288,112,41,135
2011,North West Leicestershire 010C,E01025931,1311,976,335,157,39,139
2011,North West Leicestershire 010D,E01025957,1328,983,345,144,41,160
2011,North West Leicestershire 011B,E01025937,1162,834,328,188,46,94
2011,North West Leicestershire 011C,E01025958,1203,928,275,144,39,92
2011,North West Leicestershire 011D,E01025959,1536,1109,427,253,61,113
2011,North West Leicestershire 011E,E01033102,1192,984,208,93,24,91
2011,North West Leicestershire 011F,E01033103,1292,1040,252,132,48,72
2011,North West Leicestershire 012A,E01025913,1665,1226,439,284,49,106
2011,North West Leicestershire 012B,E01025947,1390,953,437,300,42,95
2011,North West Leicestershire 012C,E01025948,1229,982,247,107,43,97
2011,North West Leicestershire 012D,E01025949,1179,787,392,176,54,162
2011,North West Leicestershire 013A,E01025938,931,684,247,137,24,86
2011,North West Leicestershire 013B,E01025939,1452,1078,374,178,60,136
2011,North West Leicestershire 013C,E01025940,1432,1060,372,199,40,133
2011,North West Leicestershire 013D,E01025941,1144,810,334,219,29,86
2011,North West Leicestershire 013E,E01025942,1357,1008,349,224,40,85
2011,North West Leicestershire 013F,E01025943,1308,898,410,232,29,149
2011,Oadby and Wigston 003A,E01025970,1019,703,316,189,72,55
2011,Oadby and Wigston 003B,E01025971,874,577,297,167,77,53
2011,Oadby and Wigston 003C,E01025972,865,586,279,151,54,74
2011,Oadby and Wigston 003D,E01025976,930,601,329,161,61,107
2011,Oadby and Wigston 003E,E01025977,926,634,292,176,51,65
2011,Oadby and Wigston 003F,E01025978,1095,738,357,178,65,114
2011,Oadby and Wigston 005A,E01025992,1061,734,327,179,34,114
2011,Oadby and Wigston 005B,E01025994,1035,698,337,131,72,134
2011,Oadby and Wigston 005C,E01025997,1025,718,307,123,77,107
2011,Oadby and Wigston 005D,E01025999,1031,748,283,142,39,102
2011,Oadby and Wigston 005E,E01026005,1183,869,314,167,50,97
2011,Oadby and Wigston 006A,E01025985,956,588,368,274,25,69
2011,Oadby and Wigston 006B,E01025986,1046,703,343,233,39,71
2011,Oadby and Wigston 006C,E01025987,1085,820,265,90,45,130
2011,Oadby and Wigston 006D,E01025988,1153,898,255,73,43,139
2011,Oadby and Wigston 006E,E01025989,1227,931,296,111,52,133
2011,Oadby and Wigston 007A,E01025990,1040,684,356,262,38,56
2011,Oadby and Wigston 007B,E01025991,1119,750,369,260,43,66
2011,Oadby and Wigston 007C,E01025993,1064,757,307,220,29,58
2011,Oadby and Wigston 007D,E01025998,1393,1082,311,180,56,75
2011,Oadby and Wigston 007E,E01026000,1017,723,294,200,33,61
2011,Oadby and Wigston 007F,E01026001,1051,815,236,156,29,51
2011,Oadby and Wigston 008A,E01025995,1037,724,313,176,51,86
2011,Oadby and Wigston 008B,E01026003,1153,812,341,196,52,93
2011,Oadby and Wigston 008C,E01026004,1226,883,343,228,59,56
2011,Oadby and Wigston 008D,E01032600,1383,1004,379,219,67,93
2011,Oadby and Wigston 008E,E01032601,1068,784,284,180,45,59
2011,Oadby and Wigston 009A,E01025973,2323,1147,1176,160,895,121
2011,Oadby and Wigston 009B,E01025974,1884,994,890,118,697,75
2011,Oadby and Wigston 009C,E01025975,1024,673,351,187,91,73
2011,Oadby and Wigston 009E,E01025979,969,720,249,121,63,65
2011,Oadby and Wigston 009D,E01025980,1011,674,337,170,95,72
2011,Oadby and Wigston 009F,E01025981,1172,819,353,168,93,92
2011,Oadby and Wigston 009G,E01025982,1394,1077,317,118,117,82
2011,Oadby and Wigston 009H,E01025983,907,669,238,113,61,64
2011,Oadby and Wigston 009I,E01025984,1051,782,269,125,85,59
2011,Boston 001A,E01026007,812,570,242,166,14,62
2011,Boston 001B,E01026008,1200,686,514,218,25,271
2011,Boston 001C,E01026009,948,630,318,190,26,102
2011,Boston 001D,E01026023,1050,633,417,251,30,136
2011,Boston 001E,E01026024,1429,922,507,275,62,170
2011,Boston 002A,E01026010,1038,669,369,91,30,248
2011,Boston 002B,E01026011,2142,1561,581,199,87,295
2011,Boston 002C,E01026030,1584,1065,519,261,38,220
2011,Boston 002D,E01026032,1512,1137,375,173,52,150
2011,Boston 002E,E01026037,934,667,267,108,31,128
2011,Boston 003A,E01026006,2042,1660,382,126,48,208
2011,Boston 003B,E01026021,1277,942,335,215,29,91
2011,Boston 003C,E01026025,1716,1317,399,133,84,182
2011,Boston 003D,E01026036,1267,1019,248,102,35,111
2011,Boston 004A,E01026012,775,439,336,218,22,96
2011,Boston 004B,E01026015,1096,862,234,124,30,80
2011,Boston 004C,E01026026,1328,846,482,192,55,235
2011,Boston 004D,E01026027,1376,1001,375,206,56,113
2011,Boston 004E,E01026028,1293,873,420,230,38,152
2011,Boston 006A,E01026016,1717,1104,613,385,60,168
2011,Boston 006B,E01026033,1466,1028,438,259,41,138
2011,Boston 006C,E01026034,1302,864,438,278,33,127
2011,Boston 007A,E01026017,1170,773,397,228,33,136
2011,Boston 007B,E01026018,1276,824,452,314,29,109
2011,Boston 007C,E01026019,1906,1329,577,260,69,248
2011,Boston 007D,E01026020,1647,1148,499,305,50,144
2011,Boston 007E,E01026041,887,599,288,173,22,93
2011,Boston 008A,E01026013,1053,748,305,197,32,76
2011,Boston 008B,E01026014,1386,956,430,280,49,101
2011,Boston 008C,E01026022,1488,986,502,351,49,102
2011,Boston 008D,E01026038,958,703,255,162,35,58
2011,Boston 008E,E01026040,917,683,234,148,22,64
2011,Boston 009A,E01026029,1822,1404,418,233,41,144
2011,Boston 009B,E01026031,1066,690,376,282,16,78
2011,Boston 009C,E01026035,1546,1088,458,321,51,86
2011,Boston 009D,E01026039,880,605,275,188,23,64
2011,East Lindsey 001A,E01026045,1378,811,567,375,41,151
2011,East Lindsey 001B,E01026061,946,651,295,215,32,48
2011,East Lindsey 001C,E01026062,883,650,233,148,18,67
2011,East Lindsey 001D,E01026063,938,592,346,263,30,53
2011,East Lindsey 001E,E01026080,1477,962,515,337,62,116
2011,East Lindsey 001F,E01026106,897,585,312,205,30,77
2011,East Lindsey 001G,E01026107,971,674,297,147,65,85
2011,East Lindsey 002A,E01026058,1632,1087,545,350,58,137
2011,East Lindsey 002B,E01026076,1653,1101,552,374,40,138
2011,East Lindsey 002C,E01026079,1433,864,569,347,63,159
2011,East Lindsey 003A,E01026077,806,529,277,156,33,88
2011,East Lindsey 003B,E01026078,810,538,272,123,30,119
2011,East Lindsey 003C,E01026087,800,508,292,135,23,134
2011,East Lindsey 003D,E01026088,912,611,301,207,34,60
2011,East Lindsey 003E,E01026090,985,660,325,194,31,100
2011,East Lindsey 003F,E01026091,816,603,213,124,25,64
2011,East Lindsey 003G,E01026108,1712,1084,628,252,67,309
2011,East Lindsey 004A,E01026081,1761,1285,476,249,66,161
2011,East Lindsey 004C,E01026089,1458,952,506,343,44,119
2011,East Lindsey 004D,E01032986,838,586,252,133,24,95
2011,East Lindsey 004E,E01032987,964,716,248,133,24,91
2011,East Lindsey 005A,E01026072,1387,630,757,451,39,267
2011,East Lindsey 005B,E01026073,1438,675,763,412,50,301
2011,East Lindsey 005C,E01026074,1540,621,919,572,50,297
2011,East Lindsey 005D,E01026099,1558,882,676,424,43,209
2011,East Lindsey 006A,E01026103,1424,579,845,585,38,222
2011,East Lindsey 006B,E01026104,1605,605,1000,730,42,228
2011,East Lindsey 006C,E01026109,1701,678,1023,716,48,259
2011,East Lindsey 007A,E01026071,1612,1045,567,384,46,137
2011,East Lindsey 007B,E01026082,1676,1023,653,477,53,123
2011,East Lindsey 007C,E01026121,1802,1120,682,435,58,189
2011,East Lindsey 008A,E01026042,1082,698,384,185,44,155
2011,East Lindsey 008B,E01026043,1114,694,420,217,39,164
2011,East Lindsey 008C,E01026044,979,554,425,274,31,120
2011,East Lindsey 008D,E01026113,1510,870,640,428,56,156
2011,East Lindsey 008E,E01026117,1395,837,558,355,43,160
2011,East Lindsey 009A,E01026060,1024,608,416,277,38,101
2011,East Lindsey 009B,E01026068,1615,1009,606,378,45,183
2011,East Lindsey 009C,E01026070,1472,946,526,341,43,142
2011,East Lindsey 009D,E01026105,1638,1068,570,372,44,154
2011,East Lindsey 010A,E01026048,1165,536,629,398,24,207
2011,East Lindsey 010B,E01026049,1183,625,558,384,27,147
2011,East Lindsey 010C,E01026050,1167,507,660,486,22,152
2011,East Lindsey 010D,E01026069,1905,1058,847,501,46,300
2011,East Lindsey 011A,E01026064,1035,690,345,149,38,158
2011,East Lindsey 011B,E01026065,1238,801,437,329,34,74
2011,East Lindsey 011C,E01026066,1344,827,517,377,37,103
2011,East Lindsey 011D,E01026067,1377,923,454,221,53,180
2011,East Lindsey 012A,E01026084,1157,704,453,238,65,150
2011,East Lindsey 012B,E01026085,1640,868,772,569,23,180
2011,East Lindsey 012C,E01026115,1303,675,628,382,38,208
2011,East Lindsey 012D,E01026116,1247,801,446,230,47,169
2011,East Lindsey 013A,E01026046,838,540,298,177,28,93
2011,East Lindsey 013B,E01026047,891,496,395,305,20,70
2011,East Lindsey 013C,E01026055,839,485,354,232,26,96
2011,East Lindsey 013D,E01026059,903,494,409,221,89,99
2011,East Lindsey 013E,E01026100,1267,852,415,233,60,122
2011,East Lindsey 013F,E01026101,844,486,358,164,26,168
2011,East Lindsey 014A,E01026092,1073,689,384,153,39,192
2011,East Lindsey 014B,E01026093,1341,893,448,181,32,235
2011,East Lindsey 014C,E01026095,847,563,284,145,31,108
2011,East Lindsey 014D,E01026114,1110,720,390,205,33,152
2011,East Lindsey 015A,E01026083,1245,667,578,219,54,305
2011,East Lindsey 015B,E01026094,1185,630,555,312,35,208
2011,East Lindsey 015C,E01026096,1050,781,269,158,29,82
2011,East Lindsey 015D,E01026097,1030,540,490,302,44,144
2011,East Lindsey 016A,E01026051,966,688,278,181,26,71
2011,East Lindsey 016B,E01026052,1107,712,395,253,17,125
2011,East Lindsey 016C,E01026053,1381,1027,354,148,39,167
2011,East Lindsey 016D,E01026054,1667,1294,373,189,44,140
2011,East Lindsey 016E,E01026118,1173,650,523,422,24,77
2011,East Lindsey 016F,E01026119,743,410,333,272,21,40
2011,East Lindsey 016G,E01026120,946,604,342,218,31,93
2011,East Lindsey 017A,E01026056,863,548,315,195,27,93
2011,East Lindsey 017B,E01026110,1065,622,443,266,41,136
2011,East Lindsey 017C,E01026111,1147,673,474,274,36,164
2011,East Lindsey 017D,E01026112,800,430,370,137,36,197
2011,East Lindsey 018A,E01026057,1467,948,519,328,58,133
2011,East Lindsey 018B,E01026075,1602,996,606,384,46,176
2011,East Lindsey 018C,E01026098,1401,952,449,319,34,96
2011,East Lindsey 018D,E01026102,1734,1120,614,358,64,192
2011,Lincoln 001A,E01026149,1188,796,392,154,40,198
2011,Lincoln 001B,E01026150,1038,633,405,171,41,193
2011,Lincoln 001C,E01026166,867,542,325,123,53,149
2011,Lincoln 001D,E01026168,988,630,358,137,35,186
2011,Lincoln 002A,E01026153,1788,1384,404,220,52,132
2011,Lincoln 002B,E01026155,1282,1012,270,148,35,87
2011,Lincoln 002C,E01026157,924,538,386,176,31,179
2011,Lincoln 002D,E01026165,962,626,336,161,30,145
2011,Lincoln 003A,E01026125,1301,766,535,70,45,420
2011,Lincoln 003B,E01026144,1268,842,426,102,236,88
2011,Lincoln 003C,E01026147,1809,1408,401,186,94,121
2011,Lincoln 003D,E01026148,1430,1037,393,163,134,96
2011,Lincoln 003E,E01026151,1358,981,377,179,83,115
2011,Lincoln 003F,E01026164,1054,674,380,156,163,61
2011,Lincoln 003G,E01026167,1127,751,376,228,68,80
2011,Lincoln 004A,E01026122,1571,1122,449,97,226,126
2011,Lincoln 004B,E01026123,1700,1294,406,139,59,208
2011,Lincoln 004C,E01026124,1217,924,293,66,97,130
2011,Lincoln 004D,E01026126,1376,913,463,86,84,293
2011,Lincoln 004E,E01026152,1022,621,401,92,53,256
2011,Lincoln 004F,E01026154,1021,702,319,123,56,140
2011,Lincoln 004G,E01026156,904,622,282,99,42,141
2011,Lincoln 005A,E01026132,2575,1420,1155,109,959,87
2011,Lincoln 005B,E01026143,2000,1226,774,89,597,88
2011,Lincoln 005C,E01026145,1283,888,395,112,211,72
2011,Lincoln 005D,E01026146,1761,1018,743,117,533,93
2011,Lincoln 006A,E01026134,1162,863,299,120,47,132
2011,Lincoln 006B,E01026176,1426,983,443,82,160,201
2011,Lincoln 006C,E01026177,1525,1148,377,69,181,127
2011,Lincoln 006D,E01026178,1315,994,321,106,107,108
2011,Lincoln 007A,E01026127,989,669,320,117,29,174
2011,Lincoln 007B,E01026128,1954,1492,462,219,66,177
2011,Lincoln 007C,E01026129,1195,742,453,69,67,317
2011,Lincoln 007D,E01026131,1016,691,325,171,31,123
2011,Lincoln 008A,E01026133,2967,1878,1089,151,793,145
2011,Lincoln 008B,E01026135,1222,899,323,187,44,92
2011,Lincoln 008C,E01026136,1031,748,283,186,33,64
2011,Lincoln 008D,E01026174,1052,834,218,68,41,109
2011,Lincoln 009A,E01026130,1014,688,326,224,28,74
2011,Lincoln 009B,E01026158,1042,733,309,213,23,73
2011,Lincoln 009C,E01026159,1099,886,213,109,22,82
2011,Lincoln 009D,E01026160,1015,764,251,162,20,69
2011,Lincoln 009E,E01026162,1056,705,351,197,41,113
2011,Lincoln 009F,E01026163,1090,879,211,136,27,48
2011,Lincoln 010A,E01026161,997,669,328,145,30,153
2011,Lincoln 010B,E01026170,1038,649,389,140,63,186
2011,Lincoln 010C,E01026172,995,675,320,112,37,171
2011,Lincoln 010D,E01026173,1054,642,412,98,44,270
2011,Lincoln 010E,E01026175,1420,1052,368,121,36,211
2011,Lincoln 011A,E01026137,920,702,218,125,32,61
2011,Lincoln 011B,E01026138,1115,857,258,149,33,76
2011,Lincoln 011C,E01026139,869,637,232,166,22,44
2011,Lincoln 011D,E01026140,948,721,227,98,25,104
2011,Lincoln 011E,E01026141,1022,791,231,115,38,78
2011,Lincoln 011F,E01026142,952,670,282,127,45,110
2011,Lincoln 011G,E01026169,1177,775,402,231,40,131
2011,Lincoln 011H,E01026171,1086,717,369,299,25,45
2011,North Kesteven 001A,E01026186,1170,801,369,259,39,71
2011,North Kesteven 001B,E01026187,1420,1178,242,119,47,76
2011,North Kesteven 001C,E01026189,1296,838,458,363,31,64
2011,North Kesteven 001D,E01026203,1305,870,435,330,37,68
2011,North Kesteven 001E,E01026204,1246,822,424,329,37,58
2011,North Kesteven 001F,E01026206,1381,1038,343,215,47,81
2011,North Kesteven 003B,E01026182,1046,762,284,186,23,75
2011,North Kesteven 003C,E01026193,1070,748,322,209,44,69
2011,North Kesteven 003D,E01026199,1714,1146,568,371,48,149
2011,North Kesteven 003E,E01026225,1185,953,232,126,33,73
2011,North Kesteven 003F,E01026226,1364,881,483,398,30,55
2011,North Kesteven 003G,E01032990,1712,1487,225,51,56,118
2011,North Kesteven 003H,E01032994,983,753,230,155,24,51
2011,North Kesteven 004A,E01026184,1358,1174,184,60,31,93
2011,North Kesteven 004B,E01026185,1238,840,398,267,36,95
2011,North Kesteven 004C,E01026188,1515,1128,387,210,42,135
2011,North Kesteven 004D,E01026190,1045,670,375,236,30,109
2011,North Kesteven 004E,E01026237,843,575,268,198,17,53
2011,North Kesteven 004F,E01026238,988,733,255,147,28,80
2011,North Kesteven 005A,E01026191,1223,875,348,200,37,111
2011,North Kesteven 005B,E01026205,1014,691,323,206,24,93
2011,North Kesteven 005C,E01026211,1454,1056,398,245,40,113
2011,North Kesteven 005D,E01026212,1131,766,365,221,42,102
2011,North Kesteven 005E,E01026213,1189,718,471,311,42,118
2011,North Kesteven 006A,E01026192,904,601,303,178,49,76
2011,North Kesteven 006B,E01026194,1307,864,443,299,39,105
2011,North Kesteven 006C,E01026195,1402,955,447,311,45,91
2011,North Kesteven 006D,E01026196,1097,742,355,236,39,80
2011,North Kesteven 007A,E01026180,1069,717,352,224,26,102
2011,North Kesteven 007B,E01026183,1830,1125,705,408,71,226
2011,North Kesteven 007C,E01026210,1697,1134,563,348,64,151
2011,North Kesteven 007D,E01026224,1210,757,453,265,44,144
2011,North Kesteven 008A,E01026179,973,724,249,76,27,146
2011,North Kesteven 008B,E01026197,1037,742,295,195,31,69
2011,North Kesteven 008C,E01026198,1044,883,161,32,21,108
2011,North Kesteven 008D,E01026223,1532,1041,491,337,45,109
2011,North Kesteven 009A,E01026209,1519,950,569,437,34,98
2011,North Kesteven 009B,E01026221,1727,1138,589,380,65,144
2011,North Kesteven 009C,E01026222,1325,799,526,386,28,112
2011,North Kesteven 010A,E01026227,1047,786,261,132,25,104
2011,North Kesteven 010B,E01026230,862,609,253,139,29,85
2011,North Kesteven 010C,E01026231,1983,1558,425,242,77,106
2011,North Kesteven 010D,E01026232,1581,1083,498,286,61,151
2011,North Kesteven 010E,E01026235,1126,740,386,171,55,160
2011,North Kesteven 011A,E01026228,1119,857,262,130,54,78
2011,North Kesteven 011B,E01026229,1133,863,270,142,47,81
2011,North Kesteven 011C,E01026233,1238,920,318,200,53,65
2011,North Kesteven 011D,E01026234,2015,1521,494,274,91,129
2011,North Kesteven 011E,E01026236,836,511,325,224,25,76
2011,North Kesteven 012A,E01026200,1185,865,320,199,38,83
2011,North Kesteven 012B,E01026201,1443,878,565,365,56,144
2011,North Kesteven 012C,E01026202,1231,739,492,363,34,95
2011,North Kesteven 012D,E01026207,936,591,345,210,34,101
2011,North Kesteven 012E,E01026208,1197,849,348,226,40,82
2011,North Kesteven 013A,E01026220,1623,1007,616,442,47,127
2011,North Kesteven 013B,E01032988,1009,733,276,139,35,102
2011,North Kesteven 013C,E01032989,1018,854,164,44,49,71
2011,North Kesteven 013D,E01032993,1062,732,330,238,37,55
2011,North Kesteven 014A,E01026214,834,590,244,166,28,50
2011,North Kesteven 014B,E01026215,753,493,260,185,25,50
2011,North Kesteven 014C,E01026218,852,533,319,245,16,58
2011,North Kesteven 014D,E01026219,905,612,293,207,33,53
2011,North Kesteven 014E,E01032991,1067,774,293,211,24,58
2011,North Kesteven 014F,E01032992,998,692,306,186,30,90
2011,South Holland 001A,E01026242,1096,740,356,235,37,84
2011,South Holland 001B,E01026243,964,661,303,159,33,111
2011,South Holland 001C,E01026244,975,642,333,197,35,101
2011,South Holland 001D,E01026247,1356,922,434,276,34,124
2011,South Holland 001E,E01026276,1777,1210,567,348,39,180
2011,South Holland 002A,E01026246,1756,1097,659,374,66,219
2011,South Holland 002B,E01026248,1703,1188,515,269,75,171
2011,South Holland 002C,E01026257,1315,775,540,408,33,99
2011,South Holland 003A,E01026250,1289,921,368,197,40,131
2011,South Holland 003B,E01026251,1236,844,392,258,33,101
2011,South Holland 003C,E01026252,1185,768,417,277,44,96
2011,South Holland 003D,E01026253,1233,786,447,266,41,140
2011,South Holland 004A,E01026281,992,670,322,209,34,79
2011,South Holland 004B,E01026282,1217,794,423,284,29,110
2011,South Holland 004C,E01026283,1244,843,401,274,26,101
2011,South Holland 004D,E01026285,1059,706,353,225,32,96
2011,South Holland 004E,E01026286,927,625,302,170,31,101
2011,South Holland 005A,E01026241,1480,1130,350,172,42,136
2011,South Holland 005B,E01026258,1302,900,402,293,33,76
2011,South Holland 005C,E01026259,1309,914,395,219,45,131
2011,South Holland 005D,E01026260,1369,960,409,261,31,117
2011,South Holland 006B,E01026266,1529,1241,288,130,38,120
2011,South Holland 006C,E01026273,1216,820,396,288,31,77
2011,South Holland 006D,E01026274,1355,1052,303,176,39,88
2011,South Holland 006E,E01026275,1433,1058,375,248,26,101
2011,South Holland 006F,E01032995,1009,763,246,134,24,88
2011,South Holland 006G,E01032996,980,700,280,178,29,73
2011,South Holland 007A,E01026268,1405,979,426,234,39,153
2011,South Holland 007B,E01026269,1565,1084,481,330,47,104
2011,South Holland 007C,E01026270,1356,970,386,155,44,187
2011,South Holland 007D,E01026271,1280,891,389,161,51,177
2011,South Holland 007E,E01026272,924,669,255,166,19,70
2011,South Holland 008A,E01026254,1293,756,537,372,29,136
2011,South Holland 008B,E01026255,1398,913,485,318,38,129
2011,South Holland 008C,E01026256,1202,769,433,259,29,145
2011,South Holland 008D,E01026277,1136,745,391,165,48,178
2011,South Holland 008E,E01026278,1041,721,320,197,18,105
2011,South Holland 008F,E01026279,926,588,338,218,34,86
2011,South Holland 009A,E01026262,1184,843,341,236,30,75
2011,South Holland 009B,E01026263,1383,1103,280,160,37,83
2011,South Holland 009C,E01026264,1127,852,275,155,22,98
2011,South Holland 009D,E01026265,942,658,284,164,32,88
2011,South Holland 009E,E01026267,2104,1620,484,301,47,136
2011,South Holland 010A,E01026245,1555,969,586,366,38,182
2011,South Holland 010B,E01026249,1416,959,457,299,42,116
2011,South Holland 010C,E01026280,1897,1274,623,351,60,212
2011,South Holland 011A,E01026239,1278,960,318,188,33,97
2011,South Holland 011B,E01026240,1738,1233,505,311,47,147
2011,South Holland 011C,E01026284,1464,990,474,260,62,152
2011,South Kesteven 001A,E01026313,1125,816,309,215,36,58
2011,South Kesteven 001B,E01026314,896,659,237,145,32,60
2011,South Kesteven 001C,E01026329,1354,895,459,297,48,114
2011,South Kesteven 001D,E01026333,1847,1350,497,325,54,118
2011,South Kesteven 002A,E01026291,1426,945,481,329,43,109
2011,South Kesteven 002B,E01026340,1531,1015,516,338,49,129
2011,South Kesteven 002C,E01026355,1685,1132,553,370,63,120
2011,South Kesteven 002D,E01026365,1701,1089,612,457,48,107
2011,South Kesteven 003A,E01026325,998,679,319,133,38,148
2011,South Kesteven 003B,E01026326,1070,750,320,174,36,110
2011,South Kesteven 003C,E01026327,950,623,327,187,37,103
2011,South Kesteven 003D,E01026328,995,592,403,138,60,205
2011,South Kesteven 003E,E01026352,939,626,313,223,33,57
2011,South Kesteven 003F,E01026353,1133,793,340,178,27,135
2011,South Kesteven 003G,E01026354,925,634,291,213,26,52
2011,South Kesteven 004A,E01026320,1250,932,318,209,47,62
2011,South Kesteven 004B,E01026321,942,683,259,182,33,44
2011,South Kesteven 004C,E01026322,856,622,234,166,20,48
2011,South Kesteven 004D,E01026323,1377,993,384,182,41,161
2011,South Kesteven 004E,E01026324,1661,1296,365,224,53,88
2011,South Kesteven 005A,E01026308,1023,674,349,91,38,220
2011,South Kesteven 005B,E01026309,1188,846,342,194,48,100
2011,South Kesteven 005C,E01026310,861,593,268,117,36,115
2011,South Kesteven 005D,E01026311,1176,857,319,145,43,131
2011,South Kesteven 005E,E01026312,881,583,298,56,66,176
2011,South Kesteven 006A,E01026317,1619,1247,372,148,60,164
2011,South Kesteven 006B,E01026318,1404,1075,329,102,59,168
2011,South Kesteven 006C,E01026319,1592,1171,421,284,36,101
2011,South Kesteven 006D,E01026343,1368,1029,339,142,42,155
2011,South Kesteven 006E,E01026344,1163,915,248,132,43,73
2011,South Kesteven 006F,E01026345,1043,686,357,183,53,121
2011,South Kesteven 007A,E01026292,1089,843,246,161,21,64
2011,South Kesteven 007B,E01026293,1510,1190,320,186,32,102
2011,South Kesteven 007C,E01026294,1227,996,231,115,42,74
2011,South Kesteven 007D,E01026316,1773,1259,514,323,58,133
2011,South Kesteven 007E,E01026332,1624,1095,529,342,61,126
2011,South Kesteven 008A,E01026290,1621,1127,494,290,56,148
2011,South Kesteven 008B,E01026341,1076,721,355,234,30,91
2011,South Kesteven 008C,E01026342,1080,815,265,149,40,76
2011,South Kesteven 008D,E01026361,1926,1303,623,363,76,184
2011,South Kesteven 009A,E01026315,1528,1043,485,328,49,108
2011,South Kesteven 009B,E01026331,1770,1257,513,319,48,146
2011,South Kesteven 009C,E01026338,907,656,251,153,25,73
2011,South Kesteven 009D,E01026339,923,725,198,109,14,75
2011,South Kesteven 010A,E01026299,1164,837,327,176,42,109
2011,South Kesteven 010B,E01026300,1100,761,339,228,36,75
2011,South Kesteven 010C,E01026301,1156,764,392,290,29,73
2011,South Kesteven 010D,E01026302,891,721,170,98,32,40
2011,South Kesteven 011B,E01026296,1125,744,381,261,28,92
2011,South Kesteven 011C,E01026297,976,671,305,192,29,84
2011,South Kesteven 011D,E01026298,1237,906,331,180,34,117
2011,South Kesteven 011E,E01032997,874,727,147,59,30,58
2011,South Kesteven 011F,E01032998,919,785,134,35,41,58
2011,South Kesteven 011G,E01032999,814,594,220,141,25,54
2011,South Kesteven 012A,E01026330,1630,1172,458,273,45,140
2011,South Kesteven 012B,E01026360,1602,1171,431,304,35,92
2011,South Kesteven 012C,E01026362,1285,1026,259,163,37,59
2011,South Kesteven 012D,E01026363,916,654,262,158,33,71
2011,South Kesteven 012E,E01026364,1222,873,349,252,27,70
2011,South Kesteven 013A,E01026334,1181,894,287,174,43,70
2011,South Kesteven 013B,E01026335,1151,777,374,262,28,84
2011,South Kesteven 013C,E01026336,1176,809,367,198,32,137
2011,South Kesteven 013D,E01026337,1134,828,306,192,29,85
2011,South Kesteven 014A,E01026303,1052,849,203,117,34,52
2011,South Kesteven 014B,E01026304,1134,836,298,205,37,56
2011,South Kesteven 014C,E01026305,1074,890,184,94,21,69
2011,South Kesteven 014D,E01026306,1101,725,376,238,37,101
2011,South Kesteven 014E,E01026307,997,748,249,182,28,39
2011,South Kesteven 015A,E01026287,1107,764,343,201,34,108
2011,South Kesteven 015B,E01026288,1137,818,319,146,37,136
2011,South Kesteven 015C,E01026289,1517,1129,388,213,45,130
2011,South Kesteven 015D,E01026346,892,689,203,118,22,63
2011,South Kesteven 015E,E01026347,1116,804,312,217,26,69
2011,South Kesteven 015F,E01026348,815,624,191,88,29,74
2011,South Kesteven 016A,E01026349,1098,790,308,178,23,107
2011,South Kesteven 016B,E01026350,1160,830,330,213,50,67
2011,South Kesteven 016C,E01026351,1124,821,303,192,45,66
2011,South Kesteven 016D,E01026356,1105,952,153,85,29,39
2011,South Kesteven 016E,E01026357,1102,874,228,149,23,56
2011,South Kesteven 016F,E01026358,1077,777,300,224,27,49
2011,South Kesteven 016G,E01026359,1125,809,316,217,31,68
2011,West Lindsey 001A,E01026367,1172,804,368,202,42,124
2011,West Lindsey 001B,E01026368,1186,815,371,230,42,99
2011,West Lindsey 001C,E01026387,2044,1428,616,383,69,164
2011,West Lindsey 001D,E01026416,953,641,312,185,42,85
2011,West Lindsey 001G,E01032683,1682,1199,483,348,44,91
2011,West Lindsey 002A,E01026380,1340,934,406,214,52,140
2011,West Lindsey 002B,E01026401,1167,813,354,245,29,80
2011,West Lindsey 002C,E01026402,1349,960,389,275,41,73
2011,West Lindsey 002D,E01026403,1004,691,313,193,33,87
2011,West Lindsey 002E,E01026407,1012,723,289,157,26,106
2011,West Lindsey 002F,E01026408,984,669,315,214,19,82
2011,West Lindsey 003A,E01026389,1201,832,369,196,49,124
2011,West Lindsey 003B,E01026390,1297,837,460,257,56,147
2011,West Lindsey 003C,E01026391,1405,923,482,317,76,89
2011,West Lindsey 003D,E01026392,2208,1489,719,468,65,186
2011,West Lindsey 003E,E01026415,796,514,282,157,29,96
2011,West Lindsey 004A,E01026378,1233,822,411,165,48,198
2011,West Lindsey 004B,E01026379,1203,869,334,157,41,136
2011,West Lindsey 004C,E01026381,1241,832,409,216,38,155
2011,West Lindsey 004D,E01026382,1194,836,358,180,34,144
2011,West Lindsey 004E,E01026383,925,609,316,97,32,187
2011,West Lindsey 004F,E01026384,1293,882,411,192,44,175
2011,West Lindsey 005A,E01026385,856,583,273,166,35,72
2011,West Lindsey 005B,E01026386,1054,730,324,127,39,158
2011,West Lindsey 005C,E01026399,1129,805,324,182,38,104
2011,West Lindsey 005D,E01026411,1884,1341,543,346,50,147
2011,West Lindsey 006A,E01026374,1011,651,360,101,52,207
2011,West Lindsey 006B,E01026375,1113,743,370,144,44,182
2011,West Lindsey 006C,E01026376,1227,755,472,231,43,198
2011,West Lindsey 006D,E01026377,1556,1092,464,213,49,202
2011,West Lindsey 007A,E01026388,1580,1055,525,373,52,100
2011,West Lindsey 007B,E01026404,1694,1160,534,332,57,145
2011,West Lindsey 007C,E01026409,925,657,268,167,27,74
2011,West Lindsey 007D,E01026410,1199,609,590,444,29,117
2011,West Lindsey 008A,E01026372,1807,1254,553,361,96,96
2011,West Lindsey 008B,E01026412,1186,829,357,204,49,104
2011,West Lindsey 008C,E01026413,1572,1172,400,233,64,103
2011,West Lindsey 008D,E01026414,1284,860,424,257,55,112
2011,West Lindsey 009A,E01026396,920,602,318,245,30,43
2011,West Lindsey 009B,E01026397,1766,1300,466,286,60,120
2011,West Lindsey 009C,E01026398,1085,733,352,237,28,87
2011,West Lindsey 009D,E01026400,1225,958,267,92,67,108
2011,West Lindsey 010A,E01026393,987,624,363,276,32,55
2011,West Lindsey 010B,E01026394,1411,1000,411,219,113,79
2011,West Lindsey 010C,E01026395,1017,644,373,289,39,45
2011,West Lindsey 010D,E01026405,975,684,291,194,49,48
2011,West Lindsey 010E,E01026406,940,609,331,224,47,60
2011,West Lindsey 011A,E01026366,1517,1008,509,315,41,153
2011,West Lindsey 011B,E01026369,778,503,275,196,25,54
2011,West Lindsey 011C,E01026370,1485,1013,472,345,29,98
2011,West Lindsey 011D,E01026371,907,595,312,220,29,63
2011,West Lindsey 011E,E01026373,1552,1077,475,299,48,128
2011,Corby 001A,E01026971,1245,921,324,172,48,104
2011,Corby 001B,E01026979,1029,755,274,162,36,76
2011,Corby 001C,E01026980,1186,868,318,213,36,69
2011,Corby 001D,E01026982,1416,1081,335,122,53,160
2011,Corby 002A,E01026969,1182,796,386,225,33,128
2011,Corby 002B,E01026970,1257,998,259,117,43,99
2011,Corby 002C,E01026972,1308,980,328,138,56,134
2011,Corby 002D,E01026976,990,732,258,104,27,127
2011,Corby 002E,E01026981,877,626,251,175,17,59
2011,Corby 002F,E01026983,868,624,244,108,31,105
2011,Corby 003A,E01026957,1159,824,335,151,31,153
2011,Corby 003B,E01026958,1340,1037,303,108,30,165
2011,Corby 003C,E01026977,1419,1038,381,255,39,87
2011,Corby 003D,E01026978,1059,779,280,175,32,73
2011,Corby 004A,E01026962,1050,727,323,188,37,98
2011,Corby 004B,E01026973,1011,736,275,145,33,97
2011,Corby 004C,E01026974,851,602,249,158,27,64
2011,Corby 004D,E01026975,965,665,300,153,31,116
2011,Corby 004E,E01026984,1272,877,395,222,29,144
2011,Corby 004F,E01026985,1133,788,345,232,37,76
2011,Corby 005A,E01026949,982,674,308,138,30,140
2011,Corby 005B,E01026950,1086,756,330,112,41,177
2011,Corby 005C,E01026951,921,655,266,105,39,122
2011,Corby 005D,E01026952,901,661,240,121,27,92
2011,Corby 006A,E01026959,1063,778,285,142,23,120
2011,Corby 006B,E01026960,1072,743,329,103,37,189
2011,Corby 006C,E01026961,921,671,250,72,40,138
2011,Corby 006D,E01026965,772,498,274,81,34,159
2011,Corby 006E,E01026966,1031,681,350,149,52,149
2011,Corby 006F,E01026967,1216,858,358,138,41,179
2011,Corby 006G,E01026968,987,633,354,113,25,216
2011,Corby 008A,E01026953,1057,723,334,213,30,91
2011,Corby 008B,E01026954,1037,728,309,120,44,145
2011,Corby 008C,E01026955,1136,879,257,147,43,67
2011,Corby 008D,E01026956,1489,1134,355,149,45,161
2011,Corby 009A,E01026963,973,734,239,74,37,128
2011,Corby 009B,E01032963,1208,1009,199,72,44,83
2011,Corby 009C,E01032964,1195,1001,194,65,45,84
2011,Corby 009D,E01032965,997,852,145,39,39,67
2011,Corby 009E,E01032966,1241,1074,167,56,37,74
2011,Corby 009F,E01032967,1147,970,177,34,45,98
2011,Daventry 001A,E01027005,1538,1119,419,244,55,120
2011,Daventry 001B,E01027026,1413,1028,385,223,57,105
2011,Daventry 001C,E01027030,1351,920,431,250,76,105
2011,Daventry 002A,E01027000,1035,761,274,162,32,80
2011,Daventry 002B,E01027001,1117,890,227,93,61,73
2011,Daventry 002C,E01027002,1208,896,312,184,45,83
2011,Daventry 002D,E01027003,1071,854,217,136,33,48
2011,Daventry 002E,E01027022,1357,1005,352,228,41,83
2011,Daventry 003A,E01026994,744,521,223,159,16,48
2011,Daventry 003D,E01026999,1313,893,420,298,37,85
2011,Daventry 003E,E01027006,1358,1025,333,203,44,86
2011,Daventry 003F,E01032968,2686,1319,1367,348,98,921
2011,Daventry 004A,E01026998,1380,1004,376,239,47,90
2011,Daventry 004B,E01027015,917,681,236,158,31,47
2011,Daventry 004C,E01027016,1135,889,246,163,36,47
2011,Daventry 004D,E01027021,1378,994,384,262,45,77
2011,Daventry 004E,E01027027,1690,1302,388,204,73,111
2011,Daventry 005A,E01026997,1243,897,346,214,49,83
2011,Daventry 005B,E01027018,1093,747,346,259,37,50
2011,Daventry 005C,E01027019,1151,826,325,149,100,76
2011,Daventry 005D,E01027020,840,606,234,163,25,46
2011,Daventry 005E,E01027023,1499,1091,408,251,52,105
2011,Daventry 006A,E01026987,933,640,293,197,30,66
2011,Daventry 006B,E01026989,1052,840,212,75,37,100
2011,Daventry 006C,E01026990,1987,1633,354,158,56,140
2011,Daventry 006D,E01027012,1302,892,410,240,28,142
2011,Daventry 006E,E01027014,1548,1271,277,130,54,93
2011,Daventry 007A,E01026986,2070,1629,441,187,61,193
2011,Daventry 007B,E01026988,1078,788,290,106,40,144
2011,Daventry 007C,E01026991,1188,759,429,363,10,56
2011,Daventry 007D,E01026992,1310,926,384,216,29,139
2011,Daventry 007E,E01027010,907,629,278,193,29,56
2011,Daventry 008A,E01027007,1024,756,268,116,40,112
2011,Daventry 008B,E01027008,1546,1196,350,219,44,87
2011,Daventry 008C,E01027009,1064,745,319,125,44,150
2011,Daventry 008D,E01027013,1267,846,421,111,81,229
2011,Daventry 009A,E01027011,1416,1028,388,262,41,85
2011,Daventry 009B,E01027017,1047,736,311,181,31,99
2011,Daventry 009C,E01027024,1304,989,315,216,29,70
2011,Daventry 009D,E01027025,1223,889,334,192,31,111
2011,Daventry 010A,E01026993,1488,1043,445,300,52,93
2011,Daventry 010B,E01027004,1375,962,413,260,38,115
2011,Daventry 010C,E01027028,1606,1232,374,199,48,127
2011,Daventry 010D,E01027029,1127,849,278,141,35,102
2011,East Northamptonshire 001A,E01027033,1350,967,383,228,52,103
2011,East Northamptonshire 001B,E01027043,1421,996,425,256,57,112
2011,East Northamptonshire 001C,E01027050,1391,961,430,264,48,118
2011,East Northamptonshire 002A,E01027031,1535,1135,400,228,58,114
2011,East Northamptonshire 002B,E01027044,1531,1102,429,281,58,90
2011,East Northamptonshire 002C,E01027046,947,694,253,156,39,58
2011,East Northamptonshire 002D,E01027047,945,654,291,187,29,75
2011,East Northamptonshire 002E,E01027048,1382,658,724,187,466,71
2011,East Northamptonshire 002F,E01027049,688,483,205,142,31,32
2011,East Northamptonshire 003A,E01027032,1359,987,372,228,42,102
2011,East Northamptonshire 003B,E01027045,1411,1016,395,247,39,109
2011,East Northamptonshire 003C,E01027075,1518,1164,354,186,49,119
2011,East Northamptonshire 003D,E01027076,1543,1144,399,227,39,133
2011,East Northamptonshire 003E,E01027077,1448,1159,289,143,53,93
2011,East Northamptonshire 004A,E01027057,1308,939,369,209,42,118
2011,East Northamptonshire 004B,E01027074,1638,1167,471,288,67,116
2011,East Northamptonshire 004C,E01027078,1562,1120,442,283,50,109
2011,East Northamptonshire 005A,E01027051,1282,934,348,166,55,127
2011,East Northamptonshire 005B,E01027052,1065,784,281,157,51,73
2011,East Northamptonshire 005C,E01027053,1158,860,298,183,40,75
2011,East Northamptonshire 005D,E01027054,950,644,306,223,20,63
2011,East Northamptonshire 005E,E01027055,840,638,202,128,25,49
2011,East Northamptonshire 005F,E01027056,1091,760,331,170,39,122
2011,East Northamptonshire 006A,E01027038,1189,803,386,197,62,127
2011,East Northamptonshire 006B,E01027039,1259,939,320,178,39,103
2011,East Northamptonshire 006C,E01027040,1224,933,291,168,32,91
2011,East Northamptonshire 006D,E01027041,1136,773,363,171,42,150
2011,East Northamptonshire 006E,E01027042,1423,1159,264,126,37,101
2011,East Northamptonshire 007A,E01027034,1169,818,351,217,34,100
2011,East Northamptonshire 007B,E01027035,1025,697,328,167,42,119
2011,East Northamptonshire 007D,E01027037,1560,1210,350,218,41,91
2011,East Northamptonshire 007E,E01033244,1756,1388,368,226,48,94
2011,East Northamptonshire 007F,E01033245,747,577,170,104,27,39
2011,East Northamptonshire 008A,E01027061,1269,944,325,149,45,131
2011,East Northamptonshire 008B,E01027062,1595,1191,404,204,49,151
2011,East Northamptonshire 008C,E01027063,1379,1023,356,226,29,101
2011,East Northamptonshire 008D,E01027064,1181,839,342,244,17,81
2011,East Northamptonshire 008E,E01027072,1097,740,357,137,45,175
2011,East Northamptonshire 008F,E01027073,1461,1052,409,224,44,141
2011,East Northamptonshire 009A,E01027058,1017,696,321,132,35,154
2011,East Northamptonshire 009B,E01027059,1236,906,330,150,57,123
2011,East Northamptonshire 009C,E01027060,1260,932,328,144,38,146
2011,East Northamptonshire 009D,E01027065,1292,975,317,114,46,157
2011,East Northamptonshire 009E,E01027069,1177,857,320,155,36,129
2011,East Northamptonshire 010A,E01027066,1552,1162,390,258,46,86
2011,East Northamptonshire 010B,E01027067,1150,750,400,303,25,72
2011,East Northamptonshire 010C,E01027068,2155,1774,381,188,68,125
2011,East Northamptonshire 010D,E01027070,1209,902,307,192,31,84
2011,East Northamptonshire 010E,E01027071,1125,815,310,190,40,80
2011,Kettering 001A,E01027090,1102,796,306,186,33,87
2011,Kettering 001B,E01027103,1200,909,291,204,31,56
2011,Kettering 001C,E01027129,1646,1155,491,331,47,113
2011,Kettering 002B,E01027094,1088,748,340,229,37,74
2011,Kettering 002C,E01027095,1050,778,272,130,42,100
2011,Kettering 002D,E01027107,960,693,267,161,29,77
2011,Kettering 002E,E01027108,981,655,326,243,36,47
2011,Kettering 002F,E01027109,958,690,268,144,32,92
2011,Kettering 002G,E01032969,911,765,146,39,30,77
2011,Kettering 002H,E01032970,1032,772,260,118,42,100
2011,Kettering 002I,E01032971,772,607,165,75,18,72
2011,Kettering 003A,E01027123,1116,793,323,208,24,91
2011,Kettering 003B,E01027124,1627,1187,440,214,53,173
2011,Kettering 003C,E01027125,1366,1016,350,227,37,86
2011,Kettering 003D,E01027126,1530,1102,428,247,32,149
2011,Kettering 004A,E01027079,1310,1003,307,160,46,101
2011,Kettering 004B,E01027080,1412,1055,357,226,38,93
2011,Kettering 004C,E01027087,890,670,220,144,30,46
2011,Kettering 004D,E01027088,927,753,174,84,38,52
2011,Kettering 004E,E01027089,1455,1084,371,217,35,119
2011,Kettering 005A,E01027081,997,726,271,117,34,120
2011,Kettering 005B,E01027082,1187,876,311,109,41,161
2011,Kettering 005C,E01027083,999,621,378,121,27,230
2011,Kettering 005D,E01027127,1301,817,484,143,68,273
2011,Kettering 005E,E01027128,1193,820,373,158,46,169
2011,Kettering 006A,E01027105,1601,1256,345,106,51,188
2011,Kettering 006B,E01027106,1455,1143,312,102,49,161
2011,Kettering 006C,E01027111,1587,1208,379,143,45,191
2011,Kettering 006D,E01027112,1581,1268,313,135,46,132
2011,Kettering 007A,E01027104,1715,1283,432,198,47,187
2011,Kettering 007B,E01027110,1257,861,396,169,27,200
2011,Kettering 007C,E01027113,1475,1076,399,206,51,142
2011,Kettering 007D,E01027115,791,559,232,171,23,38
2011,Kettering 007E,E01027116,1570,1304,266,123,50,93
2011,Kettering 007F,E01027117,1042,805,237,146,33,58
2011,Kettering 008A,E01027096,841,610,231,157,22,52
2011,Kettering 008B,E01027097,1045,744,301,213,28,60
2011,Kettering 008C,E01027098,894,689,205,126,23,56
2011,Kettering 008D,E01027099,1023,691,332,251,23,58
2011,Kettering 008E,E01027122,880,610,270,188,19,63
2011,Kettering 009A,E01027100,1118,827,291,163,34,94
2011,Kettering 009B,E01027114,1170,894,276,130,40,106
2011,Kettering 009C,E01027130,1313,908,405,211,43,151
2011,Kettering 009D,E01027131,1483,1021,462,188,40,234
2011,Kettering 010A,E01027084,1035,689,346,258,29,59
2011,Kettering 010B,E01027085,904,628,276,179,29,68
2011,Kettering 010C,E01027086,1224,877,347,243,45,59
2011,Kettering 010D,E01027120,1007,840,167,78,37,52
2011,Kettering 010E,E01027121,1086,802,284,195,35,54
2011,Kettering 011A,E01027091,1347,949,398,204,49,145
2011,Kettering 011B,E01027092,1112,803,309,190,34,85
2011,Kettering 011C,E01027101,1742,1317,425,225,62,138
2011,Kettering 011D,E01027102,1211,858,353,223,38,92
2011,Kettering 011F,E01027119,1230,870,360,231,34,95
2011,Kettering 011G,E01032972,1067,816,251,157,32,62
2011,Kettering 011H,E01032973,1153,992,161,54,29,78
2011,Kettering 011I,E01032974,951,723,228,131,28,69
2011,Northampton 001A,E01027145,1063,747,316,172,70,74
2011,Northampton 001B,E01027148,1119,853,266,152,58,56
2011,Northampton 001C,E01027149,1124,809,315,206,45,64
2011,Northampton 001D,E01027232,2193,1162,1031,139,781,111
2011,Northampton 002A,E01027218,1192,795,397,288,24,85
2011,Northampton 002B,E01027219,1192,780,412,297,37,78
2011,Northampton 002C,E01027221,1294,968,326,206,48,72
2011,Northampton 002D,E01027222,1010,788,222,147,34,41
2011,Northampton 003A,E01027143,944,675,269,172,24,73
2011,Northampton 003B,E01027144,1173,854,319,246,33,40
2011,Northampton 003C,E01027146,1103,769,334,230,40,64
2011,Northampton 003D,E01027147,1162,787,375,172,77,126
2011,Northampton 004A,E01027195,1132,797,335,71,67,197
2011,Northampton 004B,E01027245,1148,894,254,92,40,122
2011,Northampton 004C,E01027247,1162,905,257,97,54,106
2011,Northampton 004D,E01027248,1066,775,291,98,47,146
2011,Northampton 004E,E01027249,1262,874,388,98,71,219
2011,Northampton 005A,E01027174,1017,741,276,160,43,73
2011,Northampton 005B,E01027175,1111,874,237,63,44,130
2011,Northampton 005C,E01027178,1379,1022,357,95,72,190
2011,Northampton 005D,E01027200,988,697,291,77,61,153
2011,Northampton 005E,E01027246,1272,910,362,87,67,208
2011,Northampton 006A,E01027171,1055,755,300,183,34,83
2011,Northampton 006B,E01027172,1082,791,291,158,41,92
2011,Northampton 006C,E01027182,1039,749,290,172,41,77
2011,Northampton 006D,E01027183,1010,651,359,246,36,77
2011,Northampton 007A,E01027196,1097,735,362,130,69,163
2011,Northampton 007B,E01027197,1018,748,270,119,36,115
2011,Northampton 007C,E01027198,1133,775,358,103,53,202
2011,Northampton 007D,E01027199,892,590,302,75,46,181
2011,Northampton 008A,E01027190,1131,787,344,235,31,78
2011,Northampton 008B,E01027191,1339,1029,310,106,84,120
2011,Northampton 008C,E01027193,1119,848,271,181,27,63
2011,Northampton 008D,E01027194,966,676,290,222,27,41
2011,Northampton 009A,E01027192,1068,783,285,65,142,78
2011,Northampton 009B,E01027229,1117,756,361,105,99,157
2011,Northampton 009C,E01027230,1067,747,320,79,101,140
2011,Northampton 009D,E01027231,1309,896,413,119,89,205
2011,Northampton 010A,E01027179,1296,948,348,155,55,138
2011,Northampton 010B,E01027180,1080,726,354,203,41,110
2011,Northampton 010C,E01027181,1082,711,371,272,32,67
2011,Northampton 011A,E01027140,833,541,292,94,37,161
2011,Northampton 011B,E01027142,990,688,302,174,44,84
2011,Northampton 011C,E01027176,1142,873,269,138,33,98
2011,Northampton 011D,E01027177,1041,669,372,135,57,180
2011,Northampton 012A,E01027168,1121,768,353,87,66,200
2011,Northampton 012B,E01027169,1137,890,247,121,45,81
2011,Northampton 012C,E01027170,1035,746,289,77,68,144
2011,Northampton 012D,E01027173,1125,808,317,102,47,168
2011,Northampton 013A,E01027136,1325,1057,268,105,61,102
2011,Northampton 013B,E01027186,1303,1007,296,136,69,91
2011,Northampton 013C,E01027188,1314,958,356,132,77,147
2011,Northampton 013D,E01027220,976,624,352,248,24,80
2011,Northampton 014A,E01027208,1087,825,262,156,40,66
2011,Northampton 014B,E01027209,926,775,151,89,18,44
2011,Northampton 014C,E01027211,1044,731,313,235,23,55
2011,Northampton 014D,E01027212,1102,915,187,106,34,47
2011,Northampton 015A,E01027184,1131,823,308,93,63,152
2011,Northampton 015B,E01027185,1122,737,385,98,166,121
2011,Northampton 015C,E01027187,1057,797,260,85,86,89
2011,Northampton 015D,E01027189,1212,945,267,132,47,88
2011,Northampton 016A,E01027137,1006,730,276,115,32,129
2011,Northampton 016B,E01027138,1117,864,253,150,31,72
2011,Northampton 016C,E01027139,1128,913,215,81,49,85
2011,Northampton 016D,E01027141,1115,847,268,151,52,65
2011,Northampton 016E,E01027259,1196,909,287,154,50,83
2011,Northampton 017A,E01027239,1108,725,383,118,49,216
2011,Northampton 017B,E01027241,1254,931,323,98,56,169
2011,Northampton 017C,E01027242,1072,735,337,94,58,185
2011,Northampton 017D,E01027243,1040,719,321,109,34,178
2011,Northampton 017E,E01027244,1036,691,345,69,52,224
2011,Northampton 018A,E01027213,1127,837,290,166,41,83
2011,Northampton 018B,E01027214,1117,750,367,192,36,139
2011,Northampton 018C,E01027216,1235,881,354,260,35,59
2011,Northampton 018D,E01027240,884,618,266,110,37,119
2011,Northampton 019A,E01027207,985,668,317,255,18,44
2011,Northampton 019B,E01027210,842,624,218,138,23,57
2011,Northampton 019C,E01027215,1063,792,271,173,29,69
2011,Northampton 019D,E01027217,1447,1057,390,252,40,98
2011,Northampton 020A,E01027255,998,712,286,203,43,40
2011,Northampton 020B,E01027256,1004,731,273,174,35,64
2011,Northampton 020C,E01027258,1046,842,204,108,43,53
2011,Northampton 020D,E01027260,1063,714,349,230,38,81
2011,Northampton 021B,E01027152,1363,1035,328,67,110,151
2011,Northampton 021C,E01027153,1682,1072,610,121,298,191
2011,Northampton 021D,E01027154,1326,1022,304,73,104,127
2011,Northampton 021E,E01032978,1115,784,331,73,84,174
2011,Northampton 021F,E01032979,1017,745,272,39,39,194
2011,Northampton 022A,E01027132,1644,1342,302,81,120,101
2011,Northampton 022B,E01027133,1321,1093,228,106,52,70
2011,Northampton 022C,E01027134,1374,1099,275,86,89,100
2011,Northampton 022D,E01027135,1316,1037,279,118,54,107
2011,Northampton 023A,E01027155,1744,1352,392,71,143,178
2011,Northampton 023B,E01027225,1360,1058,302,52,120,130
2011,Northampton 023C,E01027227,1229,956,273,48,81,144
2011,Northampton 023D,E01027228,1598,1274,324,66,97,161
2011,Northampton 024A,E01027151,1272,978,294,87,53,154
2011,Northampton 024B,E01027236,1062,751,311,203,26,82
2011,Northampton 024C,E01027237,1503,1178,325,157,45,123
2011,Northampton 024D,E01027238,1484,1171,313,120,47,146
2011,Northampton 025A,E01027223,1696,1383,313,84,95,134
2011,Northampton 025B,E01027224,1380,1038,342,126,47,169
2011,Northampton 025C,E01027226,1430,1068,362,102,78,182
2011,Northampton 025D,E01027257,1168,566,602,155,50,397
2011,Northampton 026A,E01027233,897,669,228,37,44,147
2011,Northampton 026B,E01027234,1002,787,215,108,27,80
2011,Northampton 026C,E01027235,983,651,332,105,40,187
2011,Northampton 026D,E01027252,1065,835,230,93,33,104
2011,Northampton 027A,E01027156,880,633,247,89,40,118
2011,Northampton 027B,E01027159,929,714,215,117,29,69
2011,Northampton 027C,E01027160,1360,1134,226,108,38,80
2011,Northampton 027D,E01027161,1084,711,373,145,47,181
2011,Northampton 028B,E01027158,1097,865,232,113,28,91
2011,Northampton 028C,E01027201,1461,1151,310,179,41,90
2011,Northampton 028D,E01027202,1129,803,326,222,28,76
2011,Northampton 028E,E01032980,1183,1024,159,19,57,83
2011,Northampton 028F,E01032981,1208,1011,197,67,45,85
2011,Northampton 029A,E01027250,1047,812,235,153,23,59
2011,Northampton 029C,E01027253,1385,1054,331,206,45,80
2011,Northampton 029D,E01027254,1309,1024,285,177,35,73
2011,Northampton 029E,E01032975,1260,1085,175,64,40,71
2011,Northampton 029F,E01032976,792,621,171,101,17,53
2011,Northampton 029G,E01032977,1220,1040,180,40,41,99
2011,Northampton 030A,E01027162,1195,1031,164,75,28,61
2011,Northampton 030B,E01027163,1029,784,245,138,34,73
2011,Northampton 030C,E01027164,1159,1008,151,51,42,58
2011,Northampton 030D,E01027165,993,817,176,79,28,69
2011,Northampton 030E,E01027166,1203,1032,171,66,43,62
2011,Northampton 030F,E01027167,1030,834,196,117,22,57
2011,Northampton 031A,E01027203,1127,946,181,66,60,55
2011,Northampton 031B,E01027204,1198,942,256,132,53,71
2011,Northampton 031C,E01027205,1466,1263,203,67,54,82
2011,Northampton 031D,E01027206,1995,1552,443,253,70,120
2011,South Northamptonshire 001A,E01027282,1203,906,297,153,43,101
2011,South Northamptonshire 001B,E01027283,1169,882,287,177,48,62
2011,South Northamptonshire 001C,E01027285,1250,910,340,212,37,91
2011,South Northamptonshire 001D,E01027286,1129,828,301,221,25,55
2011,South Northamptonshire 001E,E01027287,1184,807,377,259,42,76
2011,South Northamptonshire 002A,E01027273,1273,914,359,263,29,67
2011,South Northamptonshire 002B,E01027274,1156,879,277,189,40,48
2011,South Northamptonshire 002C,E01027275,1045,736,309,230,24,55
2011,South Northamptonshire 002D,E01027308,1174,887,287,189,35,63
2011,South Northamptonshire 003A,E01027263,1363,938,425,297,36,92
2011,South Northamptonshire 003C,E01027279,1227,826,401,273,34,94
2011,South Northamptonshire 003D,E01027284,1505,1120,385,212,56,117
2011,South Northamptonshire 003E,E01027294,1393,1052,341,194,42,105
2011,South Northamptonshire 003F,E01032982,861,749,112,50,24,38
2011,South Northamptonshire 003G,E01032983,1019,897,122,38,36,48
2011,South Northamptonshire 003H,E01032984,1076,944,132,36,27,69
2011,South Northamptonshire 003I,E01032985,1097,809,288,183,30,75
2011,South Northamptonshire 004A,E01027262,1215,918,297,181,32,84
2011,South Northamptonshire 004B,E01027277,1353,1038,315,206,37,72
2011,South Northamptonshire 004C,E01027289,1218,837,381,259,38,84
2011,South Northamptonshire 004D,E01027300,1066,857,209,121,39,49
2011,South Northamptonshire 004E,E01027303,1111,898,213,112,36,65
2011,South Northamptonshire 005A,E01027297,1237,883,354,233,34,87
2011,South Northamptonshire 005B,E01027298,992,795,197,131,23,43
2011,South Northamptonshire 005C,E01027299,1105,840,265,147,30,88
2011,South Northamptonshire 005D,E01027301,1539,1296,243,115,49,79
2011,South Northamptonshire 005E,E01027302,1005,769,236,117,33,86
2011,South Northamptonshire 006A,E01027291,1032,758,274,200,31,43
2011,South Northamptonshire 006B,E01027292,825,598,227,130,25,72
2011,South Northamptonshire 006C,E01027293,903,722,181,125,28,28
2011,South Northamptonshire 006D,E01027304,1302,942,360,238,34,88
2011,South Northamptonshire 006E,E01027305,1363,1018,345,220,42,83
2011,South Northamptonshire 007A,E01027261,1487,1173,314,194,44,76
2011,South Northamptonshire 007B,E01027295,1630,1246,384,247,40,97
2011,South Northamptonshire 007C,E01027306,1303,977,326,195,38,93
2011,South Northamptonshire 008A,E01027276,1846,1381,465,299,45,121
2011,South Northamptonshire 008B,E01027280,1795,1426,369,205,67,97
2011,South Northamptonshire 008C,E01027281,1228,928,300,192,25,83
2011,South Northamptonshire 008D,E01027307,1546,1126,420,277,35,108
2011,South Northamptonshire 009A,E01027265,1079,811,268,186,22,60
2011,South Northamptonshire 009B,E01027266,969,701,268,165,50,53
2011,South Northamptonshire 009C,E01027270,1164,985,179,90,41,48
2011,South Northamptonshire 009D,E01027271,1097,926,171,77,32,62
2011,South Northamptonshire 009E,E01027272,1160,963,197,102,32,63
2011,South Northamptonshire 010A,E01027264,1085,819,266,155,30,81
2011,South Northamptonshire 010B,E01027267,832,664,168,100,16,52
2011,South Northamptonshire 010C,E01027268,971,767,204,105,35,64
2011,South Northamptonshire 010D,E01027269,1065,812,253,129,33,91
2011,South Northamptonshire 011A,E01027288,1528,1144,384,231,49,104
2011,South Northamptonshire 011B,E01027290,1652,1242,410,258,39,113
2011,South Northamptonshire 011C,E01027296,1494,1105,389,243,55,91
2011,Wellingborough 001A,E01027326,1116,754,362,248,22,92
2011,Wellingborough 001B,E01027327,1144,833,311,164,37,110
2011,Wellingborough 001C,E01027328,959,661,298,157,36,105
2011,Wellingborough 001D,E01027338,1688,1192,496,352,44,100
2011,Wellingborough 002A,E01027330,1176,841,335,114,57,164
2011,Wellingborough 002B,E01027331,952,611,341,156,31,154
2011,Wellingborough 002C,E01027332,1056,698,358,244,37,77
2011,Wellingborough 002D,E01027333,1731,1334,397,202,70,125
2011,Wellingborough 002E,E01027334,886,580,306,55,47,204
2011,Wellingborough 003A,E01027343,1116,806,310,188,37,85
2011,Wellingborough 003B,E01027344,1047,740,307,197,41,69
2011,Wellingborough 003C,E01027345,1031,806,225,128,43,54
2011,Wellingborough 003D,E01027346,1115,919,196,91,44,61
2011,Wellingborough 003E,E01027347,1492,1124,368,228,43,97
2011,Wellingborough 004A,E01027313,1225,864,361,121,41,199
2011,Wellingborough 004B,E01027314,1500,1115,385,132,51,202
2011,Wellingborough 004C,E01027315,1714,1347,367,138,61,168
2011,Wellingborough 004D,E01027316,1093,805,288,122,36,130
2011,Wellingborough 005A,E01027339,949,620,329,121,43,165
2011,Wellingborough 005B,E01027340,1031,650,381,212,29,140
2011,Wellingborough 005C,E01027341,1058,722,336,141,50,145
2011,Wellingborough 005D,E01027342,985,706,279,99,33,147
2011,Wellingborough 006A,E01027349,1259,901,358,154,30,174
2011,Wellingborough 006B,E01027350,1068,765,303,182,34,87
2011,Wellingborough 006C,E01027351,1084,690,394,191,33,170
2011,Wellingborough 006D,E01027352,1011,766,245,116,29,100
2011,Wellingborough 007A,E01027309,1111,791,320,218,31,71
2011,Wellingborough 007B,E01027310,1022,680,342,85,44,213
2011,Wellingborough 007C,E01027311,938,723,215,116,36,63
2011,Wellingborough 007D,E01027312,1012,672,340,187,33,120
2011,Wellingborough 008A,E01027317,1058,711,347,162,51,134
2011,Wellingborough 008B,E01027318,940,583,357,94,40,223
2011,Wellingborough 008C,E01027319,1066,763,303,122,47,134
2011,Wellingborough 008D,E01027320,1560,993,567,137,43,387
2011,Wellingborough 008E,E01027321,1138,915,223,100,46,77
2011,Wellingborough 009A,E01027322,885,690,195,119,38,38
2011,Wellingborough 009B,E01027323,1013,731,282,161,40,81
2011,Wellingborough 009C,E01027324,886,624,262,199,21,42
2011,Wellingborough 009D,E01027325,1138,854,284,183,36,65
2011,Wellingborough 009E,E01027329,1292,873,419,311,36,72
2011,Wellingborough 009F,E01027353,1281,928,353,230,45,78
2011,Wellingborough 010A,E01027335,1122,762,360,257,25,78
2011,Wellingborough 010B,E01027336,1031,734,297,169,23,105
2011,Wellingborough 010C,E01027337,1339,998,341,226,25,90
2011,Wellingborough 010D,E01027348,1531,1122,409,265,38,106
2011,Wellingborough 010E,E01027354,1745,1329,416,240,56,120
2011,Wellingborough 010F,E01027355,1223,921,302,225,31,46
2011,Ashfield 001A,E01027979,1170,743,427,299,26,102
2011,Ashfield 001B,E01027980,1087,693,394,156,51,187
2011,Ashfield 001C,E01027981,1190,738,452,287,32,133
2011,Ashfield 001D,E01027983,1123,736,387,140,47,200
2011,Ashfield 002A,E01027970,1079,756,323,188,48,87
2011,Ashfield 002B,E01027971,1105,718,387,271,36,80
2011,Ashfield 002C,E01027982,1052,692,360,220,21,119
2011,Ashfield 002D,E01027984,1134,797,337,198,48,91
2011,Ashfield 003A,E01027966,998,543,455,213,38,204
2011,Ashfield 003B,E01027986,1013,618,395,183,38,174
2011,Ashfield 003C,E01027987,1263,834,429,160,42,227
2011,Ashfield 003D,E01027990,1411,1052,359,200,38,121
2011,Ashfield 004A,E01027967,1241,889,352,138,33,181
2011,Ashfield 004B,E01027972,1609,1159,450,218,57,175
2011,Ashfield 004C,E01027977,1417,994,423,167,51,205
2011,Ashfield 004D,E01027978,1357,899,458,117,50,291
2011,Ashfield 004E,E01027985,1348,994,354,157,40,157
2011,Ashfield 005A,E01027964,1091,709,382,164,29,189
2011,Ashfield 005B,E01027965,918,565,353,115,40,198
2011,Ashfield 005C,E01027968,853,472,381,160,32,189
2011,Ashfield 005D,E01027974,1145,666,479,136,62,281
2011,Ashfield 005E,E01027976,1113,690,423,216,33,174
2011,Ashfield 006A,E01027969,1038,718,320,154,22,144
2011,Ashfield 006B,E01027975,1239,876,363,182,45,136
2011,Ashfield 006C,E01027988,1192,825,367,241,32,94
2011,Ashfield 006D,E01027989,1222,749,473,340,15,118
2011,Ashfield 006E,E01027991,943,618,325,158,31,136
2011,Ashfield 006F,E01027992,1665,1379,286,152,45,89
2011,Ashfield 007A,E01027949,1155,822,333,188,29,116
2011,Ashfield 007B,E01027951,1098,638,460,151,51,258
2011,Ashfield 007C,E01027953,1144,722,422,272,37,113
2011,Ashfield 007D,E01027954,1202,845,357,148,33,176
2011,Ashfield 007E,E01027973,1269,832,437,244,123,70
2011,Ashfield 008A,E01027952,1318,856,462,175,52,235
2011,Ashfield 008B,E01027955,948,644,304,109,29,166
2011,Ashfield 008C,E01027956,1034,574,460,211,50,199
2011,Ashfield 008D,E01027958,1010,661,349,128,39,182
2011,Ashfield 009A,E01027947,1223,845,378,208,30,140
2011,Ashfield 009B,E01027948,1391,1026,365,180,51,134
2011,Ashfield 009C,E01027950,1476,985,491,265,43,183
2011,Ashfield 009D,E01027957,922,620,302,140,40,122
2011,Ashfield 009E,E01027959,1119,882,237,106,60,71
2011,Ashfield 010A,E01027995,1230,804,426,260,28,138
2011,Ashfield 010B,E01027996,1535,1061,474,213,56,205
2011,Ashfield 010C,E01027997,1287,831,456,304,42,110
2011,Ashfield 010D,E01027998,1384,917,467,313,29,125
2011,Ashfield 011A,E01027960,1236,788,448,268,30,150
2011,Ashfield 011B,E01027961,1413,937,476,320,43,113
2011,Ashfield 011C,E01027962,1124,822,302,166,42,94
2011,Ashfield 011D,E01027963,1196,823,373,192,54,127
2011,Ashfield 012A,E01027945,1265,862,403,233,35,135
2011,Ashfield 012B,E01027946,1144,785,359,214,37,108
2011,Ashfield 012C,E01027993,1158,810,348,241,28,79
2011,Ashfield 012D,E01027994,1054,685,369,244,27,98
2011,Ashfield 013A,E01027929,1793,1380,413,210,51,152
2011,Ashfield 013B,E01027931,1500,1007,493,195,50,248
2011,Ashfield 013C,E01027934,1034,807,227,128,32,67
2011,Ashfield 013D,E01027935,944,709,235,101,47,87
2011,Ashfield 013E,E01027936,1113,683,430,346,27,57
2011,Ashfield 014A,E01027927,1462,1028,434,219,45,170
2011,Ashfield 014B,E01027928,1417,1058,359,165,46,148
2011,Ashfield 014C,E01027932,1557,1158,399,184,38,177
2011,Ashfield 014D,E01027933,1114,824,290,148,34,108
2011,Ashfield 014E,E01027937,986,647,339,148,31,160
2011,Ashfield 015A,E01027925,1344,891,453,289,56,108
2011,Ashfield 015B,E01027938,1000,814,186,91,35,60
2011,Ashfield 015C,E01027940,1052,752,300,215,30,55
2011,Ashfield 015D,E01027943,1031,746,285,176,26,83
2011,Ashfield 015E,E01027944,1153,825,328,244,17,67
2011,Ashfield 016A,E01027926,1115,745,370,254,30,86
2011,Ashfield 016B,E01027930,1119,735,384,136,38,210
2011,Ashfield 016C,E01027939,1007,656,351,135,36,180
2011,Ashfield 016D,E01027941,1002,665,337,206,30,101
2011,Ashfield 016E,E01027942,943,641,302,132,22,148
2011,Bassetlaw 001A,E01028000,1646,1129,517,369,37,111
2011,Bassetlaw 001B,E01028024,1358,938,420,237,55,128
2011,Bassetlaw 001C,E01028025,1103,783,320,136,49,135
2011,Bassetlaw 001D,E01028026,1083,644,439,224,38,177
2011,Bassetlaw 001E,E01028027,1075,688,387,190,35,162
2011,Bassetlaw 001F,E01028028,1114,711,403,202,38,163
2011,Bassetlaw 002A,E01027999,1652,1145,507,336,48,123
2011,Bassetlaw 002B,E01028005,1470,948,522,359,46,117
2011,Bassetlaw 002C,E01028031,804,530,274,166,24,84
2011,Bassetlaw 002D,E01028032,986,696,290,189,20,81
2011,Bassetlaw 002E,E01028035,1725,1191,534,359,61,114
2011,Bassetlaw 003A,E01028023,1710,1194,516,332,53,131
2011,Bassetlaw 003B,E01028034,1843,1182,661,396,124,141
2011,Bassetlaw 003C,E01028036,2580,1333,1247,312,68,867
2011,Bassetlaw 004A,E01028001,871,537,334,148,25,161
2011,Bassetlaw 004B,E01028002,1042,666,376,244,26,106
2011,Bassetlaw 004C,E01028003,1059,712,347,211,30,106
2011,Bassetlaw 004D,E01028004,1162,769,393,273,32,88
2011,Bassetlaw 004E,E01028029,900,573,327,177,25,125
2011,Bassetlaw 004F,E01028030,969,673,296,134,26,136
2011,Bassetlaw 005A,E01028013,1202,833,369,212,40,117
2011,Bassetlaw 005B,E01028014,1049,652,397,215,44,138
2011,Bassetlaw 005C,E01028015,1170,848,322,192,44,86
2011,Bassetlaw 005D,E01028016,959,603,356,239,27,90
2011,Bassetlaw 006A,E01028046,1215,846,369,225,41,103
2011,Bassetlaw 006B,E01028047,1549,1263,286,112,51,123
2011,Bassetlaw 006C,E01028048,1236,962,274,135,37,102
2011,Bassetlaw 006D,E01028049,1222,863,359,194,43,122
2011,Bassetlaw 006E,E01028050,1427,1121,306,135,55,116
2011,Bassetlaw 008A,E01028008,906,602,304,111,28,165
2011,Bassetlaw 008B,E01028009,1029,652,377,290,19,68
2011,Bassetlaw 008C,E01028010,1014,736,278,184,45,49
2011,Bassetlaw 008D,E01028011,1175,783,392,190,38,164
2011,Bassetlaw 008E,E01028012,1013,763,250,126,34,90
2011,Bassetlaw 008F,E01028022,1139,840,299,134,40,125
2011,Bassetlaw 009A,E01028055,1139,739,400,161,33,206
2011,Bassetlaw 009B,E01028056,918,639,279,123,40,116
2011,Bassetlaw 009C,E01028058,1354,1048,306,177,40,89
2011,Bassetlaw 009D,E01028059,1334,1077,257,115,51,91
2011,Bassetlaw 010A,E01028017,917,583,334,187,32,115
2011,Bassetlaw 010B,E01028018,1136,855,281,174,34,73
2011,Bassetlaw 010C,E01028019,1009,700,309,159,31,119
2011,Bassetlaw 010D,E01028020,1367,1019,348,151,55,142
2011,Bassetlaw 010E,E01028021,1084,775,309,219,34,56
2011,Bassetlaw 012A,E01028057,985,708,277,96,39,142
2011,Bassetlaw 012B,E01028065,1169,678,491,138,39,314
2011,Bassetlaw 012C,E01028066,1164,712,452,137,50,265
2011,Bassetlaw 012D,E01028068,1317,839,478,163,34,281
2011,Bassetlaw 013A,E01028060,1240,788,452,317,34,101
2011,Bassetlaw 013B,E01028061,1111,867,244,147,34,63
2011,Bassetlaw 013C,E01028062,1474,1020,454,213,36,205
2011,Bassetlaw 013D,E01028067,1112,727,385,131,43,211
2011,Bassetlaw 014A,E01028040,745,511,234,148,14,72
2011,Bassetlaw 014B,E01028041,778,514,264,147,38,79
2011,Bassetlaw 014C,E01028043,1092,727,365,239,43,83
2011,Bassetlaw 014D,E01028063,1372,972,400,274,43,83
2011,Bassetlaw 014E,E01028064,1051,648,403,113,141,149
2011,Bassetlaw 015A,E01028006,969,660,309,186,64,59
2011,Bassetlaw 015B,E01028007,825,573,252,151,33,68
2011,Bassetlaw 015C,E01028033,1823,1099,724,272,57,395
2011,Bassetlaw 015D,E01028037,1245,890,355,200,49,106
2011,Bassetlaw 015E,E01028038,1094,755,339,197,45,97
2011,Bassetlaw 015F,E01028039,882,585,297,210,19,68
2011,Bassetlaw 016E,E01028042,1048,761,287,143,43,101
2011,Bassetlaw 016F,E01028044,1069,660,409,206,36,167
2011,Bassetlaw 016G,E01028045,1386,909,477,263,47,167
2011,Bassetlaw 016A,E01028051,1124,754,370,245,25,100
2011,Bassetlaw 016B,E01028052,1235,841,394,272,42,80
2011,Bassetlaw 016C,E01028053,1177,740,437,215,35,187
2011,Bassetlaw 016D,E01028054,1103,774,329,227,35,67
2011,Broxtowe 001A,E01028092,951,672,279,142,36,101
2011,Broxtowe 001B,E01028093,807,514,293,227,22,44
2011,Broxtowe 001C,E01028107,1218,892,326,184,37,105
2011,Broxtowe 001D,E01028108,1148,772,376,240,41,95
2011,Broxtowe 001E,E01028114,1099,711,388,243,42,103
2011,Broxtowe 002A,E01028110,1076,654,422,195,35,192
2011,Broxtowe 002B,E01028111,1082,698,384,214,24,146
2011,Broxtowe 002C,E01028112,1170,787,383,158,46,179
2011,Broxtowe 002D,E01028113,1060,691,369,148,45,176
2011,Broxtowe 003A,E01028109,1290,852,438,284,37,117
2011,Broxtowe 003B,E01028115,1151,759,392,293,28,71
2011,Broxtowe 003C,E01028116,1169,810,359,240,32,87
2011,Broxtowe 003D,E01028117,1179,933,246,136,33,77
2011,Broxtowe 003E,E01028118,1226,745,481,376,27,78
2011,Broxtowe 004A,E01028102,1051,764,287,172,42,73
2011,Broxtowe 004B,E01028103,863,608,255,118,34,103
2011,Broxtowe 004C,E01028104,1127,837,290,177,52,61
2011,Broxtowe 004D,E01028122,1146,764,382,204,47,131
2011,Broxtowe 004E,E01028123,1457,1058,399,269,60,70
2011,Broxtowe 004F,E01028124,1111,736,375,237,42,96
2011,Broxtowe 007A,E01028087,1165,770,395,262,70,63
2011,Broxtowe 007B,E01028088,1072,737,335,234,58,43
2011,Broxtowe 007C,E01028089,950,650,300,209,43,48
2011,Broxtowe 007D,E01028090,1000,681,319,198,40,81
2011,Broxtowe 007E,E01028091,1056,726,330,217,52,61
2011,Broxtowe 008A,E01028125,1231,878,353,215,38,100
2011,Broxtowe 008B,E01028126,1018,720,298,157,49,92
2011,Broxtowe 008C,E01028127,1203,748,455,218,39,198
2011,Broxtowe 008D,E01028134,1122,853,269,126,46,97
2011,Broxtowe 009A,E01028076,966,668,298,148,59,91
2011,Broxtowe 009B,E01028077,1067,656,411,130,148,133
2011,Broxtowe 009C,E01028078,1213,821,392,118,148,126
2011,Broxtowe 009D,E01028079,1065,624,441,100,274,67
2011,Broxtowe 009E,E01028084,1303,971,332,189,70,73
2011,Broxtowe 010A,E01028128,1334,989,345,241,36,68
2011,Broxtowe 010B,E01028129,1067,714,353,195,45,113
2011,Broxtowe 010C,E01028130,1242,892,350,179,38,133
2011,Broxtowe 010D,E01028131,1104,799,305,196,37,72
2011,Broxtowe 010E,E01028132,734,554,180,84,30,66
2011,Broxtowe 010F,E01028133,1118,867,251,104,46,101
2011,Broxtowe 011A,E01028073,1128,683,445,186,176,83
2011,Broxtowe 011B,E01028074,1296,715,581,168,319,94
2011,Broxtowe 011C,E01028075,1332,896,436,92,252,92
2011,Broxtowe 011D,E01028085,1542,999,543,165,247,131
2011,Broxtowe 011E,E01028086,1173,864,309,139,85,85
2011,Broxtowe 012A,E01028080,1383,1068,315,134,91,90
2011,Broxtowe 012B,E01028081,896,586,310,219,30,61
2011,Broxtowe 012C,E01028082,985,777,208,124,35,49
2011,Broxtowe 012D,E01028083,1044,718,326,83,110,133
2011,Broxtowe 013A,E01028097,1139,758,381,282,42,57
2011,Broxtowe 013B,E01028098,1256,835,421,168,55,198
2011,Broxtowe 013C,E01028099,1173,857,316,208,38,70
2011,Broxtowe 013D,E01028100,1165,763,402,225,68,109
2011,Broxtowe 013E,E01028101,1009,671,338,113,54,171
2011,Broxtowe 014A,E01028069,879,666,213,131,43,39
2011,Broxtowe 014B,E01028070,794,521,273,184,31,58
2011,Broxtowe 014C,E01028094,1228,896,332,189,60,83
2011,Broxtowe 014D,E01028095,1032,718,314,181,48,85
2011,Broxtowe 014E,E01028096,1287,870,417,243,62,112
2011,Broxtowe 015A,E01028135,1010,719,291,190,43,58
2011,Broxtowe 015B,E01028136,1220,874,346,225,52,69
2011,Broxtowe 015C,E01028137,1840,1583,257,86,77,94
2011,Broxtowe 015D,E01028138,852,617,235,155,23,57
2011,Broxtowe 015E,E01028139,1054,812,242,157,36,49
2011,Broxtowe 016A,E01028105,906,641,265,160,40,65
2011,Broxtowe 016B,E01028106,1141,770,371,236,36,99
2011,Broxtowe 016C,E01028119,1637,1284,353,161,83,109
2011,Broxtowe 016D,E01028120,1174,856,318,214,43,61
2011,Broxtowe 016E,E01028121,1078,780,298,181,41,76
2011,Broxtowe 016F,E01033412,1789,1238,551,376,70,105
2011,Broxtowe 016G,E01033413,1720,1228,492,288,56,148
2011,Gedling 001A,E01028189,1744,1220,524,282,68,174
2011,Gedling 001B,E01028198,1020,674,346,263,39,44
2011,Gedling 001C,E01028199,1063,628,435,343,31,61
2011,Gedling 001D,E01028200,1191,856,335,215,44,76
2011,Gedling 001E,E01028201,865,580,285,222,25,38
2011,Gedling 002A,E01028150,1034,702,332,238,24,70
2011,Gedling 002B,E01028151,873,612,261,158,37,66
2011,Gedling 002C,E01028152,1140,819,321,190,31,100
2011,Gedling 002D,E01028153,906,621,285,125,29,131
2011,Gedling 002E,E01028154,1274,959,315,147,43,125
2011,Gedling 002F,E01028213,1422,930,492,372,40,80
2011,Gedling 004A,E01028143,910,642,268,156,18,94
2011,Gedling 004B,E01028205,956,660,296,163,45,88
2011,Gedling 004C,E01028206,1104,772,332,223,45,64
2011,Gedling 004D,E01028207,964,612,352,241,40,71
2011,Gedling 004E,E01028208,767,543,224,130,21,73
2011,Gedling 005A,E01028173,662,393,269,99,35,135
2011,Gedling 005B,E01028174,1047,728,319,126,53,140
2011,Gedling 005C,E01028175,1282,921,361,202,39,120
2011,Gedling 005D,E01028209,1034,744,290,103,42,145
2011,Gedling 006A,E01028144,1076,807,269,136,39,94
2011,Gedling 006B,E01028165,1041,736,305,169,22,114
2011,Gedling 006C,E01028166,1238,846,392,171,52,169
2011,Gedling 006D,E01028167,1384,993,391,146,63,182
2011,Gedling 007A,E01028179,1104,784,320,188,47,85
2011,Gedling 007B,E01028180,1092,745,347,247,34,66
2011,Gedling 007C,E01028181,1112,849,263,162,35,66
2011,Gedling 007D,E01028182,1192,878,314,181,55,78
2011,Gedling 007E,E01028183,895,559,336,245,26,65
2011,Gedling 008A,E01028148,1376,930,446,328,34,84
2011,Gedling 008B,E01028149,1139,812,327,216,37,74
2011,Gedling 008C,E01028178,1547,1082,465,344,40,81
2011,Gedling 009A,E01028176,1108,787,321,201,45,75
2011,Gedling 009B,E01028177,1194,858,336,245,30,61
2011,Gedling 009C,E01028214,1036,734,302,193,42,67
2011,Gedling 009D,E01028215,973,733,240,141,40,59
2011,Gedling 009E,E01028216,933,675,258,178,51,29
2011,Gedling 009F,E01028217,951,708,243,120,56,67
2011,Gedling 009G,E01028218,1076,747,329,258,32,39
2011,Gedling 010A,E01028193,973,704,269,158,36,75
2011,Gedling 010B,E01028194,1093,834,259,129,52,78
2011,Gedling 010C,E01028195,1085,861,224,131,33,60
2011,Gedling 010D,E01028196,1069,799,270,163,47,60
2011,Gedling 010E,E01028197,970,698,272,173,27,72
2011,Gedling 010F,E01028204,1035,745,290,194,28,68
2011,Gedling 011A,E01028172,844,627,217,132,25,60
2011,Gedling 011B,E01028190,1191,906,285,180,31,74
2011,Gedling 011C,E01028202,1097,715,382,263,38,81
2011,Gedling 011D,E01028203,1072,743,329,205,39,85
2011,Gedling 011E,E01028212,1094,806,288,119,47,122
2011,Gedling 012A,E01028168,917,654,263,173,30,60
2011,Gedling 012B,E01028169,1087,734,353,260,40,53
2011,Gedling 012C,E01028170,1030,732,298,189,45,64
2011,Gedling 012D,E01028171,1010,746,264,125,40,99
2011,Gedling 012E,E01028191,1329,980,349,178,55,116
2011,Gedling 012F,E01028192,1120,794,326,146,41,139
2011,Gedling 013A,E01028160,1134,868,266,120,51,95
2011,Gedling 013B,E01028161,1103,820,283,133,43,107
2011,Gedling 013C,E01028162,1052,801,251,116,48,87
2011,Gedling 013D,E01028163,1109,826,283,185,21,77
2011,Gedling 013E,E01028211,1011,722,289,150,36,103
2011,Gedling 014A,E01028155,1054,770,284,151,43,90
2011,Gedling 014B,E01028156,952,698,254,149,30,75
2011,Gedling 014C,E01028157,981,666,315,168,44,103
2011,Gedling 014D,E01028158,1165,812,353,171,45,137
2011,Gedling 014E,E01028159,968,701,267,138,40,89
2011,Gedling 014F,E01028164,940,683,257,103,37,117
2011,Gedling 014G,E01028210,1020,696,324,174,31,119
2011,Gedling 015A,E01028184,900,685,215,127,31,57
2011,Gedling 015B,E01028185,1351,975,376,198,53,125
2011,Gedling 015C,E01028186,1165,847,318,114,45,159
2011,Gedling 015D,E01028187,1063,789,274,55,46,173
2011,Gedling 015E,E01028188,1147,955,192,70,27,95
2011,Gedling 016A,E01028142,1422,977,445,300,41,104
2011,Gedling 016B,E01028146,1202,930,272,120,41,111
2011,Gedling 016C,E01028147,773,576,197,66,32,99
2011,Gedling 016D,E01032622,1031,739,292,181,38,73
2011,Mansfield 001A,E01028224,1075,583,492,301,36,155
2011,Mansfield 001B,E01028257,1155,794,361,137,45,179
2011,Mansfield 001C,E01028258,1217,750,467,272,48,147
2011,Mansfield 001D,E01028259,1098,703,395,154,43,198
2011,Mansfield 002A,E01028223,703,441,262,110,22,130
2011,Mansfield 002B,E01028225,1125,696,429,209,33,187
2011,Mansfield 002C,E01028226,1073,721,352,130,38,184
2011,Mansfield 002D,E01028260,1255,834,421,244,35,142
2011,Mansfield 003A,E01028251,1242,922,320,195,46,79
2011,Mansfield 003B,E01028252,1430,964,466,244,48,174
2011,Mansfield 003C,E01028253,1307,895,412,299,25,88
2011,Mansfield 003D,E01028277,969,608,361,262,31,68
2011,Mansfield 003E,E01028278,1050,708,342,194,29,119
2011,Mansfield 004A,E01028271,1248,814,434,160,49,225
2011,Mansfield 004B,E01028279,1038,624,414,212,35,167
2011,Mansfield 004C,E01028280,972,593,379,157,39,183
2011,Mansfield 004D,E01028281,1017,669,348,85,52,211
2011,Mansfield 004E,E01028283,1347,999,348,197,26,125
2011,Mansfield 005A,E01028242,1202,902,300,184,28,88
2011,Mansfield 005B,E01028250,1124,800,324,199,25,100
2011,Mansfield 005C,E01028272,1193,816,377,160,58,159
2011,Mansfield 005D,E01028273,1178,855,323,157,49,117
2011,Mansfield 006A,E01028229,1124,681,443,261,25,157
2011,Mansfield 006B,E01028232,1094,693,401,227,36,138
2011,Mansfield 006E,E01028267,1404,912,492,152,66,274
2011,Mansfield 006F,E01028282,805,501,304,136,33,135
2011,Mansfield 006G,E01033392,1632,1011,621,297,57,267
2011,Mansfield 007A,E01028237,1181,838,343,210,37,96
2011,Mansfield 007B,E01028238,1113,710,403,143,58,202
2011,Mansfield 007C,E01028239,1198,836,362,187,40,135
2011,Mansfield 007D,E01028240,1130,806,324,197,35,92
2011,Mansfield 007E,E01028241,1714,1389,325,167,62,96
2011,Mansfield 007F,E01028243,1282,792,490,319,43,128
2011,Mansfield 008A,E01028227,975,637,338,150,40,148
2011,Mansfield 008B,E01028228,857,569,288,162,23,103
2011,Mansfield 008C,E01028247,1275,932,343,87,34,222
2011,Mansfield 008D,E01028268,1323,974,349,87,42,220
2011,Mansfield 008E,E01028269,1129,815,314,90,37,187
2011,Mansfield 008F,E01028284,1126,745,381,167,41,173
2011,Mansfield 009A,E01028233,1408,1001,407,156,48,203
2011,Mansfield 009B,E01028234,1189,774,415,159,48,208
2011,Mansfield 009C,E01028274,1111,798,313,101,33,179
2011,Mansfield 009D,E01028275,1104,709,395,120,42,233
2011,Mansfield 009E,E01028276,1135,595,540,167,48,325
2011,Mansfield 010A,E01028230,997,652,345,134,37,174
2011,Mansfield 010B,E01028231,1010,653,357,148,37,172
2011,Mansfield 010C,E01028244,1139,835,304,177,29,98
2011,Mansfield 010D,E01028245,932,589,343,129,38,176
2011,Mansfield 010E,E01028246,1325,993,332,202,28,102
2011,Mansfield 010F,E01028248,1065,705,360,179,41,140
2011,Mansfield 010G,E01028249,974,666,308,147,45,116
2011,Mansfield 011A,E01028235,1202,867,335,219,39,77
2011,Mansfield 011B,E01028236,1289,954,335,187,38,110
2011,Mansfield 011C,E01028262,1137,822,315,199,37,79
2011,Mansfield 011D,E01028264,1476,1027,449,292,54,103
2011,Mansfield 012A,E01028254,982,621,361,190,45,126
2011,Mansfield 012B,E01028256,1230,780,450,124,58,268
2011,Mansfield 012C,E01028261,1243,776,467,132,66,269
2011,Mansfield 012D,E01028263,1132,598,534,169,50,315
2011,Mansfield 013A,E01028219,1034,715,319,253,22,44
2011,Mansfield 013B,E01028220,1416,1080,336,171,43,122
2011,Mansfield 013D,E01028222,1132,786,346,259,35,52
2011,Mansfield 013E,E01028255,1002,585,417,333,21,63
2011,Mansfield 013F,E01028270,1114,810,304,193,36,75
2011,Mansfield 013G,E01033389,1011,873,138,59,28,51
2011,Mansfield 013H,E01033390,1116,976,140,33,39,68
2011,Mansfield 013I,E01033391,870,620,250,187,27,36
2011,Newark and Sherwood 001A,E01028301,1350,827,523,143,80,300
2011,Newark and Sherwood 001B,E01028302,1171,769,402,214,38,150
2011,Newark and Sherwood 001C,E01028338,1180,800,380,182,46,152
2011,Newark and Sherwood 001D,E01028339,1323,957,366,145,53,168
2011,Newark and Sherwood 001E,E01028340,1076,706,370,169,35,166
2011,Newark and Sherwood 001F,E01028341,1263,807,456,294,30,132
2011,Newark and Sherwood 002A,E01028313,1345,835,510,250,51,209
2011,Newark and Sherwood 002B,E01028314,1904,1448,456,171,69,216
2011,Newark and Sherwood 002C,E01028321,1185,738,447,325,40,82
2011,Newark and Sherwood 002D,E01028322,1438,954,484,326,48,110
2011,Newark and Sherwood 002E,E01028323,1176,864,312,169,42,101
2011,Newark and Sherwood 003A,E01028303,1161,718,443,315,32,96
2011,Newark and Sherwood 003B,E01028312,1710,1187,523,337,56,130
2011,Newark and Sherwood 003C,E01028337,1139,800,339,243,40,56
2011,Newark and Sherwood 003D,E01028349,1155,816,339,227,31,81
2011,Newark and Sherwood 003E,E01028350,854,595,259,155,25,79
2011,Newark and Sherwood 004A,E01028315,1044,682,362,268,26,68
2011,Newark and Sherwood 004B,E01028316,1062,649,413,278,29,106
2011,Newark and Sherwood 004C,E01028317,1204,837,367,245,39,83
2011,Newark and Sherwood 004D,E01028353,1998,1386,612,409,51,152
2011,Newark and Sherwood 005A,E01028295,1523,1007,516,302,48,166
2011,Newark and Sherwood 005B,E01028297,1350,872,478,211,55,212
2011,Newark and Sherwood 005C,E01028327,1150,793,357,224,38,95
2011,Newark and Sherwood 005D,E01028328,1247,853,394,284,41,69
2011,Newark and Sherwood 005E,E01028329,1197,835,362,218,57,87
2011,Newark and Sherwood 006A,E01028296,984,632,352,161,34,157
2011,Newark and Sherwood 006B,E01028298,1190,865,325,163,44,118
2011,Newark and Sherwood 006C,E01028299,953,634,319,104,35,180
2011,Newark and Sherwood 006D,E01028300,1112,688,424,183,38,203
2011,Newark and Sherwood 006E,E01028342,1138,841,297,98,53,146
2011,Newark and Sherwood 006F,E01028343,1497,945,552,286,53,213
2011,Newark and Sherwood 006G,E01028344,1103,803,300,170,44,86
2011,Newark and Sherwood 007A,E01028294,1284,944,340,167,32,141
2011,Newark and Sherwood 007B,E01028304,1043,707,336,138,37,161
2011,Newark and Sherwood 007C,E01028305,1064,787,277,124,43,110
2011,Newark and Sherwood 007D,E01028306,1184,828,356,175,36,145
2011,Newark and Sherwood 007E,E01028307,994,784,210,86,34,90
2011,Newark and Sherwood 007F,E01028310,1329,994,335,116,64,155
2011,Newark and Sherwood 007G,E01028311,1191,821,370,132,53,185
2011,Newark and Sherwood 008A,E01028345,1471,930,541,383,83,75
2011,Newark and Sherwood 008B,E01028346,1552,1043,509,352,76,81
2011,Newark and Sherwood 008C,E01028347,1083,770,313,198,58,57
2011,Newark and Sherwood 008D,E01028348,1070,635,435,143,241,51
2011,Newark and Sherwood 009A,E01028292,1666,1278,388,239,45,104
2011,Newark and Sherwood 009B,E01028293,1402,1063,339,175,40,124
2011,Newark and Sherwood 009C,E01028333,992,750,242,145,18,79
2011,Newark and Sherwood 009D,E01028334,1077,706,371,124,60,187
2011,Newark and Sherwood 009E,E01028335,1308,976,332,157,49,126
2011,Newark and Sherwood 010A,E01028308,1169,804,365,225,34,106
2011,Newark and Sherwood 010B,E01028309,1085,775,310,215,28,67
2011,Newark and Sherwood 010C,E01028318,1106,681,425,139,54,232
2011,Newark and Sherwood 010D,E01028319,1296,839,457,202,36,219
2011,Newark and Sherwood 010E,E01028320,1134,684,450,164,38,248
2011,Newark and Sherwood 011A,E01028285,936,722,214,114,33,67
2011,Newark and Sherwood 011B,E01028286,860,542,318,221,25,72
2011,Newark and Sherwood 011C,E01028287,1031,703,328,202,37,89
2011,Newark and Sherwood 011D,E01028288,1122,780,342,227,35,80
2011,Newark and Sherwood 011E,E01028289,1030,748,282,183,15,84
2011,Newark and Sherwood 011F,E01028290,1046,735,311,204,39,68
2011,Newark and Sherwood 011G,E01028291,1155,849,306,142,51,113
2011,Newark and Sherwood 012B,E01028325,885,603,282,193,24,65
2011,Newark and Sherwood 012C,E01028326,944,616,328,226,20,82
2011,Newark and Sherwood 012D,E01028336,840,571,269,171,35,63
2011,Newark and Sherwood 012E,E01028352,878,628,250,160,33,57
2011,Newark and Sherwood 012F,E01033393,1584,1335,249,116,39,94
2011,Newark and Sherwood 012G,E01033394,923,639,284,205,21,58
2011,Newark and Sherwood 013A,E01028330,1187,843,344,255,40,49
2011,Newark and Sherwood 013B,E01028331,1877,1242,635,195,52,388
2011,Newark and Sherwood 013C,E01028332,1262,886,376,252,51,73
2011,Newark and Sherwood 013D,E01028351,903,587,316,218,47,51
2011,Rushcliffe 001A,E01028371,2163,1317,846,355,61,430
2011,Rushcliffe 001B,E01028403,1556,1049,507,342,62,103
2011,Rushcliffe 001C,E01028411,1578,1157,421,262,64,95
2011,Rushcliffe 002A,E01028357,1071,706,365,272,40,53
2011,Rushcliffe 002B,E01028358,931,628,303,212,28,63
2011,Rushcliffe 002C,E01028359,1227,930,297,194,36,67
2011,Rushcliffe 002D,E01028360,1361,1074,287,153,45,89
2011,Rushcliffe 002E,E01028361,1014,795,219,131,39,49
2011,Rushcliffe 002F,E01028362,1004,697,307,153,53,101
2011,Rushcliffe 003A,E01028393,847,559,288,227,22,39
2011,Rushcliffe 003B,E01028394,1014,714,300,215,24,61
2011,Rushcliffe 003C,E01028395,1033,802,231,141,27,63
2011,Rushcliffe 003D,E01028413,1103,784,319,200,26,93
2011,Rushcliffe 003E,E01028414,1093,705,388,289,29,70
2011,Rushcliffe 003F,E01028415,1119,829,290,212,34,44
2011,Rushcliffe 004A,E01028354,1079,817,262,142,67,53
2011,Rushcliffe 004B,E01028355,1091,835,256,126,55,75
2011,Rushcliffe 004C,E01028384,1308,1012,296,97,131,68
2011,Rushcliffe 004D,E01028385,1227,998,229,114,48,67
2011,Rushcliffe 004E,E01028386,1246,982,264,100,82,82
2011,Rushcliffe 005A,E01028396,1135,894,241,99,94,48
2011,Rushcliffe 005B,E01028398,1044,818,226,89,71,66
2011,Rushcliffe 005C,E01028399,990,721,269,78,123,68
2011,Rushcliffe 005D,E01028416,1281,934,347,51,239,57
2011,Rushcliffe 005E,E01028417,1307,964,343,52,203,88
2011,Rushcliffe 005F,E01028418,1155,797,358,102,168,88
2011,Rushcliffe 006A,E01028356,1104,822,282,161,55,66
2011,Rushcliffe 006B,E01028375,1319,1090,229,98,39,92
2011,Rushcliffe 006C,E01028376,1167,862,305,193,43,69
2011,Rushcliffe 006D,E01028377,1386,1120,266,123,67,76
2011,Rushcliffe 006E,E01028397,1255,908,347,187,76,84
2011,Rushcliffe 007A,E01028363,1103,863,240,98,75,67
2011,Rushcliffe 007B,E01028364,1275,976,299,145,66,88
2011,Rushcliffe 007C,E01028365,1251,952,299,117,105,77
2011,Rushcliffe 007D,E01028391,1394,960,434,294,61,79
2011,Rushcliffe 007E,E01028392,1318,909,409,231,67,111
2011,Rushcliffe 008A,E01028372,812,551,261,129,32,100
2011,Rushcliffe 008B,E01028373,963,631,332,218,41,73
2011,Rushcliffe 008C,E01028374,813,548,265,150,42,73
2011,Rushcliffe 008D,E01028400,1143,867,276,149,67,60
2011,Rushcliffe 008E,E01028401,923,685,238,121,54,63
2011,Rushcliffe 009A,E01028366,956,685,271,118,34,119
2011,Rushcliffe 009B,E01028367,1044,733,311,194,30,87
2011,Rushcliffe 009C,E01028368,1148,916,232,150,25,57
2011,Rushcliffe 009D,E01028369,1078,830,248,114,35,99
2011,Rushcliffe 009E,E01028370,1070,752,318,197,40,81
2011,Rushcliffe 010A,E01028402,1397,1008,389,268,39,82
2011,Rushcliffe 010B,E01028419,1825,1304,521,342,60,119
2011,Rushcliffe 010C,E01028420,1036,712,324,232,34,58
2011,Rushcliffe 011A,E01028404,1131,824,307,192,54,61
2011,Rushcliffe 011B,E01028405,1386,1033,353,206,34,113
2011,Rushcliffe 011C,E01028406,1194,877,317,150,39,128
2011,Rushcliffe 011D,E01028407,1483,1137,346,215,48,83
2011,Rushcliffe 012A,E01028379,1157,733,424,330,42,52
2011,Rushcliffe 012B,E01028412,1320,886,434,340,50,44
2011,Rushcliffe 012C,E01028421,1558,1088,470,307,65,98
2011,Rushcliffe 013A,E01028380,861,609,252,115,24,113
2011,Rushcliffe 013B,E01028381,971,676,295,222,30,43
2011,Rushcliffe 013C,E01028382,1015,677,338,247,45,46
2011,Rushcliffe 013D,E01028383,793,524,269,206,27,36
2011,Rushcliffe 014A,E01028378,1510,1045,465,333,55,77
2011,Rushcliffe 014B,E01028387,1184,844,340,158,70,112
2011,Rushcliffe 014C,E01028408,2106,1175,931,256,600,75
2011,Rushcliffe 015A,E01028388,1194,896,298,173,68,57
2011,Rushcliffe 015B,E01028389,1025,660,365,302,31,32
2011,Rushcliffe 015C,E01028390,1189,788,401,275,53,73
2011,Rushcliffe 015D,E01028409,975,700,275,171,35,69
2011,Rushcliffe 015E,E01028410,946,671,275,185,37,53
2011,Herefordshire 001A,E01013998,967,662,305,234,18,53
2011,Herefordshire 001B,E01014051,1212,848,364,226,33,105
2011,Herefordshire 001C,E01014052,1153,820,333,229,38,66
2011,Herefordshire 001D,E01014096,1129,799,330,228,25,77
2011,Herefordshire 002A,E01014041,1036,710,326,202,25,99
2011,Herefordshire 002B,E01014042,1129,787,342,95,39,208
2011,Herefordshire 002C,E01014043,738,500,238,163,15,60
2011,Herefordshire 002D,E01014044,1082,801,281,135,43,103
2011,Herefordshire 003A,E01014045,1174,853,321,187,43,91
2011,Herefordshire 003B,E01014046,1065,730,335,211,43,81
2011,Herefordshire 003C,E01014047,1029,644,385,182,48,155
2011,Herefordshire 003D,E01014048,1064,758,306,145,18,143
2011,Herefordshire 004A,E01013999,1053,680,373,232,68,73
2011,Herefordshire 004B,E01014017,1055,737,318,207,37,74
2011,Herefordshire 004C,E01014024,978,694,284,185,31,68
2011,Herefordshire 004D,E01014025,1040,695,345,243,28,74
2011,Herefordshire 004E,E01014055,1187,800,387,247,39,101
2011,Herefordshire 004F,E01014097,972,697,275,191,32,52
2011,Herefordshire 005A,E01014000,1043,737,306,202,24,80
2011,Herefordshire 005B,E01014001,1112,767,345,216,51,78
2011,Herefordshire 005C,E01014002,933,615,318,228,23,67
2011,Herefordshire 005D,E01014003,1110,767,343,142,68,133
2011,Herefordshire 005E,E01014004,1043,721,322,214,38,70
2011,Herefordshire 005F,E01014005,1139,792,347,170,33,144
2011,Herefordshire 005G,E01014015,1225,893,332,197,36,99
2011,Herefordshire 006A,E01014008,1177,818,359,235,35,89
2011,Herefordshire 006B,E01014009,1102,734,368,250,38,80
2011,Herefordshire 006C,E01014033,1199,845,354,207,33,114
2011,Herefordshire 006D,E01014034,1034,762,272,137,25,110
2011,Herefordshire 006E,E01014056,1119,782,337,211,36,90
2011,Herefordshire 007A,E01014006,1175,824,351,230,41,80
2011,Herefordshire 007B,E01014012,1223,842,381,249,43,89
2011,Herefordshire 007C,E01014013,1294,988,306,141,45,120
2011,Herefordshire 007D,E01014016,1008,614,394,242,44,108
2011,Herefordshire 007E,E01014100,1140,828,312,195,37,80
2011,Herefordshire 007F,E01014101,823,551,272,186,33,53
2011,Herefordshire 008A,E01014022,1524,1184,340,200,60,80
2011,Herefordshire 008B,E01014023,1280,974,306,166,38,102
2011,Herefordshire 008C,E01014081,1092,745,347,227,41,79
2011,Herefordshire 008D,E01014082,1397,1044,353,225,47,81
2011,Herefordshire 009A,E01014027,957,650,307,202,23,82
2011,Herefordshire 009B,E01014028,1061,676,385,267,35,83
2011,Herefordshire 009C,E01014029,1029,651,378,253,46,79
2011,Herefordshire 009D,E01014030,1040,708,332,237,31,64
2011,Herefordshire 010A,E01014083,1140,809,331,241,27,63
2011,Herefordshire 010B,E01014084,1125,863,262,132,35,95
2011,Herefordshire 010C,E01014085,1045,788,257,117,38,102
2011,Herefordshire 010D,E01014087,1187,935,252,146,25,81
2011,Herefordshire 010E,E01014088,1110,873,237,135,19,83
2011,Herefordshire 010F,E01014089,1092,802,290,148,32,110
2011,Herefordshire 011A,E01013987,1136,804,332,192,59,81
2011,Herefordshire 011B,E01013988,1281,877,404,254,59,91
2011,Herefordshire 011C,E01014007,1251,908,343,231,56,56
2011,Herefordshire 011D,E01014095,1080,773,307,171,54,82
2011,Herefordshire 012A,E01013986,1254,905,349,153,47,149
2011,Herefordshire 012B,E01013989,1175,775,400,102,165,133
2011,Herefordshire 012C,E01014010,1311,1013,298,106,58,134
2011,Herefordshire 012D,E01014011,1137,885,252,97,54,101
2011,Herefordshire 012E,E01014086,1098,838,260,100,36,124
2011,Herefordshire 012F,E01014092,1389,1013,376,204,65,107
2011,Herefordshire 013A,E01014075,1240,917,323,166,60,97
2011,Herefordshire 013B,E01014076,1633,1343,290,128,64,98
2011,Herefordshire 013C,E01014077,1140,835,305,197,37,71
2011,Herefordshire 013D,E01014078,1008,750,258,124,43,91
2011,Herefordshire 014A,E01014090,1052,748,304,215,44,45
2011,Herefordshire 014B,E01014091,1036,725,311,205,40,66
2011,Herefordshire 014C,E01014093,1047,697,350,190,45,115
2011,Herefordshire 014D,E01014094,1105,802,303,195,48,60
2011,Herefordshire 015A,E01014068,1114,785,329,189,38,102
2011,Herefordshire 015B,E01014070,1639,1316,323,163,54,106
2011,Herefordshire 015C,E01014072,1488,1118,370,163,51,156
2011,Herefordshire 015D,E01014073,1332,938,394,131,48,215
2011,Herefordshire 015E,E01014074,1156,787,369,148,50,171
2011,Herefordshire 016A,E01013996,1148,930,218,115,24,79
2011,Herefordshire 016B,E01013997,1515,1203,312,138,65,109
2011,Herefordshire 016C,E01014079,1180,815,365,235,48,82
2011,Herefordshire 016D,E01014080,1006,644,362,226,37,99
2011,Herefordshire 017A,E01013992,1100,834,266,103,37,126
2011,Herefordshire 017B,E01013993,1114,745,369,138,53,178
2011,Herefordshire 017C,E01013994,1109,783,326,111,39,176
2011,Herefordshire 017D,E01013995,1177,798,379,122,38,219
2011,Herefordshire 017E,E01014071,1011,725,286,93,43,150
2011,Herefordshire 018A,E01013990,1227,848,379,272,38,69
2011,Herefordshire 018B,E01013991,992,685,307,164,38,105
2011,Herefordshire 018C,E01014014,1385,1030,355,220,53,82
2011,Herefordshire 018D,E01014054,1041,760,281,179,36,66
2011,Herefordshire 019A,E01014035,1202,897,305,142,39,124
2011,Herefordshire 019B,E01014036,1101,746,355,246,39,70
2011,Herefordshire 019C,E01014037,994,646,348,262,23,63
2011,Herefordshire 019D,E01014038,1047,741,306,178,33,95
2011,Herefordshire 019E,E01014039,1243,962,281,173,43,65
2011,Herefordshire 019F,E01014040,1144,800,344,229,30,85
2011,Herefordshire 020A,E01014018,1082,756,326,198,45,83
2011,Herefordshire 020B,E01014019,1144,815,329,191,44,94
2011,Herefordshire 020C,E01014020,1128,834,294,186,46,62
2011,Herefordshire 020D,E01014021,1011,710,301,198,24,79
2011,Herefordshire 021A,E01014026,1585,1104,481,285,57,139
2011,Herefordshire 021B,E01014059,1483,1086,397,246,54,97
2011,Herefordshire 021C,E01014060,1151,798,353,222,41,90
2011,Herefordshire 021D,E01014069,1359,1097,262,107,40,115
2011,Herefordshire 021E,E01014098,1119,777,342,169,61,112
2011,Herefordshire 021F,E01014099,1317,913,404,235,44,125
2011,Herefordshire 022A,E01014061,1048,651,397,290,46,61
2011,Herefordshire 022B,E01014062,1181,881,300,183,32,85
2011,Herefordshire 022C,E01014063,1212,803,409,240,39,130
2011,Herefordshire 022D,E01014064,1173,856,317,121,35,161
2011,Herefordshire 022E,E01014065,1112,786,326,178,45,103
2011,Herefordshire 022F,E01014066,829,599,230,140,26,64
2011,Herefordshire 022G,E01014067,1018,755,263,174,40,49
2011,Herefordshire 023A,E01014031,1110,762,348,215,43,90
2011,Herefordshire 023B,E01014032,1192,848,344,231,49,64
2011,Herefordshire 023C,E01014049,1188,787,401,243,37,121
2011,Herefordshire 023D,E01014050,1320,931,389,250,49,90
2011,Herefordshire 023E,E01014053,1325,951,374,242,44,88
2011,Herefordshire 023F,E01014057,1260,841,419,259,44,116
2011,Herefordshire 023G,E01014058,1216,832,384,286,26,72
2011,Shropshire 025A,E01028853,1054,719,335,160,40,135
2011,Shropshire 025B,E01028854,1163,836,327,227,26,74
2011,Shropshire 025C,E01028855,1149,839,310,205,37,68
2011,Shropshire 025D,E01028856,938,676,262,158,30,74
2011,Shropshire 025E,E01028857,1311,928,383,236,46,101
2011,Shropshire 027A,E01028826,1222,838,384,245,48,91
2011,Shropshire 027B,E01028827,1070,776,294,170,37,87
2011,Shropshire 027C,E01028844,1570,1376,194,85,19,90
2011,Shropshire 027D,E01028845,1362,926,436,340,37,59
2011,Shropshire 029A,E01028838,1055,681,374,202,44,128
2011,Shropshire 029B,E01028839,1001,693,308,206,35,67
2011,Shropshire 029C,E01028840,993,708,285,169,35,81
2011,Shropshire 029D,E01028841,1177,866,311,170,43,98
2011,Shropshire 029E,E01028850,1741,1341,400,228,57,115
2011,Shropshire 029F,E01028851,1214,814,400,253,51,96
2011,Shropshire 029G,E01028852,1185,818,367,245,30,92
2011,Shropshire 031A,E01028830,1087,765,322,208,36,78
2011,Shropshire 031B,E01028831,1090,750,340,227,44,69
2011,Shropshire 031C,E01028836,1033,707,326,164,35,127
2011,Shropshire 031D,E01028837,1133,783,350,239,40,71
2011,Shropshire 033A,E01028832,1296,973,323,207,35,81
2011,Shropshire 033B,E01028833,1066,735,331,218,37,76
2011,Shropshire 033C,E01028834,1147,756,391,240,40,111
2011,Shropshire 033D,E01028835,1124,811,313,194,43,76
2011,Shropshire 034A,E01028828,1236,892,344,205,42,97
2011,Shropshire 034B,E01028829,999,652,347,261,39,47
2011,Shropshire 034C,E01028842,1213,873,340,207,46,87
2011,Shropshire 034D,E01028847,1127,793,334,204,48,82
2011,Shropshire 034E,E01028859,1212,849,363,237,38,88
2011,Shropshire 035A,E01028843,1246,874,372,237,48,87
2011,Shropshire 035B,E01028846,1306,914,392,261,32,99
2011,Shropshire 035C,E01028848,1243,807,436,295,42,99
2011,Shropshire 035D,E01028849,1423,940,483,273,47,163
2011,Shropshire 035E,E01028858,1641,1105,536,380,49,107
2011,Shropshire 001A,E01028891,1231,905,326,134,48,144
2011,Shropshire 001B,E01028892,1026,725,301,211,31,59
2011,Shropshire 001C,E01028894,1102,805,297,150,35,112
2011,Shropshire 001D,E01028895,1206,864,342,136,66,140
2011,Shropshire 001E,E01028896,1494,1130,364,198,39,127
2011,Shropshire 001F,E01028897,1017,696,321,179,46,96
2011,Shropshire 002A,E01028880,1138,764,374,198,50,126
2011,Shropshire 002B,E01028881,946,634,312,210,37,65
2011,Shropshire 002C,E01028882,1167,869,298,159,41,98
2011,Shropshire 002D,E01028893,1143,833,310,182,33,95
2011,Shropshire 002E,E01028899,1153,808,345,234,28,83
2011,Shropshire 004A,E01028864,1099,788,311,194,40,77
2011,Shropshire 004B,E01028865,1232,873,359,258,34,67
2011,Shropshire 004C,E01028866,959,703,256,155,32,69
2011,Shropshire 004D,E01028867,910,610,300,163,35,102
2011,Shropshire 004E,E01028872,1207,774,433,179,169,85
2011,Shropshire 005A,E01028873,1271,903,368,156,30,182
2011,Shropshire 005B,E01028874,996,585,411,293,40,78
2011,Shropshire 005C,E01028875,1768,1330,438,258,58,122
2011,Shropshire 005D,E01028876,1250,846,404,202,49,153
2011,Shropshire 005E,E01028877,944,694,250,157,37,56
2011,Shropshire 005F,E01028878,1153,793,360,228,39,93
2011,Shropshire 005G,E01028879,1151,815,336,149,32,155
2011,Shropshire 008A,E01028886,1202,848,354,170,42,142
2011,Shropshire 008B,E01028887,920,629,291,192,36,63
2011,Shropshire 008C,E01028889,1018,645,373,234,68,71
2011,Shropshire 008D,E01028890,997,711,286,169,37,80
2011,Shropshire 009A,E01028868,1103,735,368,236,40,92
2011,Shropshire 009B,E01028869,1088,794,294,153,49,92
2011,Shropshire 009C,E01028871,883,658,225,115,35,75
2011,Shropshire 009D,E01028885,2257,1505,752,191,86,475
2011,Shropshire 010A,E01028860,1332,971,361,203,62,96
2011,Shropshire 010B,E01028862,1188,850,338,216,37,85
2011,Shropshire 010C,E01028863,1066,796,270,168,39,63
2011,Shropshire 010D,E01028888,1198,888,310,153,68,89
2011,Shropshire 010E,E01028898,1084,771,313,198,36,79
2011,Shropshire 013A,E01028861,946,677,269,173,36,60
2011,Shropshire 013B,E01028870,1108,811,297,177,29,91
2011,Shropshire 013C,E01028883,1271,1025,246,132,25,89
2011,Shropshire 013D,E01028884,1080,775,305,193,28,84
2011,Shropshire 003A,E01028910,1170,648,522,165,280,77
2011,Shropshire 003B,E01028911,993,737,256,174,29,53
2011,Shropshire 003C,E01028912,808,535,273,104,35,134
2011,Shropshire 003D,E01028920,925,647,278,165,23,90
2011,Shropshire 003E,E01028921,1151,868,283,167,35,81
2011,Shropshire 003F,E01028925,1087,705,382,179,139,64
2011,Shropshire 003G,E01028926,1020,693,327,178,37,112
2011,Shropshire 006C,E01028902,790,519,271,163,18,90
2011,Shropshire 006D,E01028903,903,558,345,212,32,101
2011,Shropshire 006E,E01028904,1064,759,305,157,39,109
2011,Shropshire 006F,E01028905,1267,918,349,128,56,165
2011,Shropshire 006G,E01028909,1060,782,278,132,37,109
2011,Shropshire 006H,E01033528,1915,1530,385,192,73,120
2011,Shropshire 007A,E01028906,951,706,245,81,38,126
2011,Shropshire 007B,E01028907,1204,871,333,209,46,78
2011,Shropshire 007C,E01028908,1155,833,322,112,34,176
2011,Shropshire 007D,E01028916,1067,696,371,287,25,59
2011,Shropshire 007E,E01028917,1083,778,305,162,83,60
2011,Shropshire 007F,E01028924,1155,867,288,159,45,84
2011,Shropshire 011A,E01028913,1157,843,314,211,24,79
2011,Shropshire 011B,E01028918,1066,787,279,160,35,84
2011,Shropshire 011C,E01028919,898,667,231,127,35,69
2011,Shropshire 011D,E01028927,782,515,267,155,37,75
2011,Shropshire 011E,E01028928,1146,791,355,209,38,108
2011,Shropshire 012A,E01028914,822,542,280,195,29,56
2011,Shropshire 012B,E01028915,1004,665,339,234,28,77
2011,Shropshire 012C,E01028922,941,683,258,151,43,64
2011,Shropshire 012D,E01028923,1193,848,345,249,39,57
2011,Shropshire 014A,E01028929,1113,830,283,197,33,53
2011,Shropshire 014B,E01028969,1063,742,321,185,68,68
2011,Shropshire 014C,E01028970,926,656,270,184,28,58
2011,Shropshire 014D,E01028971,1544,1065,479,313,59,107
2011,Shropshire 014E,E01028978,1144,875,269,138,34,97
2011,Shropshire 014F,E01028979,918,713,205,126,28,51
2011,Shropshire 015A,E01028933,1191,904,287,149,37,101
2011,Shropshire 015B,E01028934,1047,724,323,118,33,172
2011,Shropshire 015C,E01028956,1118,788,330,245,29,56
2011,Shropshire 015D,E01028957,1085,723,362,111,43,208
2011,Shropshire 015E,E01028958,1366,1013,353,168,52,133
2011,Shropshire 016A,E01028932,1481,1208,273,159,33,81
2011,Shropshire 016B,E01028981,1201,935,266,145,39,82
2011,Shropshire 016C,E01028982,1137,873,264,136,25,103
2011,Shropshire 016D,E01028983,1448,1031,417,169,60,188
2011,Shropshire 017A,E01028930,1201,978,223,105,40,78
2011,Shropshire 017B,E01028931,1483,1185,298,143,47,108
2011,Shropshire 017C,E01028944,1288,947,341,205,34,102
2011,Shropshire 017D,E01028945,1611,1233,378,142,48,188
2011,Shropshire 018A,E01028965,1022,654,368,176,37,155
2011,Shropshire 018B,E01028966,960,680,280,200,32,48
2011,Shropshire 018C,E01028967,1075,676,399,146,70,183
2011,Shropshire 018D,E01028968,955,665,290,147,39,104
2011,Shropshire 018E,E01028988,1247,963,284,145,48,91
2011,Shropshire 018F,E01028989,1224,880,344,154,67,123
2011,Shropshire 019A,E01028946,1941,1430,511,241,56,214
2011,Shropshire 019B,E01028972,1211,867,344,246,37,61
2011,Shropshire 019C,E01028973,1442,1117,325,169,56,100
2011,Shropshire 019D,E01028987,1548,1199,349,204,45,100
2011,Shropshire 020A,E01028941,1393,969,424,168,154,102
2011,Shropshire 020B,E01028942,1061,809,252,120,49,83
2011,Shropshire 020C,E01028943,1650,1299,351,201,44,106
2011,Shropshire 020D,E01028951,1056,743,313,198,41,74
2011,Shropshire 020E,E01028953,977,713,264,178,34,52
2011,Shropshire 021A,E01028947,970,619,351,275,31,45
2011,Shropshire 021B,E01028948,1069,680,389,241,51,97
2011,Shropshire 021C,E01028949,1078,766,312,211,37,64
2011,Shropshire 021D,E01028985,1006,693,313,239,30,44
2011,Shropshire 022A,E01028938,1212,934,278,153,33,92
2011,Shropshire 022B,E01028939,1185,949,236,123,33,80
2011,Shropshire 022C,E01028984,1038,727,311,166,26,119
2011,Shropshire 022D,E01028986,1116,807,309,232,33,44
2011,Shropshire 023A,E01028940,1148,830,318,192,41,85
2011,Shropshire 023B,E01028952,1270,951,319,209,37,73
2011,Shropshire 023C,E01028962,1159,825,334,123,49,162
2011,Shropshire 023D,E01028963,1164,851,313,219,31,63
2011,Shropshire 023E,E01028964,1196,871,325,217,45,63
2011,Shropshire 023F,E01028974,1198,669,529,125,344,60
2011,Shropshire 024A,E01028935,1095,765,330,238,37,55
2011,Shropshire 024B,E01028936,1515,1050,465,344,28,93
2011,Shropshire 024C,E01028937,1129,839,290,192,32,66
2011,Shropshire 024D,E01028959,1904,1429,475,285,51,139
2011,Shropshire 026A,E01028954,952,629,323,206,46,71
2011,Shropshire 026B,E01028955,788,522,266,169,13,84
2011,Shropshire 026C,E01028975,1243,910,333,184,54,95
2011,Shropshire 026D,E01028976,1262,899,363,266,40,57
2011,Shropshire 026E,E01028977,1396,962,434,277,47,110
2011,Shropshire 028A,E01028950,1689,1215,474,295,56,123
2011,Shropshire 028B,E01028960,1003,736,267,182,35,50
2011,Shropshire 028C,E01028961,1267,760,507,131,310,66
2011,Shropshire 028D,E01028980,1605,1116,489,308,49,132
2011,Shropshire 030A,E01028991,924,653,271,162,38,71
2011,Shropshire 030B,E01028992,1146,804,342,193,34,115
2011,Shropshire 030D,E01033529,787,595,192,131,23,38
2011,Shropshire 030E,E01033530,1489,1082,407,224,48,135
2011,Shropshire 032A,E01028990,893,657,236,166,24,46
2011,Shropshire 032B,E01028997,1534,910,624,454,50,120
2011,Shropshire 032C,E01028998,1643,1074,569,401,53,115
2011,Shropshire 036A,E01028993,1155,816,339,210,36,93
2011,Shropshire 036B,E01029004,817,583,234,160,17,57
2011,Shropshire 036C,E01029013,1225,885,340,207,43,90
2011,Shropshire 036D,E01029014,818,583,235,91,22,122
2011,Shropshire 036E,E01029015,1068,747,321,205,26,90
2011,Shropshire 037A,E01028994,898,535,363,215,67,81
2011,Shropshire 037B,E01029003,1717,1240,477,342,45,90
2011,Shropshire 037C,E01029005,901,632,269,194,18,57
2011,Shropshire 037D,E01029016,1021,689,332,243,26,63
2011,Shropshire 038A,E01029006,1055,695,360,264,18,78
2011,Shropshire 038B,E01029007,791,520,271,111,30,130
2011,Shropshire 038D,E01029009,832,572,260,198,22,40
2011,Shropshire 038E,E01029010,1016,755,261,110,36,115
2011,Shropshire 038F,E01029011,1065,739,326,176,30,120
2011,Shropshire 038G,E01029012,1332,990,342,212,34,96
2011,Shropshire 038H,E01033526,747,500,247,147,24,76
2011,Shropshire 038I,E01033527,884,535,349,273,17,59
2011,Shropshire 039A,E01028995,1120,831,289,176,37,76
2011,Shropshire 039B,E01028996,954,640,314,238,20,56
2011,Shropshire 039C,E01028999,1160,793,367,242,32,93
2011,Shropshire 039D,E01029000,841,558,283,194,23,66
2011,Shropshire 039E,E01029001,1431,1019,412,268,56,88
2011,Shropshire 039F,E01029002,936,619,317,164,47,106
2011,Stoke-on-Trent 001A,E01014257,1097,714,383,174,44,165
2011,Stoke-on-Trent 001B,E01014258,1142,921,221,106,44,71
2011,Stoke-on-Trent 001C,E01014259,1114,724,390,229,42,119
2011,Stoke-on-Trent 001D,E01014260,952,547,405,202,32,171
2011,Stoke-on-Trent 001E,E01014264,1390,1028,362,197,47,118
2011,Stoke-on-Trent 002A,E01014357,1063,694,369,194,30,145
2011,Stoke-on-Trent 002B,E01014358,961,578,383,123,44,216
2011,Stoke-on-Trent 002C,E01014359,1307,858,449,190,59,200
2011,Stoke-on-Trent 002D,E01014360,1458,1095,363,159,65,139
2011,Stoke-on-Trent 003A,E01014261,956,528,428,112,55,261
2011,Stoke-on-Trent 003B,E01014262,943,558,385,145,54,186
2011,Stoke-on-Trent 003C,E01014263,1214,753,461,126,79,256
2011,Stoke-on-Trent 003D,E01014333,1136,812,324,216,32,76
2011,Stoke-on-Trent 003E,E01014334,1055,577,478,330,31,117
2011,Stoke-on-Trent 004A,E01014331,1052,628,424,139,53,232
2011,Stoke-on-Trent 004B,E01014332,1261,757,504,349,29,126
2011,Stoke-on-Trent 004C,E01014335,1235,909,326,182,37,107
2011,Stoke-on-Trent 004D,E01014336,1111,681,430,125,53,252
2011,Stoke-on-Trent 004E,E01014337,1228,767,461,189,65,207
2011,Stoke-on-Trent 005A,E01014354,1221,710,511,184,59,268
2011,Stoke-on-Trent 005B,E01014355,1388,877,511,164,67,280
2011,Stoke-on-Trent 005C,E01014356,1260,834,426,133,74,219
2011,Stoke-on-Trent 005D,E01014361,1135,732,403,74,68,261
2011,Stoke-on-Trent 006A,E01014241,1125,765,360,132,53,175
2011,Stoke-on-Trent 006B,E01014242,1018,599,419,164,50,205
2011,Stoke-on-Trent 006C,E01014243,1090,765,325,197,41,87
2011,Stoke-on-Trent 006D,E01014244,1030,595,435,122,50,263
2011,Stoke-on-Trent 006E,E01014245,1240,886,354,155,51,148
2011,Stoke-on-Trent 006F,E01014248,1124,799,325,95,53,177
2011,Stoke-on-Trent 007A,E01014214,1107,739,368,267,44,57
2011,Stoke-on-Trent 007B,E01014215,1087,741,346,201,42,103
2011,Stoke-on-Trent 007C,E01014216,1020,696,324,230,29,65
2011,Stoke-on-Trent 007D,E01014265,1170,850,320,233,36,51
2011,Stoke-on-Trent 007E,E01014267,1764,1309,455,242,60,153
2011,Stoke-on-Trent 007F,E01014272,1068,800,268,172,32,64
2011,Stoke-on-Trent 008A,E01014246,1189,757,432,173,52,207
2011,Stoke-on-Trent 008B,E01014266,881,589,292,154,29,109
2011,Stoke-on-Trent 008C,E01014268,1481,1020,461,245,45,171
2011,Stoke-on-Trent 008D,E01014270,1123,777,346,213,36,97
2011,Stoke-on-Trent 008E,E01014271,1114,788,326,163,55,108
2011,Stoke-on-Trent 009A,E01014247,1313,815,498,160,68,270
2011,Stoke-on-Trent 009B,E01014250,805,459,346,127,38,181
2011,Stoke-on-Trent 009C,E01014251,1390,899,491,139,65,287
2011,Stoke-on-Trent 009D,E01014252,1267,931,336,116,48,172
2011,Stoke-on-Trent 009E,E01014255,1289,780,509,134,103,272
2011,Stoke-on-Trent 010A,E01014269,1097,666,431,150,59,222
2011,Stoke-on-Trent 010B,E01014324,1080,695,385,260,44,81
2011,Stoke-on-Trent 010C,E01014325,1070,872,198,101,52,45
2011,Stoke-on-Trent 010D,E01014326,1177,884,293,166,44,83
2011,Stoke-on-Trent 011A,E01014249,1225,710,515,120,88,307
2011,Stoke-on-Trent 011B,E01014253,1160,831,329,155,62,112
2011,Stoke-on-Trent 011C,E01014254,1115,674,441,98,77,266
2011,Stoke-on-Trent 011D,E01014256,1195,692,503,197,65,241
2011,Stoke-on-Trent 012A,E01014210,1055,612,443,180,59,204
2011,Stoke-on-Trent 012B,E01014211,1062,576,486,173,65,248
2011,Stoke-on-Trent 012C,E01014212,959,553,406,168,39,199
2011,Stoke-on-Trent 012D,E01014213,925,617,308,119,33,156
2011,Stoke-on-Trent 012E,E01014217,972,529,443,139,53,251
2011,Stoke-on-Trent 013A,E01014323,974,718,256,119,29,108
2011,Stoke-on-Trent 013B,E01014327,1070,781,289,128,40,121
2011,Stoke-on-Trent 013C,E01014328,1100,746,354,121,67,166
2011,Stoke-on-Trent 013D,E01014329,1103,750,353,168,38,147
2011,Stoke-on-Trent 013E,E01014330,1241,699,542,142,81,319
2011,Stoke-on-Trent 014A,E01014218,1051,628,423,145,52,226
2011,Stoke-on-Trent 014B,E01014219,963,670,293,179,29,85
2011,Stoke-on-Trent 014C,E01014225,1131,753,378,253,36,89
2011,Stoke-on-Trent 014D,E01014226,992,616,376,214,40,122
2011,Stoke-on-Trent 014E,E01014228,1047,642,405,293,29,83
2011,Stoke-on-Trent 014F,E01014230,1102,750,352,185,38,129
2011,Stoke-on-Trent 015A,E01014281,1396,772,624,67,319,238
2011,Stoke-on-Trent 015B,E01014285,1620,1106,514,126,116,272
2011,Stoke-on-Trent 015C,E01014286,1037,574,463,71,123,269
2011,Stoke-on-Trent 015D,E01014287,1258,690,568,101,116,351
2011,Stoke-on-Trent 016B,E01014231,1186,823,363,108,59,196
2011,Stoke-on-Trent 016D,E01014282,1494,702,792,66,564,162
2011,Stoke-on-Trent 016E,E01014283,1789,1089,700,69,497,134
2011,Stoke-on-Trent 016F,E01014284,1338,645,693,24,585,84
2011,Stoke-on-Trent 016G,E01033216,1865,1297,568,250,97,221
2011,Stoke-on-Trent 017A,E01014220,1115,642,473,121,43,309
2011,Stoke-on-Trent 017B,E01014221,1104,670,434,100,52,282
2011,Stoke-on-Trent 017C,E01014222,1039,627,412,96,54,262
2011,Stoke-on-Trent 017D,E01014223,1156,676,480,160,39,281
2011,Stoke-on-Trent 017E,E01014224,1004,567,437,113,50,274
2011,Stoke-on-Trent 017F,E01014229,1171,735,436,145,50,241
2011,Stoke-on-Trent 018A,E01014288,1261,922,339,121,113,105
2011,Stoke-on-Trent 018B,E01014289,1217,856,361,188,75,98
2011,Stoke-on-Trent 018C,E01014290,1134,832,302,117,94,91
2011,Stoke-on-Trent 018D,E01014291,1051,724,327,116,79,132
2011,Stoke-on-Trent 018E,E01014292,1265,920,345,137,103,105
2011,Stoke-on-Trent 018F,E01014294,953,634,319,122,77,120
2011,Stoke-on-Trent 019A,E01014293,1343,923,420,86,176,158
2011,Stoke-on-Trent 019B,E01014295,1226,827,399,232,61,106
2011,Stoke-on-Trent 019C,E01014339,1306,891,415,129,84,202
2011,Stoke-on-Trent 019D,E01014340,1437,1034,403,156,94,153
2011,Stoke-on-Trent 019E,E01014345,1337,899,438,118,103,217
2011,Stoke-on-Trent 020A,E01014274,1310,912,398,164,33,201
2011,Stoke-on-Trent 020B,E01014275,1019,576,443,164,47,232
2011,Stoke-on-Trent 020C,E01014276,1206,868,338,154,69,115
2011,Stoke-on-Trent 020D,E01014277,1207,825,382,195,49,138
2011,Stoke-on-Trent 020E,E01014279,1318,942,376,137,59,180
2011,Stoke-on-Trent 021A,E01014273,930,640,290,59,44,187
2011,Stoke-on-Trent 021B,E01014278,1036,692,344,159,37,148
2011,Stoke-on-Trent 021C,E01014280,1055,742,313,205,24,84
2011,Stoke-on-Trent 021D,E01014297,1041,783,258,115,39,104
2011,Stoke-on-Trent 022A,E01014296,1108,731,377,184,44,149
2011,Stoke-on-Trent 022B,E01014298,1135,744,391,129,52,210
2011,Stoke-on-Trent 022C,E01014300,1028,641,387,163,46,178
2011,Stoke-on-Trent 022D,E01014302,1340,846,494,255,39,200
2011,Stoke-on-Trent 023A,E01014338,1154,802,352,184,46,122
2011,Stoke-on-Trent 023B,E01014341,1348,908,440,135,133,172
2011,Stoke-on-Trent 023C,E01014342,1011,605,406,144,76,186
2011,Stoke-on-Trent 023D,E01014343,1360,1002,358,155,47,156
2011,Stoke-on-Trent 023E,E01014344,1099,742,357,154,45,158
2011,Stoke-on-Trent 024A,E01014363,985,598,387,250,26,111
2011,Stoke-on-Trent 024B,E01014364,1045,702,343,169,32,142
2011,Stoke-on-Trent 024C,E01014365,1104,677,427,271,44,112
2011,Stoke-on-Trent 024D,E01014369,942,626,316,155,31,130
2011,Stoke-on-Trent 025A,E01014299,1132,872,260,141,22,97
2011,Stoke-on-Trent 025B,E01014301,1300,1025,275,96,67,112
2011,Stoke-on-Trent 025C,E01014303,1232,982,250,119,44,87
2011,Stoke-on-Trent 025D,E01014304,1091,737,354,224,37,93
2011,Stoke-on-Trent 025E,E01014362,1072,773,299,186,24,89
2011,Stoke-on-Trent 026A,E01014233,1047,638,409,278,42,89
2011,Stoke-on-Trent 026B,E01014234,1087,671,416,97,71,248
2011,Stoke-on-Trent 026C,E01014239,1089,749,340,180,38,122
2011,Stoke-on-Trent 026D,E01014240,1092,708,384,155,53,176
2011,Stoke-on-Trent 027A,E01014308,1276,809,467,327,34,106
2011,Stoke-on-Trent 027B,E01014309,894,508,386,177,49,160
2011,Stoke-on-Trent 027C,E01014311,1016,610,406,202,40,164
2011,Stoke-on-Trent 027D,E01014313,1100,558,542,301,39,202
2011,Stoke-on-Trent 028A,E01014321,1125,771,354,185,38,131
2011,Stoke-on-Trent 028B,E01014366,1258,718,540,159,60,321
2011,Stoke-on-Trent 028C,E01014367,1005,561,444,140,50,254
2011,Stoke-on-Trent 028D,E01014368,1129,694,435,165,52,218
2011,Stoke-on-Trent 029A,E01014305,961,533,428,92,64,272
2011,Stoke-on-Trent 029B,E01014306,1001,601,400,89,60,251
2011,Stoke-on-Trent 029C,E01014307,918,511,407,76,70,261
2011,Stoke-on-Trent 029D,E01014312,1024,656,368,185,34,149
2011,Stoke-on-Trent 030A,E01014346,1185,760,425,316,29,80
2011,Stoke-on-Trent 030B,E01014348,985,606,379,292,20,67
2011,Stoke-on-Trent 030C,E01014349,1016,673,343,247,37,59
2011,Stoke-on-Trent 030D,E01014353,1195,836,359,144,50,165
2011,Stoke-on-Trent 031A,E01014310,1445,1063,382,174,62,146
2011,Stoke-on-Trent 031B,E01014314,1075,790,285,145,49,91
2011,Stoke-on-Trent 031C,E01014316,1037,581,456,133,49,274
2011,Stoke-on-Trent 031D,E01014317,1063,599,464,169,47,248
2011,Stoke-on-Trent 031E,E01014322,1203,770,433,161,63,209
2011,Stoke-on-Trent 032A,E01014235,1133,669,464,182,52,230
2011,Stoke-on-Trent 032B,E01014236,1619,1072,547,152,73,322
2011,Stoke-on-Trent 032C,E01014237,1151,709,442,126,51,265
2011,Stoke-on-Trent 032D,E01014238,1044,621,423,98,59,266
2011,Stoke-on-Trent 033A,E01014315,1048,674,374,282,28,64
2011,Stoke-on-Trent 033B,E01014318,1113,822,291,177,43,71
2011,Stoke-on-Trent 033C,E01014319,1080,782,298,159,42,97
2011,Stoke-on-Trent 033D,E01014320,1011,807,204,114,32,58
2011,Stoke-on-Trent 034A,E01014347,1144,883,261,167,40,54
2011,Stoke-on-Trent 034B,E01014350,1060,741,319,223,41,55
2011,Stoke-on-Trent 034C,E01014351,1142,818,324,177,27,120
2011,Stoke-on-Trent 034D,E01014352,1087,796,291,208,31,52
2011,Telford and Wrekin 001A,E01014171,1054,634,420,182,138,100
2011,Telford and Wrekin 001B,E01014172,1085,747,338,160,111,67
2011,Telford and Wrekin 001C,E01014173,1149,741,408,199,121,88
2011,Telford and Wrekin 001D,E01014174,1157,870,287,159,67,61
2011,Telford and Wrekin 002A,E01014112,1206,806,400,240,69,91
2011,Telford and Wrekin 002B,E01014131,1860,957,903,191,621,91
2011,Telford and Wrekin 002C,E01014132,794,500,294,175,73,46
2011,Telford and Wrekin 002D,E01014135,935,700,235,139,33,63
2011,Telford and Wrekin 003A,E01014175,852,577,275,143,50,82
2011,Telford and Wrekin 003B,E01014176,1111,722,389,242,91,56
2011,Telford and Wrekin 003C,E01014177,1045,697,348,201,101,46
2011,Telford and Wrekin 003D,E01014178,1171,728,443,147,218,78
2011,Telford and Wrekin 004A,E01014111,1121,808,313,208,40,65
2011,Telford and Wrekin 004B,E01014167,1395,1112,283,126,66,91
2011,Telford and Wrekin 004C,E01014168,1031,778,253,139,45,69
2011,Telford and Wrekin 004D,E01014170,1087,699,388,279,39,70
2011,Telford and Wrekin 005A,E01014125,1144,768,376,153,43,180
2011,Telford and Wrekin 005B,E01014126,1046,644,402,224,39,139
2011,Telford and Wrekin 005C,E01014127,1225,763,462,128,60,274
2011,Telford and Wrekin 005D,E01014128,1500,1088,412,163,59,190
2011,Telford and Wrekin 005E,E01014169,1259,981,278,66,63,149
2011,Telford and Wrekin 006A,E01014129,778,486,292,169,16,107
2011,Telford and Wrekin 006B,E01014130,1058,798,260,150,40,70
2011,Telford and Wrekin 006C,E01014179,878,609,269,190,22,57
2011,Telford and Wrekin 006D,E01014180,937,634,303,186,31,86
2011,Telford and Wrekin 006E,E01014189,1138,871,267,123,54,90
2011,Telford and Wrekin 006F,E01014190,1304,1040,264,144,51,69
2011,Telford and Wrekin 007A,E01014102,1366,1027,339,171,58,110
2011,Telford and Wrekin 007B,E01014103,949,719,230,120,38,72
2011,Telford and Wrekin 007C,E01014138,1077,750,327,143,44,140
2011,Telford and Wrekin 007D,E01014140,1086,739,347,124,56,167
2011,Telford and Wrekin 008A,E01014205,1048,723,325,227,38,60
2011,Telford and Wrekin 008B,E01014206,962,657,305,138,39,128
2011,Telford and Wrekin 008C,E01014207,973,689,284,150,34,100
2011,Telford and Wrekin 008D,E01014208,874,578,296,154,22,120
2011,Telford and Wrekin 008E,E01014209,1091,741,350,187,43,120
2011,Telford and Wrekin 009A,E01014137,1113,865,248,105,56,87
2011,Telford and Wrekin 009B,E01014139,947,631,316,116,42,158
2011,Telford and Wrekin 009C,E01014141,2009,1534,475,125,68,282
2011,Telford and Wrekin 009D,E01014142,894,569,325,64,59,202
2011,Telford and Wrekin 009E,E01014143,1062,666,396,150,56,190
2011,Telford and Wrekin 010A,E01014136,1165,813,352,238,23,91
2011,Telford and Wrekin 010B,E01014148,1207,895,312,190,45,77
2011,Telford and Wrekin 010C,E01014149,860,597,263,129,29,105
2011,Telford and Wrekin 010D,E01014202,1774,1311,463,245,73,145
2011,Telford and Wrekin 010E,E01014203,1122,785,337,232,39,66
2011,Telford and Wrekin 010F,E01014204,1478,1113,365,214,52,99
2011,Telford and Wrekin 011A,E01014104,1216,853,363,140,48,175
2011,Telford and Wrekin 011B,E01014105,1338,891,447,123,65,259
2011,Telford and Wrekin 011C,E01014113,1184,727,457,113,72,272
2011,Telford and Wrekin 011D,E01014114,1079,717,362,203,81,78
2011,Telford and Wrekin 012A,E01014133,1318,887,431,215,50,166
2011,Telford and Wrekin 012B,E01014134,944,618,326,245,28,53
2011,Telford and Wrekin 012C,E01014144,1039,644,395,187,35,173
2011,Telford and Wrekin 012D,E01014145,1320,985,335,132,42,161
2011,Telford and Wrekin 013A,E01014185,1228,797,431,223,52,156
2011,Telford and Wrekin 013B,E01014186,1059,791,268,132,43,93
2011,Telford and Wrekin 013C,E01014187,1125,801,324,180,32,112
2011,Telford and Wrekin 013D,E01014188,1171,902,269,123,65,81
2011,Telford and Wrekin 014A,E01014150,1291,968,323,177,58,88
2011,Telford and Wrekin 014B,E01014151,1053,703,350,132,35,183
2011,Telford and Wrekin 014C,E01014152,969,546,423,231,41,151
2011,Telford and Wrekin 014D,E01014153,1316,930,386,185,42,159
2011,Telford and Wrekin 014E,E01014154,1291,986,305,150,35,120
2011,Telford and Wrekin 014F,E01014155,1190,817,373,162,40,171
2011,Telford and Wrekin 015A,E01014181,1457,1211,246,91,63,92
2011,Telford and Wrekin 015B,E01014182,968,714,254,142,62,50
2011,Telford and Wrekin 015C,E01014183,1187,854,333,215,36,82
2011,Telford and Wrekin 015D,E01014184,1040,753,287,143,42,102
2011,Telford and Wrekin 016A,E01014146,1537,1162,375,181,56,138
2011,Telford and Wrekin 016B,E01014147,1544,1243,301,133,68,100
2011,Telford and Wrekin 016C,E01014156,1539,1164,375,86,72,217
2011,Telford and Wrekin 016D,E01014157,1171,934,237,88,60,89
2011,Telford and Wrekin 016E,E01014158,1168,916,252,103,30,119
2011,Telford and Wrekin 017A,E01014124,1219,793,426,164,49,213
2011,Telford and Wrekin 017B,E01014163,1004,617,387,136,61,190
2011,Telford and Wrekin 017C,E01014164,1153,682,471,142,60,269
2011,Telford and Wrekin 017D,E01014165,1053,664,389,113,62,214
2011,Telford and Wrekin 017E,E01014166,1165,817,348,164,34,150
2011,Telford and Wrekin 018A,E01014191,1343,1007,336,107,41,188
2011,Telford and Wrekin 018B,E01014192,1053,758,295,109,43,143
2011,Telford and Wrekin 018C,E01014193,1230,827,403,130,63,210
2011,Telford and Wrekin 018D,E01014194,1113,790,323,115,54,154
2011,Telford and Wrekin 018E,E01014195,1097,859,238,133,37,68
2011,Telford and Wrekin 018F,E01014196,1116,746,370,150,44,176
2011,Telford and Wrekin 019A,E01014119,1237,905,332,169,47,116
2011,Telford and Wrekin 019B,E01014120,1254,797,457,192,39,226
2011,Telford and Wrekin 019C,E01014121,1086,749,337,209,42,86
2011,Telford and Wrekin 019D,E01014122,1240,976,264,74,52,138
2011,Telford and Wrekin 019E,E01014123,1199,970,229,111,40,78
2011,Telford and Wrekin 020A,E01014106,1155,789,366,160,50,156
2011,Telford and Wrekin 020B,E01014107,933,661,272,180,33,59
2011,Telford and Wrekin 020C,E01014108,1056,688,368,70,56,242
2011,Telford and Wrekin 020D,E01014109,881,658,223,87,31,105
2011,Telford and Wrekin 020E,E01014110,999,611,388,66,60,262
2011,Telford and Wrekin 021A,E01014197,1034,622,412,134,66,212
2011,Telford and Wrekin 021B,E01014198,734,397,337,97,37,203
2011,Telford and Wrekin 021C,E01014199,1149,814,335,90,56,189
2011,Telford and Wrekin 021D,E01014200,848,498,350,90,56,204
2011,Telford and Wrekin 021E,E01014201,864,532,332,95,62,175
2011,Telford and Wrekin 022A,E01014159,917,598,319,166,26,127
2011,Telford and Wrekin 022B,E01014160,1040,703,337,203,43,91
2011,Telford and Wrekin 022C,E01014161,892,615,277,131,32,114
2011,Telford and Wrekin 022D,E01014162,1193,747,446,215,49,182
2011,Telford and Wrekin 023A,E01014115,976,642,334,134,32,168
2011,Telford and Wrekin 023B,E01014116,1159,625,534,252,52,230
2011,Telford and Wrekin 023C,E01014117,939,587,352,240,36,76
2011,Telford and Wrekin 023D,E01014118,829,529,300,87,40,173
2011,Cannock Chase 001A,E01029368,987,650,337,248,24,65
2011,Cannock Chase 001B,E01029369,937,665,272,168,29,75
2011,Cannock Chase 001C,E01029370,1097,750,347,269,31,47
2011,Cannock Chase 001D,E01029371,1181,889,292,152,58,82
2011,Cannock Chase 001E,E01029402,1463,983,480,353,48,79
2011,Cannock Chase 002A,E01029372,984,630,354,86,42,226
2011,Cannock Chase 002B,E01029373,1635,1152,483,184,61,238
2011,Cannock Chase 002C,E01029401,1229,888,341,181,46,114
2011,Cannock Chase 002D,E01029403,1107,791,316,143,46,127
2011,Cannock Chase 002E,E01029404,1053,712,341,169,28,144
2011,Cannock Chase 003A,E01029345,1195,876,319,157,36,126
2011,Cannock Chase 003B,E01029346,1152,752,400,153,50,197
2011,Cannock Chase 003C,E01029347,1128,744,384,286,21,77
2011,Cannock Chase 003D,E01029348,1259,861,398,204,52,142
2011,Cannock Chase 003E,E01029374,1726,1284,442,203,53,186
2011,Cannock Chase 004A,E01029383,1202,940,262,123,52,87
2011,Cannock Chase 004B,E01029385,1188,860,328,211,35,82
2011,Cannock Chase 004C,E01029388,988,658,330,146,29,155
2011,Cannock Chase 004D,E01029390,818,551,267,93,31,143
2011,Cannock Chase 005A,E01029384,1446,1048,398,212,51,135
2011,Cannock Chase 005B,E01029386,1063,736,327,157,45,125
2011,Cannock Chase 005C,E01029387,1115,751,364,157,40,167
2011,Cannock Chase 005D,E01029389,1279,978,301,171,38,92
2011,Cannock Chase 006A,E01029379,1300,1035,265,102,59,104
2011,Cannock Chase 006B,E01029398,1256,875,381,223,46,112
2011,Cannock Chase 006C,E01029399,1202,897,305,163,31,111
2011,Cannock Chase 006D,E01029400,1271,933,338,140,56,142
2011,Cannock Chase 007A,E01029354,1121,767,354,167,41,146
2011,Cannock Chase 007B,E01029355,1118,701,417,170,49,198
2011,Cannock Chase 007C,E01029356,1037,659,378,164,47,167
2011,Cannock Chase 007D,E01029357,1020,703,317,131,35,151
2011,Cannock Chase 007E,E01029358,874,544,330,101,40,189
2011,Cannock Chase 008A,E01029349,948,634,314,180,30,104
2011,Cannock Chase 008B,E01029350,1134,688,446,198,51,197
2011,Cannock Chase 008C,E01029351,1100,721,379,121,51,207
2011,Cannock Chase 008D,E01029352,1066,793,273,135,28,110
2011,Cannock Chase 008E,E01029393,1301,911,390,246,48,96
2011,Cannock Chase 009A,E01029380,1169,970,199,103,33,63
2011,Cannock Chase 009B,E01029381,1142,733,409,233,34,142
2011,Cannock Chase 009C,E01029382,1230,866,364,213,31,120
2011,Cannock Chase 009D,E01029391,1277,913,364,232,56,76
2011,Cannock Chase 009E,E01029392,1435,1127,308,164,55,89
2011,Cannock Chase 010A,E01029375,1855,1582,273,117,45,111
2011,Cannock Chase 010B,E01029376,1432,1211,221,85,48,88
2011,Cannock Chase 010C,E01029377,1091,944,147,51,51,45
2011,Cannock Chase 010D,E01029378,1307,1086,221,101,45,75
2011,Cannock Chase 011A,E01029353,1047,650,397,273,19,105
2011,Cannock Chase 011B,E01029364,1186,849,337,241,37,59
2011,Cannock Chase 011C,E01029365,1156,863,293,160,49,84
2011,Cannock Chase 011D,E01029366,1279,773,506,364,55,87
2011,Cannock Chase 011E,E01029367,1579,1104,475,245,64,166
2011,Cannock Chase 012A,E01029359,1191,859,332,115,34,183
2011,Cannock Chase 012B,E01029360,1077,716,361,150,78,133
2011,Cannock Chase 012C,E01029361,1129,707,422,197,50,175
2011,Cannock Chase 012D,E01029362,1141,765,376,115,54,207
2011,Cannock Chase 012E,E01029363,1030,653,377,219,37,121
2011,Cannock Chase 013A,E01029394,1123,709,414,269,25,120
2011,Cannock Chase 013B,E01029395,1251,886,365,249,42,74
2011,Cannock Chase 013C,E01029396,1326,990,336,196,43,97
2011,Cannock Chase 013D,E01029397,1841,1340,501,176,61,264
2011,East Staffordshire 001A,E01029405,1200,885,315,209,37,69
2011,East Staffordshire 001B,E01029406,931,715,216,133,32,51
2011,East Staffordshire 001C,E01029422,975,607,368,184,106,78
2011,East Staffordshire 001D,E01029423,1160,835,325,161,39,125
2011,East Staffordshire 001E,E01029467,1560,1120,440,291,39,110
2011,East Staffordshire 002A,E01029430,1119,843,276,160,40,76
2011,East Staffordshire 002B,E01029431,1149,836,313,144,34,135
2011,East Staffordshire 002C,E01029432,1098,762,336,234,22,80
2011,East Staffordshire 002D,E01029433,1131,839,292,123,32,137
2011,East Staffordshire 003A,E01029459,1163,960,203,103,33,67
2011,East Staffordshire 003B,E01029460,1226,928,298,175,49,74
2011,East Staffordshire 003C,E01029461,1390,1067,323,168,39,116
2011,East Staffordshire 003D,E01029462,1183,814,369,178,35,156
2011,East Staffordshire 004A,E01029443,1223,824,399,302,42,55
2011,East Staffordshire 004B,E01029444,1152,744,408,286,50,72
2011,East Staffordshire 004C,E01029463,892,630,262,166,31,65
2011,East Staffordshire 004D,E01029464,1160,784,376,210,37,129
2011,East Staffordshire 004E,E01029465,1159,826,333,241,23,69
2011,East Staffordshire 004F,E01029466,1091,781,310,186,51,73
2011,East Staffordshire 005A,E01029454,1233,869,364,243,56,65
2011,East Staffordshire 005B,E01029455,1328,960,368,244,46,78
2011,East Staffordshire 005C,E01029456,1064,751,313,212,22,79
2011,East Staffordshire 005D,E01029457,1029,827,202,106,38,58
2011,East Staffordshire 005E,E01029458,1102,762,340,232,38,70
2011,East Staffordshire 006A,E01029411,981,701,280,198,26,56
2011,East Staffordshire 006B,E01029412,1004,684,320,218,64,38
2011,East Staffordshire 006C,E01029424,761,511,250,179,26,45
2011,East Staffordshire 006D,E01029425,1981,1000,981,230,48,703
2011,East Staffordshire 006E,E01029473,1018,733,285,162,35,88
2011,East Staffordshire 006F,E01029474,850,564,286,199,33,54
2011,East Staffordshire 007A,E01029434,1104,805,299,100,56,143
2011,East Staffordshire 007B,E01029435,1053,760,293,208,34,51
2011,East Staffordshire 007C,E01029436,1335,897,438,177,65,196
2011,East Staffordshire 007D,E01029437,1599,1124,475,174,62,239
2011,East Staffordshire 007E,E01029438,1102,736,366,222,45,99
2011,East Staffordshire 008A,E01029426,1256,831,425,100,68,257
2011,East Staffordshire 008B,E01029427,1073,669,404,133,34,237
2011,East Staffordshire 008C,E01029428,1148,889,259,90,48,121
2011,East Staffordshire 008D,E01029429,946,653,293,99,37,157
2011,East Staffordshire 009A,E01029445,1452,1009,443,113,76,254
2011,East Staffordshire 009B,E01029446,1266,909,357,204,40,113
2011,East Staffordshire 009C,E01029447,1202,828,374,66,75,233
2011,East Staffordshire 009D,E01029448,1152,770,382,152,43,187
2011,East Staffordshire 010A,E01029468,1134,740,394,120,51,223
2011,East Staffordshire 010B,E01029469,1315,907,408,271,31,106
2011,East Staffordshire 010C,E01029470,1108,766,342,166,43,133
2011,East Staffordshire 010D,E01029471,1294,921,373,200,53,120
2011,East Staffordshire 010E,E01029472,1190,785,405,209,48,148
2011,East Staffordshire 011A,E01029407,1008,701,307,90,52,165
2011,East Staffordshire 011B,E01029408,1572,1154,418,89,69,260
2011,East Staffordshire 011C,E01029409,1214,848,366,110,51,205
2011,East Staffordshire 011D,E01029410,1114,772,342,116,50,176
2011,East Staffordshire 011F,E01032896,930,726,204,59,29,116
2011,East Staffordshire 011G,E01032897,895,687,208,101,22,85
2011,East Staffordshire 011H,E01032898,930,657,273,91,39,143
2011,East Staffordshire 012A,E01029418,1647,1242,405,250,52,103
2011,East Staffordshire 012B,E01029419,1182,873,309,212,35,62
2011,East Staffordshire 012C,E01029420,1229,874,355,234,45,76
2011,East Staffordshire 013A,E01029413,1151,861,290,174,31,85
2011,East Staffordshire 013B,E01029414,1270,1000,270,127,45,98
2011,East Staffordshire 013C,E01029415,1198,997,201,80,45,76
2011,East Staffordshire 013D,E01029416,935,661,274,193,25,56
2011,East Staffordshire 013E,E01029417,853,585,268,180,24,64
2011,East Staffordshire 014A,E01029449,1284,910,374,220,40,114
2011,East Staffordshire 014B,E01029450,1105,711,394,153,55,186
2011,East Staffordshire 014C,E01029451,1237,875,362,193,38,131
2011,East Staffordshire 014D,E01029452,1159,792,367,174,34,159
2011,East Staffordshire 014E,E01029453,1065,655,410,147,35,228
2011,East Staffordshire 015A,E01029439,1068,712,356,255,39,62
2011,East Staffordshire 015B,E01029440,938,708,230,158,22,50
2011,East Staffordshire 015C,E01029441,1103,768,335,226,40,69
2011,East Staffordshire 015D,E01029442,930,648,282,184,48,50
2011,Lichfield 001A,E01029480,1397,1038,359,197,60,102
2011,Lichfield 001B,E01029481,1364,917,447,305,32,110
2011,Lichfield 001C,E01029482,1209,836,373,213,46,114
2011,Lichfield 001D,E01029498,1366,934,432,281,59,92
2011,Lichfield 002A,E01029477,1148,793,355,252,44,59
2011,Lichfield 002B,E01029478,1102,772,330,223,42,65
2011,Lichfield 002C,E01029479,2066,1578,488,244,95,149
2011,Lichfield 002D,E01029509,1211,864,347,236,46,65
2011,Lichfield 003A,E01029486,1119,764,355,248,39,68
2011,Lichfield 003B,E01029507,1323,962,361,255,45,61
2011,Lichfield 003C,E01029508,1731,1241,490,341,48,101
2011,Lichfield 003D,E01029515,1412,932,480,346,43,91
2011,Lichfield 004A,E01029492,1386,931,455,155,70,230
2011,Lichfield 004B,E01029499,1262,796,466,192,60,214
2011,Lichfield 004C,E01029501,1106,706,400,195,60,145
2011,Lichfield 004E,E01029526,1159,799,360,201,36,123
2011,Lichfield 004F,E01032899,991,636,355,257,22,76
2011,Lichfield 004G,E01032900,1455,1231,224,59,47,118
2011,Lichfield 005A,E01029483,1206,810,396,286,51,59
2011,Lichfield 005B,E01029484,1337,980,357,222,38,97
2011,Lichfield 005C,E01029485,1169,867,302,206,35,61
2011,Lichfield 005D,E01029500,1377,958,419,260,58,101
2011,Lichfield 005E,E01029520,1190,810,380,259,55,66
2011,Lichfield 005F,E01029524,1308,900,408,233,52,123
2011,Lichfield 005G,E01029525,1300,839,461,328,43,90
2011,Lichfield 006A,E01029487,1221,746,475,266,38,171
2011,Lichfield 006B,E01029493,1507,1159,348,226,42,80
2011,Lichfield 006C,E01029494,1128,809,319,180,45,94
2011,Lichfield 006D,E01029495,1266,928,338,187,46,105
2011,Lichfield 006E,E01029497,1449,1023,426,242,48,136
2011,Lichfield 007A,E01029491,1310,914,396,239,44,113
2011,Lichfield 007B,E01029511,1177,798,379,260,45,74
2011,Lichfield 007C,E01029512,1367,976,391,242,48,101
2011,Lichfield 007D,E01029518,1966,1510,456,281,66,109
2011,Lichfield 007E,E01029519,1587,1143,444,240,80,124
2011,Lichfield 008A,E01029516,1422,981,441,283,72,86
2011,Lichfield 008B,E01029517,1258,863,395,256,59,80
2011,Lichfield 008C,E01029530,1243,910,333,175,44,114
2011,Lichfield 008D,E01029531,1258,830,428,325,47,56
2011,Lichfield 009A,E01029475,1537,1030,507,358,48,101
2011,Lichfield 009B,E01029476,1067,684,383,266,32,85
2011,Lichfield 009C,E01029489,1237,809,428,316,32,80
2011,Lichfield 009D,E01029490,1129,839,290,185,29,76
2011,Lichfield 009E,E01029505,1177,801,376,260,37,79
2011,Lichfield 009F,E01029506,1493,926,567,458,33,76
2011,Lichfield 010A,E01029496,1322,904,418,162,54,202
2011,Lichfield 010B,E01029527,909,599,310,158,29,123
2011,Lichfield 010C,E01029528,948,633,315,174,34,107
2011,Lichfield 010D,E01029529,945,720,225,112,26,87
2011,Lichfield 011A,E01029513,996,666,330,207,53,70
2011,Lichfield 011B,E01029514,1097,718,379,216,74,89
2011,Lichfield 011C,E01029521,1269,863,406,294,55,57
2011,Lichfield 011D,E01029522,1159,761,398,239,51,108
2011,Lichfield 011E,E01029523,1162,790,372,260,46,66
2011,Lichfield 012A,E01029488,1924,1174,750,206,81,463
2011,Lichfield 012B,E01029502,1226,866,360,177,51,132
2011,Lichfield 012C,E01029503,1128,759,369,246,36,87
2011,Lichfield 012D,E01029504,1179,836,343,193,42,108
2011,Newcastle-under-Lyme 001A,E01029562,1012,758,254,134,43,77
2011,Newcastle-under-Lyme 001B,E01029565,1001,771,230,114,49,67
2011,Newcastle-under-Lyme 001C,E01029581,1197,870,327,207,41,79
2011,Newcastle-under-Lyme 001D,E01029582,1397,954,443,292,39,112
2011,Newcastle-under-Lyme 001E,E01029586,980,661,319,262,21,36
2011,Newcastle-under-Lyme 001F,E01029587,931,649,282,195,29,58
2011,Newcastle-under-Lyme 002A,E01029561,1032,669,363,183,41,139
2011,Newcastle-under-Lyme 002B,E01029563,1061,716,345,219,30,96
2011,Newcastle-under-Lyme 002C,E01029564,965,665,300,106,41,153
2011,Newcastle-under-Lyme 002D,E01029588,1191,847,344,160,37,147
2011,Newcastle-under-Lyme 003A,E01029540,1051,659,392,251,34,107
2011,Newcastle-under-Lyme 003B,E01029541,1110,767,343,130,63,150
2011,Newcastle-under-Lyme 003C,E01029542,1036,708,328,185,38,105
2011,Newcastle-under-Lyme 003D,E01029543,932,557,375,130,54,191
2011,Newcastle-under-Lyme 003E,E01029595,1008,644,364,257,22,85
2011,Newcastle-under-Lyme 003F,E01029597,1073,718,355,144,49,162
2011,Newcastle-under-Lyme 004A,E01029536,1126,778,348,246,34,68
2011,Newcastle-under-Lyme 004B,E01029544,1039,817,222,120,57,45
2011,Newcastle-under-Lyme 004C,E01029545,1180,843,337,156,67,114
2011,Newcastle-under-Lyme 004D,E01029546,1095,910,185,68,53,64
2011,Newcastle-under-Lyme 004E,E01029596,869,484,385,275,34,76
2011,Newcastle-under-Lyme 005A,E01029532,1101,791,310,169,46,95
2011,Newcastle-under-Lyme 005B,E01029533,1164,794,370,226,40,104
2011,Newcastle-under-Lyme 005C,E01029534,1157,826,331,219,38,74
2011,Newcastle-under-Lyme 005D,E01029535,1018,689,329,129,46,154
2011,Newcastle-under-Lyme 005E,E01029556,1850,1277,573,351,56,166
2011,Newcastle-under-Lyme 006A,E01029537,1123,787,336,171,46,119
2011,Newcastle-under-Lyme 006B,E01029538,1173,739,434,202,48,184
2011,Newcastle-under-Lyme 006C,E01029539,1132,786,346,200,39,107
2011,Newcastle-under-Lyme 006D,E01029552,1080,766,314,176,41,97
2011,Newcastle-under-Lyme 006E,E01029558,1113,760,353,123,43,187
2011,Newcastle-under-Lyme 007A,E01029547,1014,650,364,111,37,216
2011,Newcastle-under-Lyme 007B,E01029548,1033,658,375,131,31,213
2011,Newcastle-under-Lyme 007C,E01029559,1112,829,283,123,40,120
2011,Newcastle-under-Lyme 007D,E01029560,1086,735,351,117,39,195
2011,Newcastle-under-Lyme 007E,E01029568,1067,672,395,177,58,160
2011,Newcastle-under-Lyme 008A,E01029583,1061,770,291,169,42,80
2011,Newcastle-under-Lyme 008B,E01029584,877,634,243,155,40,48
2011,Newcastle-under-Lyme 008C,E01029585,1128,833,295,180,42,73
2011,Newcastle-under-Lyme 008D,E01029609,1247,945,302,167,49,86
2011,Newcastle-under-Lyme 008E,E01029611,1175,874,301,150,34,117
2011,Newcastle-under-Lyme 009A,E01029577,1131,843,288,190,32,66
2011,Newcastle-under-Lyme 009B,E01029579,1224,898,326,216,40,70
2011,Newcastle-under-Lyme 009C,E01029580,1083,819,264,164,43,57
2011,Newcastle-under-Lyme 009D,E01029610,1012,778,234,123,41,70
2011,Newcastle-under-Lyme 009E,E01029612,877,610,267,165,51,51
2011,Newcastle-under-Lyme 010A,E01029553,1029,655,374,134,73,167
2011,Newcastle-under-Lyme 010B,E01029554,871,469,402,140,47,215
2011,Newcastle-under-Lyme 010C,E01029566,822,498,324,97,35,192
2011,Newcastle-under-Lyme 010D,E01029567,1204,839,365,165,69,131
2011,Newcastle-under-Lyme 010E,E01029598,1311,824,487,134,177,176
2011,Newcastle-under-Lyme 010F,E01029599,1042,649,393,194,76,123
2011,Newcastle-under-Lyme 011A,E01029555,1384,874,510,172,201,137
2011,Newcastle-under-Lyme 011B,E01029578,1176,787,389,199,62,128
2011,Newcastle-under-Lyme 011C,E01029602,1550,918,632,154,345,133
2011,Newcastle-under-Lyme 011D,E01029603,1172,745,427,153,128,146
2011,Newcastle-under-Lyme 011E,E01029604,1312,786,526,160,171,195
2011,Newcastle-under-Lyme 012A,E01029576,4124,1415,2709,136,2521,52
2011,Newcastle-under-Lyme 012B,E01029593,1313,808,505,179,116,210
2011,Newcastle-under-Lyme 012C,E01029594,1386,936,450,280,62,108
2011,Newcastle-under-Lyme 013A,E01029557,938,638,300,201,39,60
2011,Newcastle-under-Lyme 013B,E01029573,1092,764,328,202,64,62
2011,Newcastle-under-Lyme 013C,E01029574,1026,677,349,235,43,71
2011,Newcastle-under-Lyme 013D,E01029575,744,521,223,109,30,84
2011,Newcastle-under-Lyme 014A,E01029549,1183,729,454,265,50,139
2011,Newcastle-under-Lyme 014B,E01029551,1181,891,290,166,53,71
2011,Newcastle-under-Lyme 014C,E01029591,1060,675,385,176,51,158
2011,Newcastle-under-Lyme 014D,E01029600,1025,684,341,228,50,63
2011,Newcastle-under-Lyme 014E,E01029605,930,651,279,183,41,55
2011,Newcastle-under-Lyme 014F,E01029607,1001,683,318,162,48,108
2011,Newcastle-under-Lyme 015B,E01029589,946,667,279,186,37,56
2011,Newcastle-under-Lyme 015C,E01029590,986,645,341,231,38,72
2011,Newcastle-under-Lyme 015E,E01029601,1024,634,390,256,62,72
2011,Newcastle-under-Lyme 015F,E01029606,1049,779,270,163,61,46
2011,Newcastle-under-Lyme 015G,E01029608,1087,654,433,284,70,79
2011,Newcastle-under-Lyme 015H,E01033257,1870,1402,468,280,79,109
2011,Newcastle-under-Lyme 016A,E01029569,1129,732,397,219,42,136
2011,Newcastle-under-Lyme 016B,E01029570,1793,1209,584,387,76,121
2011,Newcastle-under-Lyme 016C,E01029571,997,669,328,198,52,78
2011,Newcastle-under-Lyme 016D,E01029572,1254,853,401,264,56,81
2011,South Staffordshire 001A,E01029655,1449,980,469,328,41,100
2011,South Staffordshire 001B,E01029656,1385,945,440,303,52,85
2011,South Staffordshire 001C,E01029657,1339,1098,241,121,57,63
2011,South Staffordshire 001D,E01029658,957,628,329,201,37,91
2011,South Staffordshire 001E,E01029659,1045,702,343,254,31,58
2011,South Staffordshire 001F,E01029660,1615,1124,491,320,63,108
2011,South Staffordshire 002A,E01029621,1158,822,336,198,44,94
2011,South Staffordshire 002B,E01029646,1055,740,315,142,39,134
2011,South Staffordshire 002C,E01029647,1621,1273,348,143,51,154
2011,South Staffordshire 002D,E01029648,1131,745,386,185,43,158
2011,South Staffordshire 003A,E01029617,1240,830,410,279,52,79
2011,South Staffordshire 003B,E01029618,1098,750,348,236,49,63
2011,South Staffordshire 003C,E01029668,952,637,315,231,26,58
2011,South Staffordshire 003D,E01029669,971,629,342,236,36,70
2011,South Staffordshire 003E,E01029670,1204,888,316,193,43,80
2011,South Staffordshire 004A,E01029620,975,674,301,184,34,83
2011,South Staffordshire 004B,E01029622,1162,814,348,214,35,99
2011,South Staffordshire 004C,E01029623,916,657,259,151,41,67
2011,South Staffordshire 004D,E01029624,1166,905,261,152,43,66
2011,South Staffordshire 004E,E01029625,845,544,301,232,20,49
2011,South Staffordshire 004F,E01029641,1325,972,353,238,43,72
2011,South Staffordshire 004G,E01029642,1117,733,384,280,39,65
2011,South Staffordshire 005A,E01029638,1524,978,546,340,63,143
2011,South Staffordshire 005B,E01029639,1120,797,323,152,69,102
2011,South Staffordshire 005C,E01029640,1129,862,267,123,51,93
2011,South Staffordshire 005D,E01029643,1054,646,408,228,37,143
2011,South Staffordshire 005E,E01029644,1153,741,412,283,50,79
2011,South Staffordshire 006A,E01029616,1149,779,370,289,22,59
2011,South Staffordshire 006B,E01029619,1411,975,436,328,47,61
2011,South Staffordshire 006C,E01029636,1108,820,288,195,46,47
2011,South Staffordshire 006D,E01029637,2156,1215,941,149,91,701
2011,South Staffordshire 007A,E01029632,1284,941,343,220,48,75
2011,South Staffordshire 007B,E01029633,1297,926,371,253,33,85
2011,South Staffordshire 007C,E01029634,1042,721,321,167,39,115
2011,South Staffordshire 007D,E01029635,1265,873,392,165,56,171
2011,South Staffordshire 008A,E01029613,1049,707,342,245,42,55
2011,South Staffordshire 008B,E01029614,1245,901,344,180,63,101
2011,South Staffordshire 008C,E01029615,815,539,276,132,35,109
2011,South Staffordshire 008D,E01029627,971,640,331,185,34,112
2011,South Staffordshire 009A,E01029626,1048,735,313,205,46,62
2011,South Staffordshire 009B,E01029628,878,578,300,224,30,46
2011,South Staffordshire 009C,E01029629,863,582,281,201,27,53
2011,South Staffordshire 009D,E01029630,988,681,307,208,36,63
2011,South Staffordshire 009E,E01029631,1073,802,271,164,51,56
2011,South Staffordshire 010A,E01029654,1685,1187,498,329,68,101
2011,South Staffordshire 010B,E01029661,1539,1162,377,242,60,75
2011,South Staffordshire 010C,E01029663,1100,904,196,105,42,49
2011,South Staffordshire 010D,E01029665,1425,1108,317,163,74,80
2011,South Staffordshire 011A,E01029662,1743,1336,407,221,89,97
2011,South Staffordshire 011B,E01029664,1235,971,264,139,47,78
2011,South Staffordshire 011C,E01029666,1150,841,309,139,49,121
2011,South Staffordshire 012A,E01029671,1052,665,387,243,51,93
2011,South Staffordshire 012B,E01029673,1151,805,346,192,61,93
2011,South Staffordshire 012C,E01029676,731,484,247,177,27,43
2011,South Staffordshire 012D,E01029679,1053,697,356,141,41,174
2011,South Staffordshire 012E,E01029680,1143,834,309,187,44,78
2011,South Staffordshire 013A,E01029645,1488,916,572,398,38,136
2011,South Staffordshire 013B,E01029667,1645,1140,505,340,59,106
2011,South Staffordshire 013C,E01029672,1143,862,281,181,43,57
2011,South Staffordshire 013D,E01029674,1355,1020,335,197,76,62
2011,South Staffordshire 013E,E01029675,1025,633,392,301,34,57
2011,South Staffordshire 013F,E01029677,961,671,290,211,33,46
2011,South Staffordshire 013G,E01029678,1375,1051,324,199,56,69
2011,South Staffordshire 014A,E01029649,874,537,337,240,35,62
2011,South Staffordshire 014B,E01029650,1176,773,403,267,47,89
2011,South Staffordshire 014C,E01029651,1084,719,365,260,45,60
2011,South Staffordshire 014D,E01029652,1333,954,379,243,65,71
2011,South Staffordshire 014E,E01029653,904,619,285,182,39,64
2011,Stafford 001A,E01029702,1102,708,394,244,36,114
2011,Stafford 001B,E01029703,1164,839,325,189,46,90
2011,Stafford 001C,E01029704,1020,656,364,270,19,75
2011,Stafford 001D,E01029705,1069,662,407,310,33,64
2011,Stafford 002A,E01029681,882,606,276,135,31,110
2011,Stafford 002B,E01029682,1121,732,389,263,41,85
2011,Stafford 002C,E01029683,950,648,302,180,41,81
2011,Stafford 002D,E01029748,1033,741,292,211,40,41
2011,Stafford 002E,E01029749,1207,820,387,251,35,101
2011,Stafford 003A,E01029740,1134,794,340,168,47,125
2011,Stafford 003B,E01029744,1722,1352,370,203,59,108
2011,Stafford 003C,E01029745,1194,830,364,215,35,114
2011,Stafford 003D,E01029746,1117,783,334,198,39,97
2011,Stafford 003E,E01029753,931,573,358,243,26,89
2011,Stafford 003F,E01029756,1252,982,270,138,37,95
2011,Stafford 004A,E01029733,1437,1053,384,242,54,88
2011,Stafford 004B,E01029739,1218,945,273,173,51,49
2011,Stafford 004C,E01029741,1263,1011,252,147,45,60
2011,Stafford 004D,E01029754,1015,702,313,218,34,61
2011,Stafford 004E,E01029755,1072,701,371,306,19,46
2011,Stafford 005A,E01029695,1488,1004,484,343,44,97
2011,Stafford 005B,E01029696,1163,808,355,223,45,87
2011,Stafford 005C,E01029697,1261,814,447,184,48,215
2011,Stafford 005D,E01029698,1142,821,321,235,31,55
2011,Stafford 005E,E01029747,1133,804,329,216,53,60
2011,Stafford 006A,E01029690,1137,894,243,131,47,65
2011,Stafford 006B,E01029718,1482,1083,399,265,55,79
2011,Stafford 006C,E01029743,1049,716,333,244,31,58
2011,Stafford 006D,E01029751,1153,732,421,311,38,72
2011,Stafford 007A,E01029719,1105,753,352,250,39,63
2011,Stafford 007B,E01029720,1161,831,330,113,74,143
2011,Stafford 007C,E01029721,1173,859,314,170,54,90
2011,Stafford 007D,E01029750,1105,818,287,155,30,102
2011,Stafford 007E,E01029752,908,603,305,121,57,127
2011,Stafford 008A,E01029687,1444,1000,444,321,49,74
2011,Stafford 008B,E01029710,1117,752,365,279,26,60
2011,Stafford 008C,E01029711,1151,849,302,196,44,62
2011,Stafford 008D,E01029712,1404,1033,371,246,54,71
2011,Stafford 008E,E01029713,1187,792,395,265,43,87
2011,Stafford 009A,E01029692,1121,786,335,146,63,126
2011,Stafford 009B,E01029693,1348,868,480,37,340,103
2011,Stafford 009C,E01029722,1303,940,363,126,138,99
2011,Stafford 009D,E01029725,1916,891,1025,173,175,677
2011,Stafford 010A,E01029689,1380,1094,286,86,119,81
2011,Stafford 010B,E01029691,951,659,292,125,64,103
2011,Stafford 010C,E01029694,1168,884,284,57,146,81
2011,Stafford 010D,E01029699,1452,1103,349,138,122,89
2011,Stafford 010E,E01029701,1561,1158,403,115,150,138
2011,Stafford 011A,E01029686,1018,726,292,198,39,55
2011,Stafford 011B,E01029700,997,798,199,123,40,36
2011,Stafford 011C,E01029723,1217,872,345,205,65,75
2011,Stafford 011D,E01029724,1326,992,334,197,81,56
2011,Stafford 011E,E01029732,2006,1309,697,181,416,100
2011,Stafford 012A,E01029714,1245,974,271,174,44,53
2011,Stafford 012B,E01029736,1164,899,265,144,54,67
2011,Stafford 012C,E01029737,1108,798,310,168,57,85
2011,Stafford 012D,E01029738,1002,737,265,169,42,54
2011,Stafford 012E,E01029742,1543,1032,511,372,52,87
2011,Stafford 013A,E01029715,1256,941,315,117,58,140
2011,Stafford 013B,E01029716,1122,751,371,184,50,137
2011,Stafford 013C,E01029717,1263,784,479,156,71,252
2011,Stafford 013D,E01029727,1110,699,411,164,48,199
2011,Stafford 013E,E01029728,993,715,278,161,42,75
2011,Stafford 014A,E01029684,1049,772,277,165,56,56
2011,Stafford 014B,E01029685,1104,708,396,308,42,46
2011,Stafford 014C,E01029730,769,526,243,176,34,33
2011,Stafford 014D,E01029731,1160,846,314,206,51,57
2011,Stafford 014E,E01029757,1170,890,280,179,47,54
2011,Stafford 014F,E01029758,1136,773,363,279,40,44
2011,Stafford 014G,E01029759,1290,895,395,278,51,66
2011,Stafford 014H,E01029760,1079,718,361,282,40,39
2011,Stafford 015A,E01029688,1677,1141,536,364,54,118
2011,Stafford 015B,E01029706,1202,850,352,250,47,55
2011,Stafford 015C,E01029707,1011,705,306,189,22,95
2011,Stafford 015D,E01029708,1469,1064,405,250,62,93
2011,Stafford 015E,E01029709,1144,788,356,232,56,68
2011,Stafford 016A,E01029726,1254,864,390,221,50,119
2011,Stafford 016B,E01029729,1242,878,364,201,30,133
2011,Stafford 016C,E01029734,1552,1052,500,142,72,286
2011,Stafford 016D,E01029735,1753,1290,463,236,61,166
2011,Staffordshire Moorlands 001A,E01029797,1206,882,324,182,37,105
2011,Staffordshire Moorlands 001B,E01029806,1084,741,343,242,29,72
2011,Staffordshire Moorlands 001C,E01029808,1019,686,333,194,31,108
2011,Staffordshire Moorlands 001D,E01029809,1029,684,345,143,35,167
2011,Staffordshire Moorlands 001E,E01029810,946,617,329,154,34,141
2011,Staffordshire Moorlands 002A,E01029767,1282,888,394,265,46,83
2011,Staffordshire Moorlands 002B,E01029769,1259,785,474,376,28,70
2011,Staffordshire Moorlands 002C,E01029770,1511,1067,444,324,35,85
2011,Staffordshire Moorlands 002D,E01029802,1416,974,442,263,54,125
2011,Staffordshire Moorlands 003A,E01029763,1107,708,399,152,48,199
2011,Staffordshire Moorlands 003B,E01029764,1272,1030,242,76,51,115
2011,Staffordshire Moorlands 003C,E01029765,954,612,342,111,48,183
2011,Staffordshire Moorlands 003D,E01029766,1098,735,363,163,58,142
2011,Staffordshire Moorlands 003E,E01029774,1456,1052,404,185,50,169
2011,Staffordshire Moorlands 004A,E01029768,1060,673,387,290,27,70
2011,Staffordshire Moorlands 004B,E01029771,1144,696,448,349,30,69
2011,Staffordshire Moorlands 004C,E01029772,1358,931,427,287,34,106
2011,Staffordshire Moorlands 004D,E01029773,1178,761,417,321,26,70
2011,Staffordshire Moorlands 005A,E01029804,1369,1006,363,151,49,163
2011,Staffordshire Moorlands 005B,E01029807,780,538,242,139,26,77
2011,Staffordshire Moorlands 005C,E01029811,1112,777,335,171,38,126
2011,Staffordshire Moorlands 005D,E01029812,1467,1103,364,165,52,147
2011,Staffordshire Moorlands 005E,E01029814,1260,994,266,130,52,84
2011,Staffordshire Moorlands 006A,E01029792,1752,1307,445,300,55,90
2011,Staffordshire Moorlands 006B,E01029793,1189,844,345,239,42,64
2011,Staffordshire Moorlands 006C,E01029805,1197,812,385,247,46,92
2011,Staffordshire Moorlands 006D,E01029813,1577,1113,464,291,66,107
2011,Staffordshire Moorlands 006E,E01029815,1123,749,374,256,45,73
2011,Staffordshire Moorlands 006F,E01029816,1078,729,349,245,29,75
2011,Staffordshire Moorlands 007A,E01029801,1382,1009,373,252,31,90
2011,Staffordshire Moorlands 007B,E01029803,1415,985,430,305,45,80
2011,Staffordshire Moorlands 007C,E01029817,1449,1061,388,242,38,108
2011,Staffordshire Moorlands 008A,E01029762,1174,817,357,268,44,45
2011,Staffordshire Moorlands 008B,E01029775,1113,725,388,269,37,82
2011,Staffordshire Moorlands 008C,E01029776,1309,887,422,312,55,55
2011,Staffordshire Moorlands 008D,E01029777,1070,740,330,207,33,90
2011,Staffordshire Moorlands 009A,E01029779,1167,777,390,310,26,54
2011,Staffordshire Moorlands 009B,E01029780,1197,767,430,245,48,137
2011,Staffordshire Moorlands 009C,E01029794,1073,768,305,212,32,61
2011,Staffordshire Moorlands 009D,E01029818,1160,848,312,217,34,61
2011,Staffordshire Moorlands 009E,E01029819,1255,855,400,283,35,82
2011,Staffordshire Moorlands 010A,E01029761,1056,710,346,240,39,67
2011,Staffordshire Moorlands 010B,E01029782,1489,976,513,223,41,249
2011,Staffordshire Moorlands 010C,E01029795,1270,877,393,249,49,95
2011,Staffordshire Moorlands 010D,E01029796,1130,787,343,211,35,97
2011,Staffordshire Moorlands 011A,E01029781,1176,807,369,233,42,94
2011,Staffordshire Moorlands 011B,E01029783,1006,669,337,183,33,121
2011,Staffordshire Moorlands 011C,E01029786,1116,836,280,179,47,54
2011,Staffordshire Moorlands 011D,E01029787,1268,785,483,239,45,199
2011,Staffordshire Moorlands 012A,E01029778,1319,938,381,216,43,122
2011,Staffordshire Moorlands 012B,E01029789,776,528,248,167,30,51
2011,Staffordshire Moorlands 012C,E01029798,1304,858,446,272,42,132
2011,Staffordshire Moorlands 012D,E01029799,1390,929,461,340,35,86
2011,Staffordshire Moorlands 012E,E01029800,1179,844,335,229,37,69
2011,Staffordshire Moorlands 013A,E01029784,1607,1107,500,336,46,118
2011,Staffordshire Moorlands 013B,E01029785,1355,984,371,254,38,79
2011,Staffordshire Moorlands 013C,E01029788,1062,752,310,236,26,48
2011,Staffordshire Moorlands 013D,E01029790,1431,1027,404,239,56,109
2011,Staffordshire Moorlands 013E,E01029791,1104,841,263,166,36,61
2011,Tamworth 001A,E01029846,929,618,311,185,34,92
2011,Tamworth 001B,E01029847,1046,765,281,202,32,47
2011,Tamworth 001C,E01029848,937,659,278,209,23,46
2011,Tamworth 001D,E01029852,1179,764,415,232,70,113
2011,Tamworth 001E,E01029853,1159,806,353,212,36,105
2011,Tamworth 001F,E01029854,1153,759,394,316,28,50
2011,Tamworth 002A,E01029835,1208,720,488,296,24,168
2011,Tamworth 002B,E01029836,946,688,258,136,26,96
2011,Tamworth 002C,E01029849,1015,635,380,166,37,177
2011,Tamworth 002D,E01029850,920,639,281,126,30,125
2011,Tamworth 002E,E01029851,1568,1134,434,200,60,174
2011,Tamworth 003A,E01029820,1180,818,362,167,47,148
2011,Tamworth 003B,E01029821,1165,816,349,222,35,92
2011,Tamworth 003C,E01029822,1143,963,180,62,58,60
2011,Tamworth 003D,E01029824,1339,886,453,126,59,268
2011,Tamworth 003E,E01029841,1138,807,331,211,35,85
2011,Tamworth 004A,E01029823,1136,738,398,313,24,61
2011,Tamworth 004B,E01029831,1100,743,357,156,55,146
2011,Tamworth 004C,E01029832,1184,807,377,234,36,107
2011,Tamworth 004D,E01029834,1096,740,356,190,40,126
2011,Tamworth 004E,E01029844,961,742,219,120,24,75
2011,Tamworth 005A,E01029833,1312,1048,264,124,38,102
2011,Tamworth 005B,E01029837,1163,883,280,142,33,105
2011,Tamworth 005C,E01029838,1230,975,255,138,36,81
2011,Tamworth 005D,E01029839,930,763,167,74,30,63
2011,Tamworth 006A,E01029825,1061,835,226,135,29,62
2011,Tamworth 006B,E01029826,1166,835,331,214,39,78
2011,Tamworth 006C,E01029827,992,676,316,113,50,153
2011,Tamworth 006D,E01029828,932,616,316,104,57,155
2011,Tamworth 006E,E01029830,901,635,266,132,27,107
2011,Tamworth 007A,E01029840,897,574,323,97,41,185
2011,Tamworth 007B,E01029842,956,644,312,90,48,174
2011,Tamworth 007C,E01029843,1053,726,327,146,41,140
2011,Tamworth 007D,E01029845,739,396,343,126,40,177
2011,Tamworth 007E,E01029859,1278,881,397,120,54,223
2011,Tamworth 008A,E01029855,1125,845,280,116,64,100
2011,Tamworth 008B,E01029856,1156,961,195,89,38,68
2011,Tamworth 008C,E01029857,1042,780,262,98,38,126
2011,Tamworth 008D,E01029858,1246,979,267,151,33,83
2011,Tamworth 008E,E01029865,1323,1057,266,126,53,87
2011,Tamworth 009A,E01029860,1041,808,233,154,31,48
2011,Tamworth 009B,E01029861,987,667,320,216,37,67
2011,Tamworth 009C,E01029862,1019,839,180,95,40,45
2011,Tamworth 009D,E01029863,1348,1015,333,215,38,80
2011,Tamworth 009E,E01029864,1261,931,330,231,38,61
2011,Tamworth 010A,E01029829,1466,1134,332,147,50,135
2011,Tamworth 010C,E01029867,1208,852,356,177,41,138
2011,Tamworth 010D,E01029868,1121,911,210,91,36,83
2011,Tamworth 010E,E01029869,1174,860,314,169,45,100
2011,Tamworth 010F,E01032901,1165,1009,156,56,24,76
2011,Tamworth 010G,E01032902,1039,806,233,137,30,66
2011,North Warwickshire 001A,E01031035,1453,1022,431,251,64,116
2011,North Warwickshire 001B,E01031036,1156,827,329,219,45,65
2011,North Warwickshire 001C,E01031037,1081,734,347,197,37,113
2011,North Warwickshire 001D,E01031038,1445,1041,404,234,53,117
2011,North Warwickshire 001E,E01031039,1286,937,349,242,46,61
2011,North Warwickshire 001F,E01031040,1374,1056,318,190,36,92
2011,North Warwickshire 002A,E01031016,1160,728,432,253,45,134
2011,North Warwickshire 002B,E01031025,1195,854,341,199,31,111
2011,North Warwickshire 002C,E01031026,1162,849,313,129,44,140
2011,North Warwickshire 002D,E01031031,1856,1396,460,242,61,157
2011,North Warwickshire 002E,E01031032,971,650,321,157,34,130
2011,North Warwickshire 003A,E01031009,1665,1250,415,236,43,136
2011,North Warwickshire 003B,E01031010,1306,906,400,142,28,230
2011,North Warwickshire 003C,E01031011,1468,1050,418,272,53,93
2011,North Warwickshire 003D,E01031012,1007,634,373,207,33,133
2011,North Warwickshire 003E,E01031013,793,553,240,170,18,52
2011,North Warwickshire 003F,E01031014,920,623,297,195,36,66
2011,North Warwickshire 003G,E01031015,984,615,369,155,37,177
2011,North Warwickshire 004A,E01031023,1204,842,362,251,48,63
2011,North Warwickshire 004B,E01031024,1265,951,314,204,38,72
2011,North Warwickshire 004C,E01031033,1398,922,476,312,55,109
2011,North Warwickshire 004D,E01031034,1465,1112,353,214,50,89
2011,North Warwickshire 005A,E01031005,1036,735,301,144,49,108
2011,North Warwickshire 005B,E01031008,1009,714,295,136,30,129
2011,North Warwickshire 005C,E01031017,967,692,275,180,27,68
2011,North Warwickshire 005D,E01031018,827,608,219,138,25,56
2011,North Warwickshire 005E,E01031029,1104,807,297,177,34,86
2011,North Warwickshire 005F,E01031030,1696,1177,519,302,55,162
2011,North Warwickshire 006A,E01031019,1274,1009,265,166,41,58
2011,North Warwickshire 006B,E01031020,1156,903,253,165,36,52
2011,North Warwickshire 006C,E01031021,1186,854,332,226,25,81
2011,North Warwickshire 006D,E01031022,1219,859,360,222,41,97
2011,North Warwickshire 006E,E01031041,1302,1000,302,177,57,68
2011,North Warwickshire 006F,E01031042,1277,949,328,217,37,74
2011,North Warwickshire 007A,E01031006,1089,784,305,147,42,116
2011,North Warwickshire 007B,E01031007,930,708,222,152,21,49
2011,North Warwickshire 007C,E01031027,1081,773,308,204,31,73
2011,North Warwickshire 007D,E01031028,1403,1027,376,212,48,116
2011,Nuneaton and Bedworth 001A,E01031110,1090,728,362,267,39,56
2011,Nuneaton and Bedworth 001B,E01031111,879,649,230,162,38,30
2011,Nuneaton and Bedworth 001C,E01031112,1154,842,312,231,25,56
2011,Nuneaton and Bedworth 001D,E01031113,1053,745,308,226,30,52
2011,Nuneaton and Bedworth 001E,E01031114,1129,782,347,203,44,100
2011,Nuneaton and Bedworth 002C,E01031073,1352,920,432,228,48,156
2011,Nuneaton and Bedworth 002D,E01031074,1146,816,330,151,26,153
2011,Nuneaton and Bedworth 002E,E01031075,1181,809,372,125,42,205
2011,Nuneaton and Bedworth 002F,E01032890,1517,970,547,156,91,300
2011,Nuneaton and Bedworth 003A,E01031100,1047,825,222,119,46,57
2011,Nuneaton and Bedworth 003B,E01031101,1080,831,249,153,48,48
2011,Nuneaton and Bedworth 003C,E01031102,1008,762,246,143,22,81
2011,Nuneaton and Bedworth 003D,E01031103,996,685,311,225,32,54
2011,Nuneaton and Bedworth 003E,E01031104,1034,639,395,329,28,38
2011,Nuneaton and Bedworth 004A,E01031081,1221,892,329,123,52,154
2011,Nuneaton and Bedworth 004B,E01031082,1070,895,175,70,47,58
2011,Nuneaton and Bedworth 004C,E01031083,1155,866,289,183,37,69
2011,Nuneaton and Bedworth 004D,E01031084,1657,1331,326,151,64,111
2011,Nuneaton and Bedworth 004E,E01031085,1090,844,246,150,25,71
2011,Nuneaton and Bedworth 005A,E01031043,1289,885,404,160,34,210
2011,Nuneaton and Bedworth 005B,E01031044,1258,877,381,121,48,212
2011,Nuneaton and Bedworth 005C,E01031045,1268,920,348,183,39,126
2011,Nuneaton and Bedworth 005D,E01031046,1320,931,389,104,52,233
2011,Nuneaton and Bedworth 005E,E01031047,1433,1074,359,107,58,194
2011,Nuneaton and Bedworth 006A,E01031057,1066,645,421,126,45,250
2011,Nuneaton and Bedworth 006B,E01031058,1090,718,372,199,43,130
2011,Nuneaton and Bedworth 006C,E01031059,1076,812,264,129,27,108
2011,Nuneaton and Bedworth 006D,E01031060,1101,737,364,230,35,99
2011,Nuneaton and Bedworth 006E,E01031061,1144,913,231,96,49,86
2011,Nuneaton and Bedworth 007A,E01031090,1036,658,378,120,43,215
2011,Nuneaton and Bedworth 007B,E01031091,1064,748,316,207,30,79
2011,Nuneaton and Bedworth 007C,E01031092,1041,717,324,156,40,128
2011,Nuneaton and Bedworth 007D,E01031093,1048,704,344,204,52,88
2011,Nuneaton and Bedworth 007E,E01031094,837,617,220,94,28,98
2011,Nuneaton and Bedworth 008A,E01031048,981,740,241,133,29,79
2011,Nuneaton and Bedworth 008B,E01031049,1615,1250,365,174,61,130
2011,Nuneaton and Bedworth 008C,E01031050,1423,1126,297,134,48,115
2011,Nuneaton and Bedworth 008D,E01031051,1056,720,336,241,23,72
2011,Nuneaton and Bedworth 009A,E01031115,1285,895,390,166,69,155
2011,Nuneaton and Bedworth 009B,E01031116,1139,691,448,153,52,243
2011,Nuneaton and Bedworth 009C,E01031117,995,686,309,111,47,151
2011,Nuneaton and Bedworth 009D,E01031118,863,549,314,141,45,128
2011,Nuneaton and Bedworth 009E,E01031119,1178,762,416,172,44,200
2011,Nuneaton and Bedworth 010A,E01031052,1105,868,237,96,42,99
2011,Nuneaton and Bedworth 010B,E01031053,989,650,339,187,35,117
2011,Nuneaton and Bedworth 010C,E01031054,1145,801,344,163,53,128
2011,Nuneaton and Bedworth 010D,E01031055,1214,996,218,96,39,83
2011,Nuneaton and Bedworth 010E,E01031056,1080,747,333,170,50,113
2011,Nuneaton and Bedworth 011A,E01031120,1106,832,274,180,35,59
2011,Nuneaton and Bedworth 011B,E01031121,945,694,251,178,35,38
2011,Nuneaton and Bedworth 011C,E01031122,1129,807,322,237,36,49
2011,Nuneaton and Bedworth 011D,E01031123,971,694,277,204,28,45
2011,Nuneaton and Bedworth 011E,E01031124,1129,780,349,273,35,41
2011,Nuneaton and Bedworth 012A,E01031105,1029,738,291,188,35,68
2011,Nuneaton and Bedworth 012B,E01031106,1091,705,386,248,36,102
2011,Nuneaton and Bedworth 012C,E01031107,897,694,203,116,28,59
2011,Nuneaton and Bedworth 012D,E01031108,1071,853,218,122,28,68
2011,Nuneaton and Bedworth 012E,E01031109,1184,822,362,193,41,128
2011,Nuneaton and Bedworth 013A,E01031062,951,617,334,243,27,64
2011,Nuneaton and Bedworth 013B,E01031063,974,588,386,210,35,141
2011,Nuneaton and Bedworth 013C,E01031064,845,570,275,158,32,85
2011,Nuneaton and Bedworth 013D,E01031065,1117,758,359,148,59,152
2011,Nuneaton and Bedworth 013E,E01031066,941,603,338,156,33,149
2011,Nuneaton and Bedworth 014A,E01031067,1097,685,412,275,45,92
2011,Nuneaton and Bedworth 014B,E01031068,1193,761,432,301,42,89
2011,Nuneaton and Bedworth 014C,E01031069,1064,601,463,365,27,71
2011,Nuneaton and Bedworth 014D,E01031070,1194,740,454,344,29,81
2011,Nuneaton and Bedworth 015A,E01031095,884,574,310,141,32,137
2011,Nuneaton and Bedworth 015B,E01031096,1078,822,256,125,31,100
2011,Nuneaton and Bedworth 015C,E01031097,1211,787,424,180,36,208
2011,Nuneaton and Bedworth 015D,E01031098,1121,797,324,170,43,111
2011,Nuneaton and Bedworth 015E,E01031099,1775,1429,346,176,48,122
2011,Nuneaton and Bedworth 016A,E01031086,1298,947,351,179,28,144
2011,Nuneaton and Bedworth 016B,E01031087,1559,1147,412,182,54,176
2011,Nuneaton and Bedworth 016C,E01031088,1440,1048,392,190,47,155
2011,Nuneaton and Bedworth 016D,E01031089,1077,736,341,247,23,71
2011,Nuneaton and Bedworth 018A,E01031077,1025,759,266,98,54,114
2011,Nuneaton and Bedworth 018B,E01031078,1494,1106,388,204,57,127
2011,Nuneaton and Bedworth 018C,E01031079,1093,733,360,208,39,113
2011,Nuneaton and Bedworth 018D,E01031080,1111,760,351,189,34,128
2011,Nuneaton and Bedworth 018E,E01032588,998,718,280,176,44,60
2011,Rugby 001B,E01031129,832,600,232,162,18,52
2011,Rugby 001C,E01031159,1209,858,351,246,33,72
2011,Rugby 001D,E01031160,1610,1160,450,288,57,105
2011,Rugby 001E,E01031182,1816,1398,418,233,56,129
2011,Rugby 001F,E01032891,1301,1138,163,38,46,79
2011,Rugby 001G,E01032892,1443,1086,357,192,53,112
2011,Rugby 002A,E01031137,918,742,176,87,18,71
2011,Rugby 002B,E01031138,932,761,171,71,34,66
2011,Rugby 002C,E01031139,1437,1178,259,130,53,76
2011,Rugby 002D,E01031140,1013,745,268,168,35,65
2011,Rugby 002E,E01031141,1332,1049,283,96,44,143
2011,Rugby 002F,E01031142,1173,873,300,55,49,196
2011,Rugby 003A,E01031171,1091,829,262,112,44,106
2011,Rugby 003B,E01031172,1143,794,349,158,38,153
2011,Rugby 003C,E01031173,1355,943,412,170,41,201
2011,Rugby 003D,E01031174,1305,923,382,112,55,215
2011,Rugby 004A,E01031151,1138,817,321,234,21,66
2011,Rugby 004B,E01031152,866,590,276,199,23,54
2011,Rugby 004C,E01031153,1009,729,280,159,34,87
2011,Rugby 004D,E01031154,1342,979,363,249,48,66
2011,Rugby 004E,E01031181,1344,1004,340,242,40,58
2011,Rugby 005A,E01031130,1369,1101,268,87,46,135
2011,Rugby 005B,E01031131,1239,969,270,109,44,117
2011,Rugby 005C,E01031132,1513,1199,314,134,52,128
2011,Rugby 005D,E01031133,1172,887,285,109,50,126
2011,Rugby 006A,E01031167,1020,748,272,139,34,99
2011,Rugby 006B,E01031168,1960,1550,410,147,70,193
2011,Rugby 006C,E01031169,1556,1242,314,123,38,153
2011,Rugby 006D,E01031170,1198,900,298,135,44,119
2011,Rugby 007A,E01031125,1136,827,309,203,24,82
2011,Rugby 007C,E01031127,1082,777,305,147,39,119
2011,Rugby 007D,E01031164,1505,1160,345,203,51,91
2011,Rugby 007E,E01031165,1120,794,326,164,28,134
2011,Rugby 007F,E01032893,1241,1041,200,63,65,72
2011,Rugby 007G,E01032894,930,764,166,55,38,73
2011,Rugby 007H,E01032895,1077,833,244,144,45,55
2011,Rugby 008A,E01031155,1028,767,261,174,39,48
2011,Rugby 008B,E01031156,1096,849,247,150,35,62
2011,Rugby 008C,E01031157,1404,1101,303,157,73,73
2011,Rugby 008D,E01031158,743,503,240,181,21,38
2011,Rugby 009A,E01031143,1190,815,375,288,44,43
2011,Rugby 009B,E01031144,911,714,197,84,40,73
2011,Rugby 009C,E01031145,1030,475,555,125,369,61
2011,Rugby 009D,E01031146,1036,688,348,198,43,107
2011,Rugby 010A,E01031161,1456,1020,436,325,35,76
2011,Rugby 010B,E01031162,1289,917,372,244,40,88
2011,Rugby 010C,E01031163,1117,723,394,258,28,108
2011,Rugby 010D,E01031179,1231,948,283,163,58,62
2011,Rugby 010E,E01031180,1403,1049,354,206,44,104
2011,Rugby 011A,E01031134,1167,779,388,287,47,54
2011,Rugby 011B,E01031135,1151,711,440,360,38,42
2011,Rugby 011C,E01031136,1190,835,355,224,34,97
2011,Rugby 011D,E01031175,968,590,378,306,25,47
2011,Rugby 011E,E01031176,1067,757,310,114,49,147
2011,Rugby 011F,E01031177,1013,748,265,106,40,119
2011,Rugby 011G,E01031178,994,651,343,228,37,78
2011,Rugby 012A,E01031147,1046,654,392,298,43,51
2011,Rugby 012B,E01031148,1143,757,386,241,38,107
2011,Rugby 012C,E01031149,1120,799,321,217,41,63
2011,Rugby 012D,E01031150,852,585,267,187,32,48
2011,Rugby 012E,E01031166,1387,1034,353,239,35,79
2011,Stratford-on-Avon 001A,E01031213,1390,1008,382,236,47,99
2011,Stratford-on-Avon 001B,E01031243,1443,982,461,324,52,85
2011,Stratford-on-Avon 001C,E01031244,1382,977,405,270,43,92
2011,Stratford-on-Avon 002A,E01031195,1596,1092,504,338,43,123
2011,Stratford-on-Avon 002B,E01031202,1070,773,297,214,30,53
2011,Stratford-on-Avon 002C,E01031203,1075,744,331,176,44,111
2011,Stratford-on-Avon 002D,E01031204,939,569,370,291,19,60
2011,Stratford-on-Avon 003A,E01031239,1188,858,330,209,42,79
2011,Stratford-on-Avon 003B,E01031240,967,669,298,189,40,69
2011,Stratford-on-Avon 003C,E01031241,1040,744,296,183,34,79
2011,Stratford-on-Avon 003D,E01031242,1063,730,333,202,38,93
2011,Stratford-on-Avon 004A,E01031219,1050,781,269,141,47,81
2011,Stratford-on-Avon 004B,E01031220,1116,812,304,193,43,68
2011,Stratford-on-Avon 004C,E01031221,1095,806,289,181,33,75
2011,Stratford-on-Avon 004D,E01031222,1472,1079,393,240,46,107
2011,Stratford-on-Avon 004E,E01031223,1001,752,249,145,37,67
2011,Stratford-on-Avon 004F,E01031224,855,627,228,143,36,49
2011,Stratford-on-Avon 005A,E01031197,912,670,242,141,41,60
2011,Stratford-on-Avon 005B,E01031198,910,698,212,136,25,51
2011,Stratford-on-Avon 005C,E01031199,1110,787,323,191,36,96
2011,Stratford-on-Avon 005D,E01031200,1208,958,250,154,29,67
2011,Stratford-on-Avon 005E,E01031201,1157,787,370,276,39,55
2011,Stratford-on-Avon 005F,E01031210,938,667,271,184,35,52
2011,Stratford-on-Avon 005G,E01031211,753,560,193,121,22,50
2011,Stratford-on-Avon 006A,E01031183,1249,924,325,215,29,81
2011,Stratford-on-Avon 006B,E01031184,1079,800,279,188,38,53
2011,Stratford-on-Avon 006C,E01031185,998,704,294,169,23,102
2011,Stratford-on-Avon 006D,E01031186,1064,731,333,200,23,110
2011,Stratford-on-Avon 007A,E01031187,1390,966,424,294,45,85
2011,Stratford-on-Avon 007B,E01031188,1660,1145,515,339,65,111
2011,Stratford-on-Avon 007C,E01031208,1535,1051,484,336,40,108
2011,Stratford-on-Avon 008A,E01031217,869,579,290,206,30,54
2011,Stratford-on-Avon 008B,E01031218,887,697,190,95,30,65
2011,Stratford-on-Avon 008C,E01031249,886,681,205,116,29,60
2011,Stratford-on-Avon 008D,E01031250,1088,747,341,239,46,56
2011,Stratford-on-Avon 008E,E01031251,863,600,263,206,21,36
2011,Stratford-on-Avon 008F,E01031252,1038,721,317,142,118,57
2011,Stratford-on-Avon 008G,E01031253,1079,755,324,195,26,103
2011,Stratford-on-Avon 009A,E01031228,1176,823,353,267,25,61
2011,Stratford-on-Avon 009B,E01031229,1366,1049,317,205,29,83
2011,Stratford-on-Avon 009C,E01031230,1781,1450,331,175,42,114
2011,Stratford-on-Avon 009D,E01031231,1641,1222,419,153,48,218
2011,Stratford-on-Avon 009E,E01031236,1233,950,283,153,31,99
2011,Stratford-on-Avon 009F,E01031238,998,687,311,156,35,120
2011,Stratford-on-Avon 010A,E01031225,1149,809,340,216,42,82
2011,Stratford-on-Avon 010C,E01031227,1366,992,374,257,43,74
2011,Stratford-on-Avon 010D,E01033250,985,784,201,76,48,77
2011,Stratford-on-Avon 010E,E01033251,841,663,178,72,25,81
2011,Stratford-on-Avon 010F,E01033252,903,601,302,222,25,55
2011,Stratford-on-Avon 011A,E01031232,1859,1242,617,261,247,109
2011,Stratford-on-Avon 011B,E01031233,1189,854,335,170,53,112
2011,Stratford-on-Avon 011C,E01031234,1201,878,323,212,32,79
2011,Stratford-on-Avon 011D,E01031235,1257,870,387,264,35,88
2011,Stratford-on-Avon 011E,E01031237,1076,782,294,198,27,69
2011,Stratford-on-Avon 012A,E01031189,1109,803,306,192,35,79
2011,Stratford-on-Avon 012B,E01031190,1246,904,342,162,39,141
2011,Stratford-on-Avon 012C,E01031191,1352,990,362,240,44,78
2011,Stratford-on-Avon 012D,E01031192,1386,1060,326,206,31,89
2011,Stratford-on-Avon 012E,E01031248,1550,1064,486,293,51,142
2011,Stratford-on-Avon 013A,E01031194,1794,1392,402,231,45,126
2011,Stratford-on-Avon 013B,E01031205,1160,879,281,183,32,66
2011,Stratford-on-Avon 013C,E01031206,1024,751,273,153,37,83
2011,Stratford-on-Avon 013D,E01031207,965,702,263,137,28,98
2011,Stratford-on-Avon 013E,E01031247,1715,1218,497,325,61,111
2011,Stratford-on-Avon 014A,E01031196,1716,1244,472,303,59,110
2011,Stratford-on-Avon 014B,E01031212,1906,1438,468,268,47,153
2011,Stratford-on-Avon 014C,E01031245,890,574,316,208,35,73
2011,Stratford-on-Avon 014D,E01031246,790,596,194,125,22,47
2011,Stratford-on-Avon 015A,E01031193,1565,1125,440,279,51,110
2011,Stratford-on-Avon 015B,E01031209,1556,1058,498,328,36,134
2011,Stratford-on-Avon 015C,E01031214,1262,888,374,259,44,71
2011,Stratford-on-Avon 015D,E01031215,1271,929,342,215,20,107
2011,Stratford-on-Avon 015E,E01031216,1035,751,284,173,19,92
2011,Warwick 001A,E01031254,1122,812,310,204,41,65
2011,Warwick 001B,E01031255,1068,732,336,245,39,52
2011,Warwick 001C,E01031256,1161,759,402,274,58,70
2011,Warwick 001D,E01031257,1069,806,263,109,71,83
2011,Warwick 001E,E01031258,1056,755,301,188,72,41
2011,Warwick 002A,E01031296,1234,950,284,166,53,65
2011,Warwick 002B,E01031297,1409,1061,348,187,60,101
2011,Warwick 002C,E01031298,1136,851,285,194,41,50
2011,Warwick 002D,E01031299,1030,698,332,235,41,56
2011,Warwick 002E,E01031300,1259,965,294,202,49,43
2011,Warwick 003A,E01031303,1046,729,317,185,40,92
2011,Warwick 003B,E01031304,1020,734,286,194,29,63
2011,Warwick 003C,E01031305,1002,669,333,260,33,40
2011,Warwick 003D,E01031306,1063,779,284,171,47,66
2011,Warwick 003E,E01031307,991,712,279,189,36,54
2011,Warwick 004A,E01031281,1129,826,303,188,41,74
2011,Warwick 004B,E01031282,1093,778,315,198,38,79
2011,Warwick 004C,E01031283,982,728,254,155,33,66
2011,Warwick 004D,E01031284,908,685,223,141,28,54
2011,Warwick 005A,E01031277,1077,801,276,165,39,72
2011,Warwick 005B,E01031278,1046,747,299,165,63,71
2011,Warwick 005C,E01031279,940,639,301,240,19,42
2011,Warwick 005D,E01031280,1015,748,267,159,40,68
2011,Warwick 005E,E01031301,1065,768,297,210,28,59
2011,Warwick 005F,E01031302,770,592,178,102,20,56
2011,Warwick 005G,E01031308,3013,1220,1793,226,1483,84
2011,Warwick 006A,E01031273,1013,728,285,84,33,168
2011,Warwick 006B,E01031274,993,727,266,96,56,114
2011,Warwick 006C,E01031275,923,624,299,217,39,43
2011,Warwick 006D,E01031276,1114,812,302,110,62,130
2011,Warwick 007B,E01031272,1427,991,436,142,224,70
2011,Warwick 007C,E01031285,1553,1094,459,247,126,86
2011,Warwick 007D,E01031286,1042,751,291,156,69,66
2011,Warwick 007E,E01031287,1090,841,249,151,53,45
2011,Warwick 007F,E01031288,1187,790,397,237,57,103
2011,Warwick 007G,E01031289,1089,817,272,150,48,74
2011,Warwick 007H,E01033253,1274,864,410,37,332,41
2011,Warwick 007I,E01033256,1099,737,362,52,246,64
2011,Warwick 008A,E01031309,1245,942,303,139,41,123
2011,Warwick 008B,E01031310,978,715,263,148,34,81
2011,Warwick 008C,E01031311,942,696,246,135,32,79
2011,Warwick 008D,E01031312,897,677,220,96,27,97
2011,Warwick 008E,E01031313,1050,762,288,210,29,49
2011,Warwick 008F,E01031314,1037,810,227,154,22,51
2011,Warwick 009A,E01031290,1368,1046,322,139,106,77
2011,Warwick 009B,E01031291,1319,833,486,90,311,85
2011,Warwick 009C,E01031292,1110,885,225,138,39,48
2011,Warwick 009D,E01031293,1244,876,368,139,145,84
2011,Warwick 009E,E01031294,1109,761,348,127,149,72
2011,Warwick 009F,E01031295,841,529,312,220,33,59
2011,Warwick 010A,E01031271,1330,881,449,173,177,99
2011,Warwick 010B,E01031332,1016,699,317,131,42,144
2011,Warwick 010C,E01031333,1025,732,293,131,55,107
2011,Warwick 010D,E01031334,1143,898,245,106,46,93
2011,Warwick 010E,E01031335,1240,855,385,71,223,91
2011,Warwick 010F,E01031336,1915,1021,894,60,748,86
2011,Warwick 010G,E01031337,1235,904,331,96,177,58
2011,Warwick 011A,E01031321,934,691,243,70,41,132
2011,Warwick 011B,E01031322,1439,1113,326,190,37,99
2011,Warwick 011C,E01031323,1192,893,299,170,45,84
2011,Warwick 011D,E01031324,1662,1307,355,201,47,107
2011,Warwick 011E,E01031325,1007,741,266,128,36,102
2011,Warwick 011G,E01033254,1060,929,131,37,28,66
2011,Warwick 011H,E01033255,1218,959,259,116,48,95
2011,Warwick 012A,E01031315,1571,1249,322,139,78,105
2011,Warwick 012B,E01031316,1015,720,295,177,28,90
2011,Warwick 012C,E01031317,1102,745,357,245,63,49
2011,Warwick 012D,E01031318,1299,1076,223,115,48,60
2011,Warwick 012E,E01031319,1457,1112,345,161,72,112
2011,Warwick 012F,E01031320,1114,837,277,138,46,93
2011,Warwick 013A,E01031261,1224,739,485,96,259,130
2011,Warwick 013B,E01031262,1134,774,360,91,161,108
2011,Warwick 013C,E01031263,1567,821,746,81,558,107
2011,Warwick 013D,E01031264,1191,794,397,89,148,160
2011,Warwick 013E,E01031265,1084,715,369,82,157,130
2011,Warwick 013F,E01031266,1734,1013,721,66,544,111
2011,Warwick 014A,E01031259,1020,795,225,125,40,60
2011,Warwick 014B,E01031260,863,635,228,157,19,52
2011,Warwick 014C,E01031267,1339,954,385,279,41,65
2011,Warwick 014D,E01031268,1991,1628,363,185,64,114
2011,Warwick 014E,E01031269,1237,896,341,217,46,78
2011,Warwick 015A,E01031327,1073,767,306,136,71,99
2011,Warwick 015B,E01031328,1642,1256,386,250,45,91
2011,Warwick 015C,E01031329,1808,1443,365,157,76,132
2011,Warwick 015D,E01031330,1044,843,201,108,29,64
2011,Warwick 015E,E01031331,1310,1022,288,179,45,64
2011,Birmingham 001A,E01009417,1016,702,314,187,52,75
2011,Birmingham 001B,E01009418,1026,713,313,177,49,87
2011,Birmingham 001C,E01009419,925,622,303,188,38,77
2011,Birmingham 001D,E01009433,1264,884,380,265,46,69
2011,Birmingham 002A,E01009415,1127,810,317,204,47,66
2011,Birmingham 002B,E01009422,1293,903,390,268,48,74
2011,Birmingham 002C,E01009423,1180,851,329,191,46,92
2011,Birmingham 002D,E01009425,1113,739,374,253,42,79
2011,Birmingham 003A,E01009416,1851,1467,384,197,68,119
2011,Birmingham 003B,E01009420,1050,794,256,155,42,59
2011,Birmingham 003C,E01009426,964,681,283,201,41,41
2011,Birmingham 003D,E01009429,1028,728,300,216,33,51
2011,Birmingham 003E,E01009431,1082,749,333,225,54,54
2011,Birmingham 004A,E01009421,1193,785,408,269,73,66
2011,Birmingham 004B,E01009424,1064,833,231,138,41,52
2011,Birmingham 004C,E01009427,1103,789,314,164,45,105
2011,Birmingham 004D,E01009428,1176,761,415,287,64,64
2011,Birmingham 004E,E01009430,1178,768,410,255,62,93
2011,Birmingham 004F,E01009468,1052,720,332,206,58,68
2011,Birmingham 005A,E01009445,1106,730,376,104,67,205
2011,Birmingham 005B,E01009446,1723,1341,382,188,66,128
2011,Birmingham 005C,E01009447,1060,767,293,119,50,124
2011,Birmingham 005D,E01009448,1156,754,402,173,66,163
2011,Birmingham 005E,E01009452,1175,854,321,177,50,94
2011,Birmingham 005F,E01009455,1002,672,330,171,38,121
2011,Birmingham 006A,E01009432,1054,733,321,159,46,116
2011,Birmingham 006B,E01009435,1378,1107,271,141,63,67
2011,Birmingham 006C,E01009437,1264,886,378,245,54,79
2011,Birmingham 006D,E01009444,1073,744,329,237,43,49
2011,Birmingham 006E,E01009454,1147,871,276,164,59,53
2011,Birmingham 007A,E01009221,1076,755,321,164,47,110
2011,Birmingham 007B,E01009464,990,747,243,160,33,50
2011,Birmingham 007C,E01009465,1009,755,254,146,51,57
2011,Birmingham 007D,E01009467,1143,814,329,205,50,74
2011,Birmingham 008A,E01009220,1102,816,286,108,51,127
2011,Birmingham 008B,E01009222,1074,695,379,104,68,207
2011,Birmingham 008C,E01009224,1003,700,303,168,54,81
2011,Birmingham 008D,E01009233,1062,711,351,122,51,178
2011,Birmingham 009A,E01009449,1391,1043,348,177,51,120
2011,Birmingham 009B,E01009451,1035,810,225,96,48,81
2011,Birmingham 009C,E01009453,1083,805,278,132,67,79
2011,Birmingham 009D,E01009466,1221,890,331,211,55,65
2011,Birmingham 009E,E01009471,1312,991,321,163,58,100
2011,Birmingham 010A,E01009135,1133,779,354,189,75,90
2011,Birmingham 010B,E01009469,1075,743,332,229,43,60
2011,Birmingham 010C,E01009470,1058,750,308,194,51,63
2011,Birmingham 010D,E01009472,1155,839,316,187,52,77
2011,Birmingham 010E,E01009473,1146,857,289,151,52,86
2011,Birmingham 010F,E01009474,1148,828,320,162,67,91
2011,Birmingham 011A,E01009127,1058,668,390,93,71,226
2011,Birmingham 011B,E01009128,949,597,352,107,56,189
2011,Birmingham 011C,E01009130,1059,668,391,133,55,203
2011,Birmingham 011D,E01009131,996,660,336,79,74,183
2011,Birmingham 011E,E01009133,1024,613,411,130,63,218
2011,Birmingham 011F,E01009134,1077,644,433,159,63,211
2011,Birmingham 011G,E01009137,1077,703,374,117,78,179
2011,Birmingham 012A,E01009434,1148,888,260,125,60,75
2011,Birmingham 012B,E01009436,1046,766,280,173,49,58
2011,Birmingham 012C,E01009438,1133,849,284,170,45,69
2011,Birmingham 012D,E01009440,1100,801,299,191,40,68
2011,Birmingham 012E,E01009450,1181,894,287,181,54,52
2011,Birmingham 013A,E01009223,1170,832,338,195,44,99
2011,Birmingham 013B,E01009225,1046,703,343,182,44,117
2011,Birmingham 013C,E01009227,1203,923,280,166,43,71
2011,Birmingham 013D,E01009228,1174,851,323,169,43,111
2011,Birmingham 014A,E01009121,1559,1025,534,199,92,243
2011,Birmingham 014B,E01009122,1091,668,423,127,58,238
2011,Birmingham 014C,E01009129,1081,662,419,95,72,252
2011,Birmingham 014D,E01009132,1035,632,403,109,67,227
2011,Birmingham 014E,E01009136,1152,687,465,209,57,199
2011,Birmingham 015A,E01009457,1109,778,331,242,44,45
2011,Birmingham 015B,E01009459,1208,865,343,227,41,75
2011,Birmingham 015C,E01009461,996,694,302,209,39,54
2011,Birmingham 015D,E01009463,1091,754,337,239,37,61
2011,Birmingham 016A,E01009235,1184,826,358,181,74,103
2011,Birmingham 016B,E01009243,1093,769,324,160,55,109
2011,Birmingham 016C,E01009245,1034,746,288,145,51,92
2011,Birmingham 016D,E01009246,1170,815,355,189,66,100
2011,Birmingham 016E,E01009247,1084,811,273,127,68,78
2011,Birmingham 017A,E01009226,1071,776,295,142,42,111
2011,Birmingham 017B,E01009229,1162,841,321,171,64,86
2011,Birmingham 017C,E01009230,1118,792,326,176,51,99
2011,Birmingham 017D,E01009231,1354,963,391,213,80,98
2011,Birmingham 018A,E01009001,1145,818,327,158,38,131
2011,Birmingham 018B,E01009003,1248,850,398,189,74,135
2011,Birmingham 018C,E01009456,1190,917,273,152,62,59
2011,Birmingham 018D,E01009458,993,606,387,263,38,86
2011,Birmingham 018E,E01009460,1286,993,293,154,42,97
2011,Birmingham 018F,E01009462,1274,961,313,169,62,82
2011,Birmingham 019A,E01009234,1133,858,275,124,64,87
2011,Birmingham 019B,E01009236,1120,798,322,178,51,93
2011,Birmingham 019C,E01009244,1025,754,271,148,53,70
2011,Birmingham 019D,E01009248,1322,1000,322,154,63,105
2011,Birmingham 020A,E01009403,1055,707,348,114,71,163
2011,Birmingham 020B,E01009404,1089,741,348,107,58,183
2011,Birmingham 020C,E01009405,1000,680,320,140,41,139
2011,Birmingham 020D,E01009406,1155,773,382,147,55,180
2011,Birmingham 020E,E01009407,1243,822,421,139,63,219
2011,Birmingham 021A,E01009439,970,661,309,226,31,52
2011,Birmingham 021B,E01009441,1109,811,298,168,36,94
2011,Birmingham 021C,E01009442,1010,737,273,167,42,64
2011,Birmingham 021D,E01009443,935,716,219,150,17,52
2011,Birmingham 022A,E01009123,999,657,342,119,66,157
2011,Birmingham 022B,E01009124,1022,626,396,61,95,240
2011,Birmingham 022C,E01009125,1197,772,425,156,75,194
2011,Birmingham 022D,E01009232,1074,769,305,146,57,102
2011,Birmingham 023A,E01009002,968,593,375,101,60,214
2011,Birmingham 023C,E01009006,1190,948,242,113,35,94
2011,Birmingham 023D,E01009007,1191,881,310,101,70,139
2011,Birmingham 023F,E01033632,1549,1035,514,166,85,263
2011,Birmingham 024A,E01009237,1003,669,334,138,59,137
2011,Birmingham 024B,E01009238,1149,783,366,183,74,109
2011,Birmingham 024C,E01009240,1113,801,312,136,67,109
2011,Birmingham 024D,E01009241,1193,836,357,131,103,123
2011,Birmingham 024E,E01009242,1269,847,422,123,165,134
2011,Birmingham 025A,E01009005,971,671,300,136,39,125
2011,Birmingham 025B,E01009009,1094,794,300,157,41,102
2011,Birmingham 025C,E01009098,1479,1038,441,176,61,204
2011,Birmingham 025D,E01009100,1419,1022,397,169,69,159
2011,Birmingham 025E,E01009105,1177,827,350,176,49,125
2011,Birmingham 026A,E01009126,1018,759,259,119,62,78
2011,Birmingham 026B,E01009408,1217,811,406,126,94,186
2011,Birmingham 026C,E01009409,1168,815,353,119,73,161
2011,Birmingham 026D,E01009410,1270,863,407,143,79,185
2011,Birmingham 028A,E01009008,1072,768,304,146,61,97
2011,Birmingham 028B,E01009011,1291,918,373,200,50,123
2011,Birmingham 028C,E01009012,1093,805,288,128,73,87
2011,Birmingham 028D,E01009102,1048,697,351,134,54,163
2011,Birmingham 028E,E01009104,1050,692,358,98,65,195
2011,Birmingham 029A,E01009096,1171,749,422,159,44,219
2011,Birmingham 029B,E01009097,1345,795,550,174,87,289
2011,Birmingham 029C,E01009099,1217,792,425,118,60,247
2011,Birmingham 029D,E01009101,1053,649,404,158,70,176
2011,Birmingham 029E,E01009103,1043,621,422,178,62,182
2011,Birmingham 029F,E01009106,969,646,323,147,49,127
2011,Birmingham 030A,E01008915,929,614,315,72,73,170
2011,Birmingham 030B,E01009411,1391,1068,323,106,67,150
2011,Birmingham 030C,E01009412,1256,815,441,112,139,190
2011,Birmingham 030D,E01009413,1224,852,372,112,82,178
2011,Birmingham 030E,E01009414,1425,1026,399,84,90,225
2011,Birmingham 031A,E01008998,1222,778,444,125,107,212
2011,Birmingham 031B,E01008999,1128,698,430,124,111,195
2011,Birmingham 031C,E01009000,1315,908,407,115,74,218
2011,Birmingham 031D,E01009013,1427,997,430,125,88,217
2011,Birmingham 031E,E01009400,1045,661,384,110,63,211
2011,Birmingham 031F,E01009401,1185,745,440,82,138,220
2011,Birmingham 031H,E01033630,944,736,208,23,59,126
2011,Birmingham 031I,E01033646,1225,800,425,98,77,250
2011,Birmingham 032A,E01009049,1159,756,403,105,121,177
2011,Birmingham 032B,E01009056,1471,957,514,97,148,269
2011,Birmingham 032C,E01009263,1218,790,428,106,142,180
2011,Birmingham 032D,E01009264,1215,796,419,60,258,101
2011,Birmingham 032E,E01009265,1309,862,447,101,103,243
2011,Birmingham 033A,E01009051,1145,638,507,75,171,261
2011,Birmingham 033B,E01009053,966,519,447,61,142,244
2011,Birmingham 033C,E01009054,1132,645,487,101,125,261
2011,Birmingham 033D,E01009058,1101,626,475,58,138,279
2011,Birmingham 033E,E01009061,1199,652,547,87,139,321
2011,Birmingham 033F,E01009239,1593,856,737,73,545,119
2011,Birmingham 034A,E01009266,1252,847,405,96,117,192
2011,Birmingham 034B,E01009269,1041,698,343,69,81,193
2011,Birmingham 034C,E01009270,1348,832,516,93,157,266
2011,Birmingham 034D,E01009271,1030,666,364,91,82,191
2011,Birmingham 034E,E01009273,1126,713,413,105,87,221
2011,Birmingham 035A,E01009050,1314,805,509,103,164,242
2011,Birmingham 035D,E01009057,1323,734,589,96,155,338
2011,Birmingham 035E,E01009059,1176,633,543,83,162,298
2011,Birmingham 035F,E01009060,1049,587,462,80,120,262
2011,Birmingham 035G,E01033621,1976,1126,850,150,266,434
2011,Birmingham 036A,E01009268,1098,746,352,110,80,162
2011,Birmingham 036B,E01009272,958,624,334,58,117,159
2011,Birmingham 036C,E01009274,1506,976,530,112,160,258
2011,Birmingham 036D,E01009349,1118,696,422,60,95,267
2011,Birmingham 036E,E01009351,1139,722,417,85,98,234
2011,Birmingham 036F,E01009354,997,594,403,71,108,224
2011,Birmingham 037A,E01008899,818,467,351,84,66,201
2011,Birmingham 037C,E01008901,1122,627,495,117,100,278
2011,Birmingham 037E,E01008916,933,494,439,50,95,294
2011,Birmingham 037F,E01033636,2143,1097,1046,158,236,652
2011,Birmingham 038A,E01009079,1126,683,443,111,77,255
2011,Birmingham 038B,E01009080,712,449,263,46,47,170
2011,Birmingham 038C,E01009081,883,541,342,96,64,182
2011,Birmingham 038D,E01009083,903,554,349,98,79,172
2011,Birmingham 039A,E01009275,1060,650,410,77,105,228
2011,Birmingham 039B,E01009350,1027,611,416,67,94,255
2011,Birmingham 039C,E01009352,1173,667,506,101,125,280
2011,Birmingham 039D,E01009353,1121,632,489,95,118,276
2011,Birmingham 039E,E01009355,1119,672,447,77,133,237
2011,Birmingham 039H,E01033635,1987,1226,761,135,223,403
2011,Birmingham 040A,E01008905,1075,575,500,65,135,300
2011,Birmingham 040B,E01008907,1124,604,520,97,123,300
2011,Birmingham 040C,E01009047,1228,680,548,97,140,311
2011,Birmingham 040D,E01009048,1274,752,522,85,136,301
2011,Birmingham 040E,E01009062,1091,578,513,66,147,300
2011,Birmingham 041D,E01008909,989,592,397,68,119,210
2011,Birmingham 041F,E01033628,1550,813,737,132,143,462
2011,Birmingham 041G,E01033637,1821,948,873,146,210,517
2011,Birmingham 042A,E01009084,1126,700,426,119,103,204
2011,Birmingham 042B,E01009085,1278,750,528,119,134,275
2011,Birmingham 042C,E01009087,1053,674,379,178,66,135
2011,Birmingham 042D,E01009089,1008,645,363,130,67,166
2011,Birmingham 042E,E01009090,1217,740,477,116,115,246
2011,Birmingham 043A,E01009201,1153,659,494,149,93,252
2011,Birmingham 043B,E01009202,991,604,387,89,78,220
2011,Birmingham 043C,E01009203,1759,1010,749,121,198,430
2011,Birmingham 044A,E01009082,948,579,369,124,89,156
2011,Birmingham 044B,E01009086,1237,780,457,122,94,241
2011,Birmingham 044C,E01009480,1094,671,423,89,92,242
2011,Birmingham 044D,E01009481,1417,792,625,135,121,369
2011,Birmingham 044E,E01009486,1289,738,551,87,110,354
2011,Birmingham 044F,E01009487,1356,768,588,98,123,367
2011,Birmingham 045A,E01009088,1094,671,423,221,54,148
2011,Birmingham 045B,E01009091,1098,721,377,151,53,173
2011,Birmingham 045C,E01009305,1088,718,370,95,63,212
2011,Birmingham 045D,E01009307,1060,640,420,161,49,210
2011,Birmingham 045E,E01009309,961,589,372,126,39,207
2011,Birmingham 046A,E01009304,1255,846,409,166,50,193
2011,Birmingham 046B,E01009306,1078,678,400,175,51,174
2011,Birmingham 046C,E01009308,1244,796,448,127,74,247
2011,Birmingham 046D,E01009310,1250,805,445,133,70,242
2011,Birmingham 047A,E01009348,1427,984,443,124,119,200
2011,Birmingham 047B,E01009358,1476,855,621,102,152,367
2011,Birmingham 047C,E01009359,1404,827,577,99,139,339
2011,Birmingham 047D,E01009360,1675,1091,584,111,162,311
2011,Birmingham 047E,E01009361,1422,830,592,109,146,337
2011,Birmingham 048A,E01009478,1170,668,502,93,85,324
2011,Birmingham 048B,E01009479,1377,686,691,104,153,434
2011,Birmingham 048C,E01009482,1083,524,559,62,136,361
2011,Birmingham 048D,E01009484,1122,569,553,73,140,340
2011,Birmingham 048E,E01009485,1145,570,575,89,137,349
2011,Birmingham 049A,E01008906,1083,576,507,71,122,314
2011,Birmingham 049B,E01008911,1004,586,418,37,136,245
2011,Birmingham 049D,E01009347,1235,716,519,115,123,281
2011,Birmingham 049E,E01033559,1191,1023,168,8,107,53
2011,Birmingham 049F,E01033638,1098,639,459,87,127,245
2011,Birmingham 050A,E01008910,1149,637,512,59,146,307
2011,Birmingham 050B,E01008913,1035,644,391,91,104,196
2011,Birmingham 050C,E01008914,2141,1130,1011,50,660,301
2011,Birmingham 050E,E01033561,2686,1012,1674,59,1469,146
2011,Birmingham 050F,E01033617,2925,976,1949,7,1889,53
2011,Birmingham 051A,E01009194,1804,924,880,93,225,562
2011,Birmingham 051B,E01009483,1129,558,571,56,154,361
2011,Birmingham 051C,E01009488,1338,663,675,114,135,426
2011,Birmingham 051D,E01009489,1222,612,610,63,153,394
2011,Birmingham 051E,E01009491,1131,529,602,91,129,382
2011,Birmingham 052B,E01009192,1680,863,817,100,217,500
2011,Birmingham 052D,E01009199,1001,694,307,42,89,176
2011,Birmingham 052E,E01009204,1148,661,487,82,151,254
2011,Birmingham 052F,E01033644,1892,941,951,97,253,601
2011,Birmingham 053A,E01009151,1291,792,499,67,132,300
2011,Birmingham 053B,E01009152,1513,844,669,80,254,335
2011,Birmingham 053C,E01009153,1601,1028,573,87,241,245
2011,Birmingham 053D,E01009345,1696,731,965,94,98,773
2011,Birmingham 053E,E01009346,1104,648,456,61,122,273
2011,Birmingham 054A,E01009092,1039,646,393,92,63,238
2011,Birmingham 054B,E01009093,1059,703,356,97,43,216
2011,Birmingham 054C,E01009094,958,601,357,107,56,194
2011,Birmingham 054D,E01009298,1026,704,322,68,62,192
2011,Birmingham 054E,E01009311,1087,699,388,100,72,216
2011,Birmingham 054F,E01009511,952,536,416,98,82,236
2011,Birmingham 055A,E01009475,1249,684,565,100,135,330
2011,Birmingham 055B,E01009476,1134,569,565,88,113,364
2011,Birmingham 055C,E01009477,1108,642,466,86,110,270
2011,Birmingham 055D,E01009490,1269,746,523,99,93,331
2011,Birmingham 055E,E01009492,1088,568,520,91,114,315
2011,Birmingham 056A,E01009095,1183,770,413,156,71,186
2011,Birmingham 056B,E01009507,1038,608,430,130,81,219
2011,Birmingham 056C,E01009508,1103,755,348,150,59,139
2011,Birmingham 056D,E01009509,1234,791,443,114,98,231
2011,Birmingham 056E,E01009510,1035,584,451,163,67,221
2011,Birmingham 057A,E01009297,1168,729,439,209,52,178
2011,Birmingham 057B,E01009299,1101,739,362,107,56,199
2011,Birmingham 057C,E01009300,1224,783,441,119,89,233
2011,Birmingham 057D,E01009301,1117,696,421,127,54,240
2011,Birmingham 057E,E01009303,1068,715,353,160,34,159
2011,Birmingham 058A,E01009195,1579,809,770,96,203,471
2011,Birmingham 058C,E01009197,1025,559,466,65,113,288
2011,Birmingham 058D,E01009198,997,497,500,42,164,294
2011,Birmingham 058E,E01033647,810,448,362,58,80,224
2011,Birmingham 058F,E01033649,1027,566,461,59,116,286
2011,Birmingham 060A,E01009138,1223,811,412,91,139,182
2011,Birmingham 060B,E01009139,1194,852,342,102,107,133
2011,Birmingham 060C,E01009140,1509,986,523,170,183,170
2011,Birmingham 060D,E01009145,1475,1015,460,123,142,195
2011,Birmingham 060E,E01009147,1297,957,340,81,93,166
2011,Birmingham 062A,E01009512,1127,756,371,136,68,167
2011,Birmingham 062B,E01009514,996,610,386,100,54,232
2011,Birmingham 062C,E01009516,983,651,332,135,53,144
2011,Birmingham 062D,E01009517,1180,824,356,120,62,174
2011,Birmingham 063A,E01009325,1076,578,498,78,136,284
2011,Birmingham 063D,E01009342,1119,633,486,97,128,261
2011,Birmingham 063E,E01009343,1094,586,508,66,144,298
2011,Birmingham 063F,E01033642,1910,972,938,137,257,544
2011,Birmingham 064A,E01008986,1438,1057,381,79,154,148
2011,Birmingham 064B,E01008987,1296,760,536,87,315,134
2011,Birmingham 064C,E01008988,1727,1255,472,67,174,231
2011,Birmingham 064D,E01008989,1411,987,424,115,167,142
2011,Birmingham 064E,E01008990,922,615,307,84,171,52
2011,Birmingham 064F,E01008991,1071,740,331,194,57,80
2011,Birmingham 066A,E01008882,1150,683,467,123,58,286
2011,Birmingham 066B,E01008896,1038,629,409,101,78,230
2011,Birmingham 066C,E01008898,1076,671,405,92,86,227
2011,Birmingham 066D,E01009326,1193,682,511,92,112,307
2011,Birmingham 066E,E01009341,1007,543,464,83,107,274
2011,Birmingham 066F,E01009513,1122,702,420,94,97,229
2011,Birmingham 067A,E01008881,1057,679,378,125,69,184
2011,Birmingham 067B,E01008897,1179,764,415,135,82,198
2011,Birmingham 067C,E01009515,1080,671,409,175,54,180
2011,Birmingham 067D,E01009518,1156,796,360,171,67,122
2011,Birmingham 067E,E01009521,1197,911,286,137,48,101
2011,Birmingham 069A,E01009302,1067,716,351,223,32,96
2011,Birmingham 069B,E01009314,1082,710,372,180,50,142
2011,Birmingham 069C,E01009321,1179,671,508,157,65,286
2011,Birmingham 069D,E01009322,956,616,340,95,40,205
2011,Birmingham 069E,E01009323,1021,656,365,125,68,172
2011,Birmingham 070A,E01009329,1548,779,769,96,201,472
2011,Birmingham 070B,E01009334,1204,621,583,105,141,337
2011,Birmingham 070C,E01009337,1107,607,500,75,129,296
2011,Birmingham 070D,E01009338,1014,541,473,66,108,299
2011,Birmingham 070E,E01009380,1028,516,512,71,106,335
2011,Birmingham 071A,E01009362,878,469,409,63,120,226
2011,Birmingham 071B,E01009363,1063,570,493,112,105,276
2011,Birmingham 071C,E01009364,872,504,368,47,76,245
2011,Birmingham 071D,E01009365,1196,609,587,82,149,356
2011,Birmingham 071E,E01009379,1104,503,601,163,110,328
2011,Birmingham 072A,E01009312,1126,821,305,186,43,76
2011,Birmingham 072B,E01009324,1178,829,349,212,38,99
2011,Birmingham 072C,E01009519,1105,800,305,181,37,87
2011,Birmingham 072D,E01009520,1260,933,327,184,51,92
2011,Birmingham 073A,E01009066,1136,830,306,174,72,60
2011,Birmingham 073B,E01009070,1172,893,279,153,56,70
2011,Birmingham 073C,E01009252,1180,874,306,141,103,62
2011,Birmingham 073D,E01009260,1106,750,356,199,76,81
2011,Birmingham 073E,E01009261,1162,860,302,177,57,68
2011,Birmingham 074A,E01008984,1742,787,955,141,608,206
2011,Birmingham 074B,E01008994,1365,876,489,123,264,102
2011,Birmingham 074C,E01008996,1009,556,453,120,119,214
2011,Birmingham 074D,E01008997,1073,718,355,140,89,126
2011,Birmingham 075A,E01009065,1291,970,321,131,87,103
2011,Birmingham 075B,E01009067,1064,836,228,98,71,59
2011,Birmingham 075C,E01009068,1213,947,266,67,142,57
2011,Birmingham 075D,E01009069,1296,1022,274,106,93,75
2011,Birmingham 075E,E01009072,1291,968,323,119,88,116
2011,Birmingham 076A,E01008885,933,697,236,118,39,79
2011,Birmingham 076B,E01008886,1137,808,329,169,32,128
2011,Birmingham 076C,E01008888,1194,904,290,132,59,99
2011,Birmingham 076D,E01009313,1112,788,324,172,55,97
2011,Birmingham 077A,E01009368,997,504,493,73,124,296
2011,Birmingham 077D,E01009371,1144,537,607,54,201,352
2011,Birmingham 077E,E01009397,1114,549,565,60,144,361
2011,Birmingham 077F,E01033650,1635,759,876,123,208,545
2011,Birmingham 078A,E01008883,1251,783,468,112,96,260
2011,Birmingham 078B,E01008884,1216,823,393,69,74,250
2011,Birmingham 078C,E01008887,1048,704,344,115,50,179
2011,Birmingham 078D,E01008889,1275,800,475,153,60,262
2011,Birmingham 079A,E01008982,1166,821,345,76,194,75
2011,Birmingham 079C,E01008992,1501,797,704,106,532,66
2011,Birmingham 079E,E01009283,1150,769,381,97,177,107
2011,Birmingham 079F,E01033631,4484,1731,2753,127,2505,121
2011,Birmingham 080A,E01009249,1087,806,281,144,44,93
2011,Birmingham 080B,E01009250,1206,826,380,222,44,114
2011,Birmingham 080C,E01009251,1110,810,300,173,50,77
2011,Birmingham 080D,E01009253,1111,792,319,161,54,104
2011,Birmingham 080E,E01009255,1082,744,338,121,74,143
2011,Birmingham 080F,E01009257,1027,673,354,129,63,162
2011,Birmingham 081A,E01009315,1160,752,408,235,35,138
2011,Birmingham 081B,E01009316,1180,857,323,148,48,127
2011,Birmingham 081C,E01009317,1176,790,386,166,57,163
2011,Birmingham 081D,E01009318,1135,858,277,175,37,65
2011,Birmingham 081E,E01009319,1215,917,298,166,48,84
2011,Birmingham 081F,E01009320,1138,789,349,203,62,84
2011,Birmingham 082A,E01009372,1143,582,561,57,150,354
2011,Birmingham 082B,E01009373,1170,531,639,64,174,401
2011,Birmingham 082D,E01009396,1451,733,718,104,185,429
2011,Birmingham 082F,E01033643,1956,955,1001,132,230,639
2011,Birmingham 083A,E01009367,1106,575,531,89,104,338
2011,Birmingham 083B,E01009375,1223,582,641,90,156,395
2011,Birmingham 083C,E01009377,837,416,421,67,90,264
2011,Birmingham 083D,E01009383,1031,543,488,74,155,259
2011,Birmingham 083E,E01009399,978,496,482,49,148,285
2011,Birmingham 084A,E01009366,1006,547,459,95,109,255
2011,Birmingham 084B,E01009374,735,378,357,78,73,206
2011,Birmingham 084C,E01009376,1086,571,515,59,160,296
2011,Birmingham 084F,E01033648,1802,996,806,113,210,483
2011,Birmingham 085A,E01009073,1013,588,425,72,90,263
2011,Birmingham 085B,E01009074,1143,730,413,99,99,215
2011,Birmingham 085C,E01009254,1111,771,340,138,87,115
2011,Birmingham 085D,E01009256,1101,777,324,123,68,133
2011,Birmingham 085E,E01009258,1045,647,398,150,70,178
2011,Birmingham 087B,E01009071,1176,745,431,185,113,133
2011,Birmingham 087C,E01009075,1266,674,592,136,301,155
2011,Birmingham 087E,E01009078,1183,664,519,103,308,108
2011,Birmingham 087F,E01033562,1992,1080,912,200,495,217
2011,Birmingham 088C,E01009183,1208,867,341,101,104,136
2011,Birmingham 088D,E01009186,1268,942,326,111,78,137
2011,Birmingham 088E,E01033645,2386,1235,1151,142,384,625
2011,Birmingham 089A,E01008890,1239,903,336,109,62,165
2011,Birmingham 089B,E01008891,1156,848,308,143,56,109
2011,Birmingham 089C,E01008892,1089,676,413,98,79,236
2011,Birmingham 089D,E01008893,1303,946,357,111,70,176
2011,Birmingham 089E,E01008894,1000,676,324,140,50,134
2011,Birmingham 089F,E01008895,1378,1067,311,117,60,134
2011,Birmingham 089G,E01009015,1270,908,362,148,75,139
2011,Birmingham 090A,E01009014,1337,834,503,112,121,270
2011,Birmingham 090B,E01009018,1215,796,419,173,77,169
2011,Birmingham 090C,E01009026,1017,615,402,92,61,249
2011,Birmingham 090D,E01009028,1111,689,422,93,72,257
2011,Birmingham 090E,E01009029,992,646,346,90,66,190
2011,Birmingham 092A,E01009182,1265,809,456,75,96,285
2011,Birmingham 092B,E01009184,1269,966,303,112,78,113
2011,Birmingham 092C,E01009187,1192,810,382,156,101,125
2011,Birmingham 092D,E01009188,1163,831,332,144,71,117
2011,Birmingham 092E,E01009384,1061,708,353,82,95,176
2011,Birmingham 092F,E01009385,1026,742,284,72,53,159
2011,Birmingham 093A,E01009185,1237,916,321,127,87,107
2011,Birmingham 093B,E01009389,1264,692,572,135,157,280
2011,Birmingham 093C,E01009390,1235,802,433,86,102,245
2011,Birmingham 093D,E01009394,1333,935,398,121,93,184
2011,Birmingham 094A,E01008918,1167,713,454,176,67,211
2011,Birmingham 094B,E01008920,1025,732,293,167,41,85
2011,Birmingham 094C,E01008921,1052,725,327,145,42,140
2011,Birmingham 094D,E01008931,990,637,353,129,44,180
2011,Birmingham 094E,E01009259,1104,658,446,153,70,223
2011,Birmingham 095A,E01008919,1148,766,382,149,72,161
2011,Birmingham 095B,E01009064,1055,720,335,135,68,132
2011,Birmingham 095C,E01009077,1186,794,392,169,96,127
2011,Birmingham 095D,E01009291,1090,733,357,107,86,164
2011,Birmingham 095E,E01009500,1068,626,442,145,84,213
2011,Birmingham 096A,E01009284,2060,797,1263,85,1094,84
2011,Birmingham 096C,E01009286,2075,693,1382,32,1309,41
2011,Birmingham 096E,E01009289,1993,697,1296,33,1216,47
2011,Birmingham 096F,E01009290,1922,637,1285,21,1228,36
2011,Birmingham 096G,E01033634,3871,1076,2795,21,2699,75
2011,Birmingham 097A,E01009017,1120,698,422,93,109,220
2011,Birmingham 097B,E01009043,1356,788,568,116,153,299
2011,Birmingham 097C,E01009044,1051,595,456,92,117,247
2011,Birmingham 097D,E01009045,1140,688,452,135,105,212
2011,Birmingham 097E,E01009046,1240,797,443,177,91,175
2011,Birmingham 097F,E01009395,1192,707,485,124,114,247
2011,Birmingham 098A,E01009016,1076,670,406,175,58,173
2011,Birmingham 098B,E01009022,1244,836,408,110,96,202
2011,Birmingham 098C,E01009023,1139,832,307,128,59,120
2011,Birmingham 098D,E01009030,1045,691,354,118,89,147
2011,Birmingham 099A,E01009281,983,650,333,200,62,71
2011,Birmingham 099B,E01009292,1265,868,397,142,163,92
2011,Birmingham 099C,E01009294,1325,886,439,168,109,162
2011,Birmingham 099D,E01009295,1371,782,589,162,347,80
2011,Birmingham 100A,E01009280,983,684,299,94,120,85
2011,Birmingham 100B,E01009282,1312,787,525,116,199,210
2011,Birmingham 100C,E01009288,871,517,354,149,120,85
2011,Birmingham 100D,E01009293,1210,758,452,86,281,85
2011,Birmingham 100E,E01009296,1240,795,445,93,216,136
2011,Birmingham 101A,E01008924,1000,708,292,145,37,110
2011,Birmingham 101B,E01009501,1084,716,368,100,75,193
2011,Birmingham 101C,E01009502,1015,687,328,120,52,156
2011,Birmingham 101D,E01009503,1101,731,370,124,76,170
2011,Birmingham 101E,E01009505,1112,727,385,120,83,182
2011,Birmingham 102A,E01008917,1008,733,275,132,58,85
2011,Birmingham 102B,E01008923,905,575,330,107,35,188
2011,Birmingham 102C,E01008925,1035,734,301,187,45,69
2011,Birmingham 102D,E01008927,1013,657,356,133,53,170
2011,Birmingham 102E,E01008928,1025,628,397,146,56,195
2011,Birmingham 103A,E01009019,1088,691,397,93,82,222
2011,Birmingham 103B,E01009020,1076,694,382,130,68,184
2011,Birmingham 103C,E01009021,1102,695,407,114,71,222
2011,Birmingham 103D,E01009024,1086,700,386,109,72,205
2011,Birmingham 103E,E01009025,1047,673,374,110,81,183
2011,Birmingham 103F,E01009033,1202,801,401,91,58,252
2011,Birmingham 104A,E01009175,1140,883,257,99,75,83
2011,Birmingham 104B,E01009177,1179,886,293,109,62,122
2011,Birmingham 104C,E01009178,1191,902,289,101,55,133
2011,Birmingham 104D,E01009179,1255,903,352,158,80,114
2011,Birmingham 104E,E01009189,1098,825,273,112,59,102
2011,Birmingham 105A,E01008933,1104,749,355,116,90,149
2011,Birmingham 105B,E01008934,997,670,327,156,55,116
2011,Birmingham 105C,E01009031,1176,784,392,172,80,140
2011,Birmingham 105D,E01009037,1160,762,398,218,54,126
2011,Birmingham 105E,E01009176,1187,777,410,170,89,151
2011,Birmingham 106C,E01008929,1005,639,366,108,63,195
2011,Birmingham 106D,E01008930,1073,805,268,81,62,125
2011,Birmingham 106E,E01009495,819,513,306,98,55,153
2011,Birmingham 106F,E01033629,1875,1211,664,239,174,251
2011,Birmingham 107A,E01008953,1165,802,363,132,76,155
2011,Birmingham 107B,E01008963,1003,709,294,106,63,125
2011,Birmingham 107C,E01008964,1019,695,324,124,61,139
2011,Birmingham 107D,E01008965,1123,858,265,132,44,89
2011,Birmingham 107E,E01008966,1167,746,421,119,95,207
2011,Birmingham 108A,E01009032,1258,871,387,150,90,147
2011,Birmingham 108B,E01009034,1173,805,368,135,95,138
2011,Birmingham 108C,E01009035,1278,873,405,151,85,169
2011,Birmingham 108D,E01009036,1099,745,354,185,55,114
2011,Birmingham 109A,E01009494,982,593,389,88,85,216
2011,Birmingham 109B,E01009496,1052,742,310,183,50,77
2011,Birmingham 109C,E01009497,1202,868,334,125,81,128
2011,Birmingham 109D,E01009504,973,640,333,188,57,88
2011,Birmingham 109E,E01009506,1075,692,383,238,74,71
2011,Birmingham 110A,E01008967,1225,818,407,235,73,99
2011,Birmingham 110B,E01008968,1183,858,325,179,66,80
2011,Birmingham 110C,E01008970,1069,669,400,197,62,141
2011,Birmingham 110D,E01008981,1111,756,355,184,63,108
2011,Birmingham 111A,E01008932,1094,683,411,139,82,190
2011,Birmingham 111B,E01008935,1131,673,458,112,74,272
2011,Birmingham 111C,E01008936,1102,730,372,149,76,147
2011,Birmingham 111D,E01008938,1094,694,400,104,93,203
2011,Birmingham 111E,E01008939,1092,740,352,136,59,157
2011,Birmingham 112A,E01008951,1001,747,254,129,60,65
2011,Birmingham 112B,E01008952,1302,1008,294,101,72,121
2011,Birmingham 112C,E01008955,1200,904,296,130,68,98
2011,Birmingham 112D,E01008956,1029,737,292,121,72,99
2011,Birmingham 112E,E01008957,1277,965,312,89,65,158
2011,Birmingham 113A,E01008950,1044,602,442,252,51,139
2011,Birmingham 113B,E01008954,979,606,373,235,48,90
2011,Birmingham 113C,E01008958,1099,665,434,209,66,159
2011,Birmingham 113D,E01009493,1156,761,395,70,101,224
2011,Birmingham 115A,E01008937,1028,644,384,144,77,163
2011,Birmingham 115B,E01008940,996,661,335,126,45,164
2011,Birmingham 115C,E01008941,1022,643,379,138,61,180
2011,Birmingham 115D,E01008944,1216,817,399,162,47,190
2011,Birmingham 116A,E01008959,1166,813,353,200,61,92
2011,Birmingham 116B,E01008960,1169,909,260,107,69,84
2011,Birmingham 116C,E01008961,1145,854,291,148,62,81
2011,Birmingham 116D,E01008962,1345,849,496,172,100,224
2011,Birmingham 117A,E01008942,1125,777,348,112,79,157
2011,Birmingham 117B,E01008943,1053,698,355,118,52,185
2011,Birmingham 117C,E01008969,1175,890,285,136,53,96
2011,Birmingham 117D,E01008971,1226,891,335,160,72,103
2011,Birmingham 118A,E01008972,1269,809,460,145,100,215
2011,Birmingham 118B,E01008973,1410,1035,375,167,60,148
2011,Birmingham 118C,E01008974,2060,1584,476,194,106,176
2011,Birmingham 118D,E01008975,1159,828,331,177,41,113
2011,Birmingham 119A,E01009172,965,648,317,95,70,152
2011,Birmingham 119B,E01009173,1201,785,416,100,83,233
2011,Birmingham 119C,E01009174,883,618,265,87,48,130
2011,Birmingham 119D,E01009498,1152,759,393,117,57,219
2011,Birmingham 119E,E01009499,1251,843,408,132,88,188
2011,Birmingham 120A,E01009205,1107,805,302,172,54,76
2011,Birmingham 120B,E01009206,1180,827,353,192,75,86
2011,Birmingham 120C,E01009211,1164,905,259,155,41,63
2011,Birmingham 120D,E01009218,1039,728,311,172,56,83
2011,Birmingham 120E,E01009219,1071,771,300,118,63,119
2011,Birmingham 121A,E01008976,1062,676,386,168,47,171
2011,Birmingham 121B,E01008978,940,523,417,113,55,249
2011,Birmingham 121C,E01008979,1148,713,435,158,61,216
2011,Birmingham 121D,E01008980,1109,656,453,149,67,237
2011,Birmingham 122A,E01008945,1320,979,341,132,60,149
2011,Birmingham 122B,E01008946,1065,756,309,133,48,128
2011,Birmingham 122C,E01008947,991,743,248,109,49,90
2011,Birmingham 122D,E01008948,1050,759,291,176,37,78
2011,Birmingham 122E,E01008949,949,719,230,152,32,46
2011,Birmingham 123A,E01008977,1154,863,291,128,45,118
2011,Birmingham 123B,E01009109,815,482,333,51,56,226
2011,Birmingham 123C,E01009119,1042,733,309,183,50,76
2011,Birmingham 123D,E01009120,1043,757,286,159,46,81
2011,Birmingham 124A,E01009162,1172,842,330,171,45,114
2011,Birmingham 124B,E01009207,1215,889,326,180,53,93
2011,Birmingham 124C,E01009208,1126,866,260,149,47,64
2011,Birmingham 124D,E01009209,1583,1144,439,198,82,159
2011,Birmingham 124E,E01009213,1088,671,417,222,59,136
2011,Birmingham 125B,E01009155,1006,599,407,140,45,222
2011,Birmingham 125D,E01009157,1075,633,442,161,75,206
2011,Birmingham 125E,E01009160,1124,687,437,103,55,279
2011,Birmingham 125F,E01009161,1032,667,365,159,48,158
2011,Birmingham 125G,E01033633,1689,1066,623,208,104,311
2011,Birmingham 126A,E01009117,1281,766,515,96,100,319
2011,Birmingham 126B,E01009210,1334,947,387,158,80,149
2011,Birmingham 126C,E01009212,1183,802,381,151,58,172
2011,Birmingham 126D,E01009214,1154,742,412,147,57,208
2011,Birmingham 126E,E01009215,1217,781,436,148,47,241
2011,Birmingham 127A,E01009108,960,652,308,186,44,78
2011,Birmingham 127B,E01009111,1069,787,282,142,48,92
2011,Birmingham 127C,E01009112,997,659,338,153,39,146
2011,Birmingham 127D,E01009116,1023,676,347,219,53,75
2011,Birmingham 127E,E01009118,1110,719,391,186,65,140
2011,Birmingham 128A,E01009107,1186,743,443,111,69,263
2011,Birmingham 128B,E01009110,1134,747,387,123,77,187
2011,Birmingham 128C,E01009113,970,535,435,152,57,226
2011,Birmingham 128D,E01009114,1124,687,437,195,53,189
2011,Birmingham 128E,E01009115,1027,600,427,181,68,178
2011,Birmingham 129A,E01009158,1326,944,382,114,48,220
2011,Birmingham 129B,E01009163,1053,687,366,169,60,137
2011,Birmingham 129C,E01009165,969,680,289,96,55,138
2011,Birmingham 129D,E01009169,1167,862,305,130,61,114
2011,Birmingham 130A,E01009159,1301,992,309,145,59,105
2011,Birmingham 130B,E01009164,1088,796,292,145,39,108
2011,Birmingham 130C,E01009167,1101,831,270,115,56,99
2011,Birmingham 130D,E01009171,1120,791,329,142,51,136
2011,Birmingham 131A,E01009166,946,699,247,105,40,102
2011,Birmingham 131B,E01009168,1124,794,330,191,39,100
2011,Birmingham 131C,E01009170,1095,816,279,152,49,78
2011,Birmingham 131D,E01009216,1417,978,439,207,79,153
2011,Birmingham 131E,E01009217,1203,850,353,216,60,77
2011,Birmingham 132A,E01009039,1214,854,360,191,75,94
2011,Birmingham 132B,E01009040,1234,902,332,152,65,115
2011,Birmingham 132C,E01009041,1182,887,295,141,50,104
2011,Birmingham 132D,E01009042,996,760,236,115,35,86
2011,Birmingham 132E,E01032589,987,685,302,137,66,99
2011,Birmingham 133A,E01009262,1329,995,334,97,102,135
2011,Birmingham 133B,E01009267,1285,892,393,156,100,137
2011,Birmingham 133C,E01009276,1184,829,355,129,94,132
2011,Birmingham 133D,E01009278,1269,917,352,116,123,113
2011,Birmingham 133E,E01009279,1091,766,325,100,82,143
2011,Birmingham 133F,E01032591,1228,843,385,144,107,134
2011,Birmingham 134A,E01008995,1414,757,657,112,319,226
2011,Birmingham 134B,E01033557,1995,1389,606,18,543,45
2011,Birmingham 134C,E01033624,786,576,210,42,108,60
2011,Birmingham 134D,E01033626,862,596,266,30,143,93
2011,Birmingham 134E,E01033640,885,576,309,59,83,167
2011,Birmingham 135A,E01009378,1650,1192,458,117,158,183
2011,Birmingham 135B,E01033567,1125,734,391,13,333,45
2011,Birmingham 135C,E01033615,970,718,252,3,219,30
2011,Birmingham 135D,E01033616,934,633,301,39,131,131
2011,Birmingham 136A,E01009143,978,603,375,63,96,216
2011,Birmingham 136B,E01009146,1730,901,829,89,542,198
2011,Birmingham 136C,E01033564,1136,880,256,19,185,52
2011,Birmingham 136D,E01033639,1351,912,439,52,170,217
2011,Birmingham 137A,E01009141,1258,797,461,126,98,237
2011,Birmingham 137B,E01033565,993,842,151,10,121,20
2011,Birmingham 137C,E01033618,1128,951,177,24,114,39
2011,Birmingham 137D,E01033619,989,817,172,25,85,62
2011,Birmingham 137E,E01033627,842,595,247,48,81,118
2011,Birmingham 138A,E01033620,985,602,383,13,327,43
2011,Birmingham 138B,E01033622,1641,1240,401,26,309,66
2011,Birmingham 138C,E01033623,1080,834,246,12,134,100
2011,Birmingham 138D,E01033625,1632,1176,456,7,378,71
2011,Birmingham 139A,E01009200,1179,741,438,57,116,265
2011,Birmingham 139B,E01009327,946,463,483,69,115,299
2011,Birmingham 139C,E01009328,1508,755,753,113,185,455
2011,Birmingham 139D,E01009331,1327,693,634,102,152,380
2011,Birmingham 139E,E01009332,1102,584,518,91,123,304
2011,Birmingham 139F,E01009333,969,484,485,40,109,336
2011,Birmingham 139G,E01009335,1185,618,567,92,147,328
2011,Birmingham 139H,E01009344,958,508,450,53,135,262
2011,Birmingham 140A,E01009339,944,499,445,78,109,258
2011,Birmingham 140B,E01009340,1766,1126,640,92,144,404
2011,Birmingham 140C,E01009382,1225,605,620,113,153,354
2011,Birmingham 140D,E01009391,1041,582,459,74,103,282
2011,Birmingham 140E,E01009392,1218,676,542,100,151,291
2011,Birmingham 140F,E01009393,1001,534,467,60,115,292
2011,Birmingham 140G,E01033641,2099,1156,943,158,222,563
2011,Coventry 001A,E01009589,1038,759,279,125,44,110
2011,Coventry 001F,E01032536,1417,1056,361,152,47,162
2011,Coventry 001G,E01032537,1449,933,516,263,68,185
2011,Coventry 001H,E01032538,1584,1096,488,185,72,231
2011,Coventry 002A,E01009590,953,676,277,131,47,99
2011,Coventry 002B,E01009591,1117,829,288,113,53,122
2011,Coventry 002C,E01009593,1191,848,343,187,45,111
2011,Coventry 002D,E01009598,1165,797,368,224,54,90
2011,Coventry 004A,E01009604,1032,690,342,131,54,157
2011,Coventry 004B,E01009605,1057,654,403,136,63,204
2011,Coventry 004C,E01009607,1097,666,431,121,34,276
2011,Coventry 004D,E01009608,1080,745,335,131,60,144
2011,Coventry 004E,E01009610,1040,676,364,149,71,144
2011,Coventry 005A,E01009564,1079,658,421,79,81,261
2011,Coventry 005B,E01009575,882,586,296,62,56,178
2011,Coventry 005C,E01009606,999,712,287,130,43,114
2011,Coventry 005D,E01009609,1044,707,337,104,53,180
2011,Coventry 006A,E01009524,1013,694,319,153,42,124
2011,Coventry 006B,E01009525,1001,702,299,154,54,91
2011,Coventry 006C,E01009527,1163,891,272,128,51,93
2011,Coventry 006D,E01009594,1020,752,268,157,38,73
2011,Coventry 007A,E01009577,845,498,347,80,60,207
2011,Coventry 007B,E01009579,1104,650,454,121,71,262
2011,Coventry 007C,E01009581,1037,625,412,134,73,205
2011,Coventry 007D,E01009584,978,657,321,171,36,114
2011,Coventry 007E,E01009585,655,366,289,45,66,178
2011,Coventry 007F,E01009709,675,380,295,71,55,169
2011,Coventry 008A,E01009576,1149,881,268,135,33,100
2011,Coventry 008B,E01009578,1112,838,274,162,40,72
2011,Coventry 008C,E01009582,1258,944,314,162,42,110
2011,Coventry 008D,E01009583,1139,795,344,176,50,118
2011,Coventry 008E,E01009586,1210,873,337,193,60,84
2011,Coventry 009A,E01009565,1079,600,479,90,102,287
2011,Coventry 009B,E01009566,1074,655,419,54,123,242
2011,Coventry 009C,E01009567,1236,713,523,102,118,303
2011,Coventry 009D,E01009568,1195,713,482,85,120,277
2011,Coventry 010A,E01009523,1128,746,382,273,52,57
2011,Coventry 010B,E01009526,1126,810,316,183,63,70
2011,Coventry 010C,E01009528,1137,776,361,255,45,61
2011,Coventry 010D,E01009531,1069,718,351,231,47,73
2011,Coventry 011A,E01009587,1073,719,354,108,72,174
2011,Coventry 011B,E01009624,1140,808,332,100,80,152
2011,Coventry 011C,E01009625,1659,1170,489,171,108,210
2011,Coventry 011D,E01009626,1162,845,317,120,60,137
2011,Coventry 012A,E01009622,1175,779,396,101,74,221
2011,Coventry 012B,E01009623,1097,737,360,136,54,170
2011,Coventry 012C,E01009627,1158,809,349,121,65,163
2011,Coventry 012D,E01009628,1079,777,302,139,65,98
2011,Coventry 013A,E01009599,901,576,325,194,27,104
2011,Coventry 013B,E01009663,990,624,366,231,37,98
2011,Coventry 013C,E01009710,1028,764,264,152,47,65
2011,Coventry 013D,E01009711,946,652,294,163,43,88
2011,Coventry 014A,E01009522,981,644,337,206,35,96
2011,Coventry 014B,E01009529,1135,862,273,145,65,63
2011,Coventry 014C,E01009530,983,760,223,111,39,73
2011,Coventry 014D,E01009645,1065,809,256,127,40,89
2011,Coventry 015A,E01009569,896,556,340,60,71,209
2011,Coventry 015B,E01009570,1265,702,563,114,128,321
2011,Coventry 015C,E01009571,1074,616,458,99,88,271
2011,Coventry 015D,E01009572,1452,870,582,82,140,360
2011,Coventry 015E,E01009573,1063,587,476,72,129,275
2011,Coventry 015F,E01009574,1086,594,492,94,113,285
2011,Coventry 016A,E01009655,1309,921,388,124,87,177
2011,Coventry 016B,E01009656,1156,761,395,137,72,186
2011,Coventry 016C,E01009659,1278,830,448,88,113,247
2011,Coventry 016D,E01009662,1115,770,345,140,56,149
2011,Coventry 016E,E01009664,1077,768,309,119,62,128
2011,Coventry 017A,E01009643,1086,860,226,129,37,60
2011,Coventry 017B,E01009644,1214,914,300,161,55,84
2011,Coventry 017C,E01009647,1272,948,324,150,72,102
2011,Coventry 017D,E01009648,1103,857,246,132,46,68
2011,Coventry 017E,E01009652,993,722,271,177,34,60
2011,Coventry 017F,E01009653,1063,794,269,154,33,82
2011,Coventry 018A,E01009613,968,724,244,121,60,63
2011,Coventry 018B,E01009657,1228,897,331,136,74,121
2011,Coventry 018C,E01009712,1117,838,279,134,51,94
2011,Coventry 018D,E01009714,1075,827,248,114,56,78
2011,Coventry 018E,E01009716,1185,897,288,117,54,117
2011,Coventry 019A,E01009580,873,586,287,179,33,75
2011,Coventry 019B,E01009713,1008,756,252,121,49,82
2011,Coventry 019C,E01009715,1003,706,297,125,59,113
2011,Coventry 019D,E01009717,1087,789,298,152,44,102
2011,Coventry 019E,E01009718,1237,784,453,182,74,197
2011,Coventry 020A,E01009629,2052,1435,617,121,226,270
2011,Coventry 020B,E01009630,1219,838,381,102,113,166
2011,Coventry 020C,E01009631,968,601,367,108,96,163
2011,Coventry 020D,E01009632,1368,822,546,124,190,232
2011,Coventry 020E,E01009650,1427,867,560,66,391,103
2011,Coventry 021A,E01009614,1041,762,279,124,56,99
2011,Coventry 021B,E01009654,1268,987,281,128,62,91
2011,Coventry 021C,E01009658,1126,817,309,128,62,119
2011,Coventry 021D,E01009660,1322,939,383,112,120,151
2011,Coventry 022A,E01009646,1113,844,269,138,39,92
2011,Coventry 022B,E01009692,861,554,307,227,28,52
2011,Coventry 022C,E01009693,1052,771,281,192,25,64
2011,Coventry 022D,E01009694,974,716,258,165,40,53
2011,Coventry 023A,E01009695,1093,712,381,296,20,65
2011,Coventry 023B,E01009696,1095,762,333,251,29,53
2011,Coventry 023C,E01009704,1186,818,368,246,55,67
2011,Coventry 023D,E01009705,1115,781,334,252,34,48
2011,Coventry 024A,E01009636,1770,1100,670,70,363,237
2011,Coventry 024B,E01009637,963,521,442,61,125,256
2011,Coventry 024C,E01009638,1075,550,525,74,154,297
2011,Coventry 024D,E01009639,1195,679,516,107,130,279
2011,Coventry 024E,E01009640,1242,725,517,69,155,293
2011,Coventry 024F,E01009641,2501,1119,1382,82,1054,246
2011,Coventry 025A,E01009697,1076,759,317,228,30,59
2011,Coventry 025B,E01009698,1133,825,308,211,43,54
2011,Coventry 025C,E01009703,1928,1527,401,136,93,172
2011,Coventry 025D,E01009706,1080,754,326,226,40,60
2011,Coventry 026A,E01009649,1016,745,271,115,83,73
2011,Coventry 026B,E01009684,1055,731,324,132,49,143
2011,Coventry 026C,E01009685,1221,905,316,174,45,97
2011,Coventry 026D,E01009686,1239,937,302,136,91,75
2011,Coventry 026E,E01009687,1073,813,260,120,85,55
2011,Coventry 027A,E01009615,1363,940,423,132,174,117
2011,Coventry 027B,E01009616,1139,848,291,115,89,87
2011,Coventry 027C,E01009617,913,673,240,103,53,84
2011,Coventry 027D,E01009618,1121,862,259,121,56,82
2011,Coventry 027E,E01009620,1019,734,285,134,55,96
2011,Coventry 027F,E01009621,981,672,309,119,69,121
2011,Coventry 028A,E01009633,1425,894,531,80,311,140
2011,Coventry 028B,E01009634,1387,846,541,78,341,122
2011,Coventry 028C,E01009635,2935,1386,1549,60,1336,153
2011,Coventry 028D,E01009661,1473,942,531,93,282,156
2011,Coventry 029A,E01009674,1180,739,441,115,166,160
2011,Coventry 029B,E01009699,1005,685,320,214,19,87
2011,Coventry 029C,E01009700,1212,760,452,138,71,243
2011,Coventry 029D,E01009701,1091,752,339,146,46,147
2011,Coventry 029E,E01009702,1039,677,362,123,59,180
2011,Coventry 030A,E01009688,1231,708,523,86,356,81
2011,Coventry 030B,E01009689,1295,855,440,49,305,86
2011,Coventry 030C,E01009690,1235,747,488,83,333,72
2011,Coventry 030D,E01009691,1178,743,435,71,300,64
2011,Coventry 031A,E01009548,1843,1147,696,132,409,155
2011,Coventry 031B,E01009553,1888,844,1044,60,884,100
2011,Coventry 031C,E01009642,2580,1007,1573,61,1387,125
2011,Coventry 031D,E01009651,1318,767,551,98,196,257
2011,Coventry 032A,E01009676,1110,814,296,122,88,86
2011,Coventry 032B,E01009681,964,665,299,166,73,60
2011,Coventry 032C,E01009682,1141,803,338,166,88,84
2011,Coventry 032D,E01009683,979,700,279,92,89,98
2011,Coventry 033A,E01009532,967,697,270,177,23,70
2011,Coventry 033B,E01009535,962,631,331,245,21,65
2011,Coventry 033C,E01009536,1071,722,349,229,42,78
2011,Coventry 033D,E01009543,1338,1129,209,90,51,68
2011,Coventry 033E,E01009707,1358,1063,295,157,47,91
2011,Coventry 033F,E01009708,1104,817,287,181,33,73
2011,Coventry 034A,E01009554,1018,748,270,101,116,53
2011,Coventry 034B,E01009555,1116,772,344,188,90,66
2011,Coventry 034C,E01009556,1226,822,404,130,173,101
2011,Coventry 034D,E01009557,1016,663,353,227,82,44
2011,Coventry 034E,E01009558,1201,912,289,94,134,61
2011,Coventry 034F,E01009559,972,579,393,199,131,63
2011,Coventry 035C,E01009537,1028,712,316,142,60,114
2011,Coventry 035D,E01009538,1033,705,328,150,48,130
2011,Coventry 035E,E01009611,1376,916,460,81,112,267
2011,Coventry 035F,E01009612,965,630,335,88,74,173
2011,Coventry 035G,E01032527,1130,819,311,121,53,137
2011,Coventry 035H,E01032528,1101,692,409,190,67,152
2011,Coventry 036C,E01009679,1073,568,505,132,217,156
2011,Coventry 036E,E01032531,1733,1077,656,165,153,338
2011,Coventry 036F,E01032532,951,639,312,175,68,69
2011,Coventry 036G,E01032533,1399,1036,363,146,127,90
2011,Coventry 037B,E01009549,1194,830,364,201,80,83
2011,Coventry 037C,E01009550,1399,983,416,176,128,112
2011,Coventry 037E,E01009552,1107,752,355,192,54,109
2011,Coventry 037F,E01032534,1302,826,476,195,70,211
2011,Coventry 037G,E01032535,874,648,226,121,42,63
2011,Coventry 038A,E01009544,1122,763,359,197,43,119
2011,Coventry 038D,E01009619,1491,1030,461,125,184,152
2011,Coventry 038E,E01032529,972,692,280,157,35,88
2011,Coventry 038F,E01032530,1333,992,341,186,59,96
2011,Coventry 039A,E01009539,1092,696,396,91,47,258
2011,Coventry 039B,E01009540,1236,791,445,84,78,283
2011,Coventry 039C,E01009541,1180,766,414,201,49,164
2011,Coventry 039D,E01009542,1288,781,507,155,58,294
2011,Coventry 040A,E01009560,1097,764,333,205,61,67
2011,Coventry 040B,E01009561,1106,744,362,191,44,127
2011,Coventry 040C,E01009562,1154,763,391,235,51,105
2011,Coventry 040D,E01009563,1138,865,273,165,56,52
2011,Coventry 040E,E01009672,1454,995,459,312,72,75
2011,Coventry 041A,E01009666,933,677,256,156,53,47
2011,Coventry 041B,E01009667,945,568,377,272,53,52
2011,Coventry 041C,E01009668,1150,868,282,123,92,67
2011,Coventry 041D,E01009670,1166,888,278,172,53,53
2011,Coventry 042A,E01009665,882,551,331,186,96,49
2011,Coventry 042B,E01009669,914,688,226,115,62,49
2011,Coventry 042C,E01009671,3896,1121,2775,133,2582,60
2011,Coventry 042F,E01033058,2215,953,1262,253,831,178
2011,Coventry 043A,E01009588,1055,660,395,170,58,167
2011,Coventry 043B,E01009592,1124,806,318,94,37,187
2011,Coventry 043C,E01009596,1079,743,336,87,71,178
2011,Coventry 043D,E01009597,1235,833,402,157,82,163
2011,Coventry 043E,E01032587,1226,859,367,121,68,178
2011,Dudley 001A,E01009763,1295,881,414,130,60,224
2011,Dudley 001B,E01009764,1109,757,352,222,46,84
2011,Dudley 001C,E01009767,1030,733,297,163,28,106
2011,Dudley 001D,E01009769,1084,702,382,114,41,227
2011,Dudley 001E,E01009770,1054,668,386,189,47,150
2011,Dudley 002A,E01009773,1071,703,368,181,61,126
2011,Dudley 002B,E01009777,1060,725,335,165,48,122
2011,Dudley 002C,E01009778,1122,847,275,145,50,80
2011,Dudley 002D,E01009895,994,685,309,170,41,98
2011,Dudley 003A,E01009896,1059,731,328,217,36,75
2011,Dudley 003B,E01009897,1024,667,357,255,46,56
2011,Dudley 003C,E01009898,1063,690,373,249,53,71
2011,Dudley 003D,E01009901,1028,669,359,271,31,57
2011,Dudley 003E,E01009902,988,656,332,266,29,37
2011,Dudley 004A,E01009765,1190,834,356,215,45,96
2011,Dudley 004B,E01009766,1184,828,356,186,49,121
2011,Dudley 004C,E01009768,975,677,298,141,51,106
2011,Dudley 004D,E01009771,924,611,313,238,28,47
2011,Dudley 004E,E01009775,1130,726,404,170,63,171
2011,Dudley 004F,E01009776,1095,779,316,181,46,89
2011,Dudley 005A,E01009758,1173,731,442,185,54,203
2011,Dudley 005B,E01009760,918,634,284,117,44,123
2011,Dudley 005C,E01009772,960,663,297,77,58,162
2011,Dudley 005D,E01009774,1102,754,348,195,40,113
2011,Dudley 005E,E01009788,1165,774,391,182,55,154
2011,Dudley 006B,E01009756,1019,634,385,114,61,210
2011,Dudley 006C,E01009757,1180,828,352,143,45,164
2011,Dudley 006D,E01009759,1000,627,373,266,35,72
2011,Dudley 006F,E01009762,927,502,425,111,81,233
2011,Dudley 006G,E01033187,1498,829,669,162,90,417
2011,Dudley 007A,E01009781,1409,1003,406,203,45,158
2011,Dudley 007B,E01009786,1057,721,336,117,46,173
2011,Dudley 007C,E01009789,1172,841,331,208,44,79
2011,Dudley 007D,E01009790,1129,805,324,134,39,151
2011,Dudley 008A,E01009779,1039,714,325,216,19,90
2011,Dudley 008B,E01009782,1108,729,379,163,41,175
2011,Dudley 008C,E01009783,1050,705,345,156,53,136
2011,Dudley 008D,E01009785,1062,692,370,285,32,53
2011,Dudley 008E,E01009899,1018,679,339,262,20,57
2011,Dudley 008F,E01009900,1044,648,396,320,26,50
2011,Dudley 009A,E01009780,1548,1313,235,92,66,77
2011,Dudley 009B,E01009784,1280,1056,224,94,55,75
2011,Dudley 009C,E01009787,1209,901,308,169,67,72
2011,Dudley 009D,E01009880,1151,872,279,128,66,85
2011,Dudley 009E,E01009882,1035,707,328,151,56,121
2011,Dudley 010A,E01009891,1149,724,425,100,61,264
2011,Dudley 010B,E01009892,1082,656,426,121,75,230
2011,Dudley 010C,E01009893,1114,632,482,122,74,286
2011,Dudley 010D,E01009894,1258,880,378,158,54,166
2011,Dudley 011A,E01009844,996,603,393,119,48,226
2011,Dudley 011B,E01009879,1470,1076,394,147,75,172
2011,Dudley 011C,E01009881,1507,969,538,229,59,250
2011,Dudley 011D,E01009885,1119,671,448,208,50,190
2011,Dudley 012A,E01009816,1109,764,345,246,30,69
2011,Dudley 012B,E01009817,892,590,302,221,34,47
2011,Dudley 012C,E01009819,1190,944,246,158,29,59
2011,Dudley 012D,E01009820,1126,790,336,217,40,79
2011,Dudley 013A,E01009748,1159,677,482,157,62,263
2011,Dudley 013B,E01009839,1145,720,425,161,62,202
2011,Dudley 013C,E01009883,932,618,314,117,51,146
2011,Dudley 013D,E01009884,1098,745,353,126,63,164
2011,Dudley 013E,E01009886,1106,661,445,231,24,190
2011,Dudley 014A,E01009814,950,644,306,206,32,68
2011,Dudley 014B,E01009815,994,727,267,170,54,43
2011,Dudley 014C,E01009818,825,553,272,166,32,74
2011,Dudley 014D,E01009821,1010,643,367,296,28,43
2011,Dudley 014E,E01009822,1050,701,349,266,20,63
2011,Dudley 015A,E01009887,1266,819,447,159,51,237
2011,Dudley 015B,E01009888,1149,806,343,166,26,151
2011,Dudley 015C,E01009889,1276,728,548,134,95,319
2011,Dudley 015D,E01009890,1144,729,415,113,79,223
2011,Dudley 016A,E01009749,1099,792,307,186,43,78
2011,Dudley 016B,E01009750,1127,732,395,217,41,137
2011,Dudley 016C,E01009823,1088,780,308,205,35,68
2011,Dudley 016D,E01009824,1103,784,319,147,43,129
2011,Dudley 017A,E01009751,1095,723,372,165,51,156
2011,Dudley 017B,E01009752,1040,678,362,112,47,203
2011,Dudley 017C,E01009753,1062,666,396,159,59,178
2011,Dudley 017D,E01009754,1204,845,359,147,45,167
2011,Dudley 017E,E01009841,1087,670,417,150,60,207
2011,Dudley 018A,E01009840,964,604,360,108,47,205
2011,Dudley 018B,E01009842,1381,934,447,145,56,246
2011,Dudley 018C,E01009843,1160,820,340,212,45,83
2011,Dudley 018D,E01009871,1418,997,421,204,51,166
2011,Dudley 018E,E01009875,1105,711,394,191,48,155
2011,Dudley 019A,E01009825,1050,743,307,174,39,94
2011,Dudley 019B,E01009826,1100,715,385,305,28,52
2011,Dudley 019C,E01009827,1118,798,320,227,38,55
2011,Dudley 019D,E01009828,1055,676,379,251,40,88
2011,Dudley 019E,E01009829,1108,790,318,231,38,49
2011,Dudley 019F,E01009830,1155,772,383,269,55,59
2011,Dudley 020A,E01009872,1071,713,358,110,64,184
2011,Dudley 020B,E01009873,1133,783,350,185,45,120
2011,Dudley 020C,E01009874,1144,738,406,140,65,201
2011,Dudley 020D,E01009876,1204,783,421,203,49,169
2011,Dudley 020E,E01009877,1047,674,373,133,37,203
2011,Dudley 021A,E01009911,1099,735,364,267,36,61
2011,Dudley 021B,E01009912,1251,920,331,211,43,77
2011,Dudley 021C,E01009913,1126,753,373,252,35,86
2011,Dudley 021D,E01009914,1062,716,346,276,26,44
2011,Dudley 021E,E01009915,1313,964,349,210,37,102
2011,Dudley 021F,E01009916,1273,924,349,200,51,98
2011,Dudley 022A,E01009741,1776,1184,592,166,80,346
2011,Dudley 022B,E01009744,1422,970,452,179,48,225
2011,Dudley 022C,E01009746,1152,741,411,134,60,217
2011,Dudley 022D,E01009747,1124,825,299,92,39,168
2011,Dudley 023A,E01009731,1195,975,220,110,29,81
2011,Dudley 023B,E01009740,1202,873,329,94,53,182
2011,Dudley 023C,E01009742,1072,710,362,157,45,160
2011,Dudley 023D,E01009743,1210,785,425,156,63,206
2011,Dudley 023E,E01009745,1293,987,306,182,49,75
2011,Dudley 024A,E01009917,971,677,294,224,22,48
2011,Dudley 024B,E01009918,1009,699,310,168,34,108
2011,Dudley 024C,E01009919,974,636,338,268,24,46
2011,Dudley 024D,E01009920,1089,853,236,136,24,76
2011,Dudley 025A,E01009864,1182,839,343,148,58,137
2011,Dudley 025B,E01009865,975,647,328,163,35,130
2011,Dudley 025C,E01009866,1227,896,331,160,38,133
2011,Dudley 025D,E01009867,1258,837,421,237,50,134
2011,Dudley 025E,E01009878,1432,1053,379,191,50,138
2011,Dudley 026A,E01009791,1073,791,282,139,38,105
2011,Dudley 026B,E01009792,1124,746,378,159,72,147
2011,Dudley 026C,E01009795,1247,867,380,140,56,184
2011,Dudley 026D,E01009796,1144,802,342,166,59,117
2011,Dudley 026E,E01009798,1267,882,385,207,60,118
2011,Dudley 027A,E01009719,1103,798,305,177,41,87
2011,Dudley 027B,E01009722,1053,747,306,227,28,51
2011,Dudley 027C,E01009727,1072,829,243,118,47,78
2011,Dudley 027D,E01009728,1027,777,250,141,31,78
2011,Dudley 027E,E01009729,1152,793,359,214,45,100
2011,Dudley 028A,E01009720,1100,873,227,116,55,56
2011,Dudley 028B,E01009723,990,776,214,124,37,53
2011,Dudley 028C,E01009724,1178,927,251,146,37,68
2011,Dudley 028D,E01009730,1141,947,194,96,43,55
2011,Dudley 029A,E01009903,1059,695,364,276,35,53
2011,Dudley 029B,E01009904,994,719,275,169,33,73
2011,Dudley 029C,E01009909,986,667,319,207,32,80
2011,Dudley 029D,E01009910,1077,733,344,170,37,137
2011,Dudley 030A,E01009793,1008,743,265,144,41,80
2011,Dudley 030B,E01009794,1005,687,318,229,29,60
2011,Dudley 030C,E01009797,961,632,329,204,45,80
2011,Dudley 030D,E01009801,1222,849,373,244,59,70
2011,Dudley 031A,E01009721,1413,1019,394,211,38,145
2011,Dudley 031B,E01009725,1049,676,373,149,55,169
2011,Dudley 031C,E01009726,1033,744,289,175,44,70
2011,Dudley 031D,E01009834,1147,771,376,173,51,152
2011,Dudley 032A,E01009833,947,580,367,83,70,214
2011,Dudley 032B,E01009835,1121,736,385,111,68,206
2011,Dudley 032C,E01009869,1229,928,301,175,50,76
2011,Dudley 032D,E01009870,1199,970,229,140,15,74
2011,Dudley 033A,E01009809,1144,718,426,172,65,189
2011,Dudley 033B,E01009813,1129,738,391,183,61,147
2011,Dudley 033C,E01009861,1124,781,343,172,45,126
2011,Dudley 033D,E01009862,1271,887,384,167,51,166
2011,Dudley 033E,E01009863,1311,949,362,126,66,170
2011,Dudley 033F,E01009868,1129,774,355,156,39,160
2011,Dudley 034A,E01009734,1082,733,349,179,55,115
2011,Dudley 034B,E01009735,1137,867,270,174,46,50
2011,Dudley 034C,E01009736,1047,719,328,223,37,68
2011,Dudley 034D,E01009737,1106,792,314,189,37,88
2011,Dudley 034E,E01009738,1075,718,357,175,67,115
2011,Dudley 035A,E01009856,1421,1011,410,164,60,186
2011,Dudley 035B,E01009905,1082,796,286,184,30,72
2011,Dudley 035C,E01009906,1189,817,372,175,37,160
2011,Dudley 035D,E01009907,1078,798,280,120,63,97
2011,Dudley 035E,E01009908,1214,918,296,157,59,80
2011,Dudley 036A,E01009800,1090,740,350,231,49,70
2011,Dudley 036B,E01009802,1136,822,314,170,60,84
2011,Dudley 036C,E01009803,1172,851,321,228,48,45
2011,Dudley 036D,E01009804,1046,744,302,200,44,58
2011,Dudley 037A,E01009831,1087,662,425,215,68,142
2011,Dudley 037B,E01009836,1275,754,521,127,51,343
2011,Dudley 037C,E01009837,1192,756,436,160,62,214
2011,Dudley 037D,E01009838,1188,788,400,195,49,156
2011,Dudley 038A,E01009847,1085,743,342,214,43,85
2011,Dudley 038B,E01009848,1036,716,320,166,57,97
2011,Dudley 038C,E01009849,1128,801,327,155,51,121
2011,Dudley 038D,E01009851,1074,737,337,207,40,90
2011,Dudley 039A,E01009732,1278,849,429,196,57,176
2011,Dudley 039B,E01009733,1270,793,477,155,56,266
2011,Dudley 039C,E01009739,1120,787,333,180,46,107
2011,Dudley 039D,E01009799,1066,731,335,239,36,60
2011,Dudley 039E,E01009805,1118,780,338,200,51,87
2011,Dudley 039F,E01009806,1146,813,333,217,36,80
2011,Dudley 040A,E01009854,1135,754,381,259,45,77
2011,Dudley 040B,E01009857,1178,778,400,182,51,167
2011,Dudley 040C,E01009858,1005,622,383,140,167,76
2011,Dudley 040D,E01009859,1158,869,289,200,42,47
2011,Dudley 041A,E01009845,1115,741,374,249,56,69
2011,Dudley 041B,E01009846,1048,729,319,192,52,75
2011,Dudley 041C,E01009850,1068,732,336,222,39,75
2011,Dudley 041D,E01009852,1055,692,363,259,46,58
2011,Dudley 042A,E01009832,1091,702,389,149,62,178
2011,Dudley 042B,E01009853,947,601,346,262,27,57
2011,Dudley 042C,E01009855,1159,742,417,283,60,74
2011,Dudley 042D,E01009860,1138,728,410,300,38,72
2011,Dudley 043A,E01009807,1219,862,357,260,44,53
2011,Dudley 043B,E01009808,1120,814,306,216,44,46
2011,Dudley 043C,E01009810,1220,843,377,252,43,82
2011,Dudley 043D,E01009811,1105,784,321,204,50,67
2011,Dudley 043E,E01009812,1145,829,316,200,54,62
2011,Sandwell 001A,E01010085,1159,830,329,140,47,142
2011,Sandwell 001B,E01010086,1242,843,399,153,63,183
2011,Sandwell 001C,E01010087,1221,805,416,156,69,191
2011,Sandwell 001D,E01010088,1122,765,357,107,60,190
2011,Sandwell 001E,E01010089,1310,850,460,175,91,194
2011,Sandwell 002A,E01009969,1361,968,393,111,70,212
2011,Sandwell 002B,E01009970,1020,699,321,153,49,119
2011,Sandwell 002C,E01009971,1091,756,335,117,64,154
2011,Sandwell 002D,E01009973,1785,1282,503,151,118,234
2011,Sandwell 003A,E01009960,1100,690,410,166,46,198
2011,Sandwell 003B,E01009961,948,659,289,188,39,62
2011,Sandwell 003C,E01009966,848,555,293,100,41,152
2011,Sandwell 003D,E01009967,1271,902,369,161,47,161
2011,Sandwell 003E,E01010092,1363,897,466,208,69,189
2011,Sandwell 004A,E01009962,924,560,364,113,53,198
2011,Sandwell 004B,E01009963,946,593,353,112,54,187
2011,Sandwell 004C,E01009964,1066,653,413,132,57,224
2011,Sandwell 004D,E01009965,969,594,375,103,51,221
2011,Sandwell 005A,E01010090,1189,749,440,161,57,222
2011,Sandwell 005B,E01010091,1130,737,393,166,63,164
2011,Sandwell 005C,E01010096,1076,658,418,247,31,140
2011,Sandwell 005D,E01010097,1321,791,530,298,47,185
2011,Sandwell 006A,E01009968,1116,777,339,218,72,49
2011,Sandwell 006B,E01009972,1301,892,409,249,68,92
2011,Sandwell 006C,E01009974,1086,766,320,179,56,85
2011,Sandwell 006D,E01009975,1166,835,331,203,54,74
2011,Sandwell 007A,E01010030,1050,599,451,162,47,242
2011,Sandwell 007B,E01010034,1124,918,206,90,41,75
2011,Sandwell 007C,E01010035,1102,717,385,278,34,73
2011,Sandwell 007D,E01010036,1156,818,338,105,54,179
2011,Sandwell 009A,E01009982,1088,725,363,119,67,177
2011,Sandwell 009B,E01009983,1064,644,420,154,57,209
2011,Sandwell 009C,E01010029,917,522,395,136,41,218
2011,Sandwell 009D,E01010037,746,464,282,91,40,151
2011,Sandwell 010A,E01009991,1507,1005,502,167,83,252
2011,Sandwell 010B,E01009994,1108,729,379,154,52,173
2011,Sandwell 010C,E01009995,1123,776,347,153,48,146
2011,Sandwell 010D,E01009996,1144,709,435,168,56,211
2011,Sandwell 010E,E01009997,1235,815,420,129,55,236
2011,Sandwell 010F,E01009998,1353,884,469,145,67,257
2011,Sandwell 011A,E01010008,1092,748,344,169,74,101
2011,Sandwell 011B,E01010010,981,669,312,125,39,148
2011,Sandwell 011C,E01010011,1171,876,295,164,52,79
2011,Sandwell 011D,E01010012,1011,714,297,172,52,73
2011,Sandwell 012A,E01010007,934,630,304,163,50,91
2011,Sandwell 012B,E01010009,987,681,306,144,60,102
2011,Sandwell 012C,E01010013,908,573,335,230,44,61
2011,Sandwell 012D,E01010014,1188,835,353,220,48,85
2011,Sandwell 013A,E01010093,802,542,260,86,38,136
2011,Sandwell 013B,E01010094,1109,755,354,110,71,173
2011,Sandwell 013C,E01010095,973,645,328,100,66,162
2011,Sandwell 013D,E01010098,1180,692,488,211,57,220
2011,Sandwell 013E,E01010099,1202,827,375,179,49,147
2011,Sandwell 013F,E01010100,1345,932,413,163,56,194
2011,Sandwell 014A,E01009978,1295,802,493,205,61,227
2011,Sandwell 014B,E01010031,1143,710,433,172,42,219
2011,Sandwell 014C,E01010032,901,532,369,57,70,242
2011,Sandwell 014D,E01010033,1131,726,405,163,36,206
2011,Sandwell 014E,E01010074,1648,1162,486,192,62,232
2011,Sandwell 015A,E01010066,1031,587,444,183,57,204
2011,Sandwell 015B,E01010067,1068,680,388,106,68,214
2011,Sandwell 015C,E01010068,1145,776,369,165,47,157
2011,Sandwell 015D,E01010070,1151,829,322,139,32,151
2011,Sandwell 015E,E01010075,1027,782,245,53,62,130
2011,Sandwell 015F,E01010076,885,512,373,174,33,166
2011,Sandwell 016A,E01009976,1887,1529,358,136,59,163
2011,Sandwell 016B,E01009977,1290,943,347,124,51,172
2011,Sandwell 016C,E01009979,1129,665,464,184,35,245
2011,Sandwell 016D,E01009980,1626,1136,490,146,72,272
2011,Sandwell 016E,E01010069,1354,1004,350,105,75,170
2011,Sandwell 016F,E01010071,1269,850,419,116,76,227
2011,Sandwell 017A,E01009947,1370,979,391,168,74,149
2011,Sandwell 017B,E01009992,1213,802,411,134,85,192
2011,Sandwell 017C,E01009993,1264,791,473,154,78,241
2011,Sandwell 017D,E01010103,1383,933,450,133,76,241
2011,Sandwell 017E,E01010104,1208,732,476,237,36,203
2011,Sandwell 017F,E01010105,1122,786,336,133,73,130
2011,Sandwell 018A,E01009981,1244,798,446,154,51,241
2011,Sandwell 018C,E01009985,1193,725,468,187,77,204
2011,Sandwell 018E,E01032887,1881,1178,703,195,106,402
2011,Sandwell 019A,E01009986,961,564,397,111,87,199
2011,Sandwell 019B,E01009987,837,475,362,96,52,214
2011,Sandwell 019C,E01009989,1129,716,413,152,76,185
2011,Sandwell 019D,E01010106,1093,690,403,113,75,215
2011,Sandwell 020A,E01009988,1207,726,481,165,77,239
2011,Sandwell 020B,E01010101,1417,881,536,233,54,249
2011,Sandwell 020C,E01010102,1220,730,490,164,71,255
2011,Sandwell 020D,E01010107,1259,786,473,96,83,294
2011,Sandwell 021A,E01010015,1210,833,377,145,68,164
2011,Sandwell 021B,E01010016,1146,783,363,95,80,188
2011,Sandwell 021C,E01010018,1494,1095,399,138,68,193
2011,Sandwell 021D,E01010072,1611,1176,435,129,81,225
2011,Sandwell 021E,E01010073,1139,794,345,125,51,169
2011,Sandwell 022A,E01010077,1082,697,385,167,38,180
2011,Sandwell 022B,E01010079,1168,872,296,173,37,86
2011,Sandwell 022C,E01010080,1205,796,409,118,59,232
2011,Sandwell 022D,E01010081,1178,877,301,178,40,83
2011,Sandwell 022E,E01010082,1675,1312,363,135,69,159
2011,Sandwell 022F,E01010083,1161,846,315,130,46,139
2011,Sandwell 022G,E01010084,1026,671,355,108,66,181
2011,Sandwell 023A,E01010046,1353,770,583,83,149,351
2011,Sandwell 023B,E01010047,1283,782,501,139,87,275
2011,Sandwell 023C,E01010048,1211,759,452,92,123,237
2011,Sandwell 023D,E01010049,1195,749,446,128,87,231
2011,Sandwell 023E,E01010050,1121,698,423,138,91,194
2011,Sandwell 023F,E01010052,934,572,362,100,57,205
2011,Sandwell 023G,E01010053,1234,712,522,80,139,303
2011,Sandwell 024A,E01010017,1353,863,490,179,60,251
2011,Sandwell 024B,E01010019,1176,723,453,93,86,274
2011,Sandwell 024C,E01010020,1306,810,496,188,92,216
2011,Sandwell 024D,E01010021,1249,797,452,139,95,218
2011,Sandwell 025A,E01010039,922,581,341,108,67,166
2011,Sandwell 025B,E01010043,1097,777,320,224,34,62
2011,Sandwell 025C,E01010044,1007,629,378,209,47,122
2011,Sandwell 025D,E01010078,946,633,313,238,22,53
2011,Sandwell 026A,E01010059,1329,862,467,64,125,278
2011,Sandwell 026B,E01010061,1221,712,509,51,163,295
2011,Sandwell 026C,E01010062,1094,618,476,135,87,254
2011,Sandwell 026D,E01010063,1397,784,613,107,154,352
2011,Sandwell 026E,E01010064,1188,753,435,103,98,234
2011,Sandwell 026F,E01010065,1780,1202,578,56,179,343
2011,Sandwell 027A,E01009934,1013,636,377,151,64,162
2011,Sandwell 027B,E01009935,1370,880,490,206,56,228
2011,Sandwell 027C,E01009936,1228,832,396,253,43,100
2011,Sandwell 027D,E01010004,1161,792,369,183,53,133
2011,Sandwell 028A,E01010054,1300,731,569,174,71,324
2011,Sandwell 028B,E01010055,1217,855,362,94,78,190
2011,Sandwell 028C,E01010056,1097,693,404,157,64,183
2011,Sandwell 028D,E01010057,1291,755,536,138,109,289
2011,Sandwell 028E,E01010060,1393,842,551,117,124,310
2011,Sandwell 029A,E01010038,1253,834,419,139,66,214
2011,Sandwell 029B,E01010040,1058,678,380,223,49,108
2011,Sandwell 029C,E01010041,1217,719,498,222,52,224
2011,Sandwell 029D,E01010045,1142,762,380,163,56,161
2011,Sandwell 030A,E01010000,1156,783,373,179,53,141
2011,Sandwell 030B,E01010002,1541,1184,357,150,60,147
2011,Sandwell 030C,E01010003,1133,727,406,158,62,186
2011,Sandwell 030D,E01010005,1086,779,307,142,52,113
2011,Sandwell 030E,E01010006,1223,872,351,160,67,124
2011,Sandwell 031A,E01009938,1218,815,403,173,66,164
2011,Sandwell 031B,E01009943,996,617,379,146,61,172
2011,Sandwell 031C,E01009944,1048,648,400,142,80,178
2011,Sandwell 031D,E01010051,865,591,274,107,53,114
2011,Sandwell 031E,E01010058,1147,755,392,147,74,171
2011,Sandwell 032A,E01009937,1083,730,353,139,52,162
2011,Sandwell 032B,E01009939,1252,894,358,191,50,117
2011,Sandwell 032C,E01009940,1057,679,378,153,55,170
2011,Sandwell 032D,E01009941,1083,729,354,163,50,141
2011,Sandwell 032E,E01009942,1204,768,436,176,64,196
2011,Sandwell 033A,E01009929,1180,743,437,193,58,186
2011,Sandwell 033B,E01009930,1071,696,375,176,52,147
2011,Sandwell 033C,E01009931,1706,1291,415,222,54,139
2011,Sandwell 033D,E01009932,1194,771,423,173,53,197
2011,Sandwell 033E,E01009999,1007,659,348,184,48,116
2011,Sandwell 034A,E01009921,1220,965,255,82,70,103
2011,Sandwell 034B,E01009922,922,657,265,119,59,87
2011,Sandwell 034C,E01009924,1037,798,239,126,45,68
2011,Sandwell 034D,E01009925,1029,811,218,109,54,55
2011,Sandwell 034E,E01009926,1069,814,255,100,53,102
2011,Sandwell 034F,E01009927,1194,947,247,91,56,100
2011,Sandwell 034G,E01009928,1310,1006,304,101,53,150
2011,Sandwell 035A,E01009933,1047,713,334,110,56,168
2011,Sandwell 035B,E01009952,1426,938,488,163,69,256
2011,Sandwell 035C,E01009955,1344,894,450,178,54,218
2011,Sandwell 035D,E01009956,1132,787,345,179,44,122
2011,Sandwell 035E,E01009959,1102,792,310,184,55,71
2011,Sandwell 035F,E01010042,1270,853,417,194,49,174
2011,Sandwell 036A,E01009923,1052,749,303,169,57,77
2011,Sandwell 036B,E01010024,1100,801,299,191,49,59
2011,Sandwell 036C,E01010026,1214,827,387,215,55,117
2011,Sandwell 036D,E01010027,1091,797,294,163,49,82
2011,Sandwell 037A,E01010001,1175,750,425,196,67,162
2011,Sandwell 037B,E01010022,1096,796,300,167,39,94
2011,Sandwell 037C,E01010023,1282,930,352,189,56,107
2011,Sandwell 037D,E01010025,1027,684,343,140,56,147
2011,Sandwell 037E,E01010028,996,683,313,99,65,149
2011,Sandwell 038A,E01009953,1253,863,390,177,38,175
2011,Sandwell 038B,E01009954,1163,751,412,200,43,169
2011,Sandwell 038C,E01009957,1139,708,431,109,71,251
2011,Sandwell 038D,E01009958,1183,851,332,197,61,74
2011,Sandwell 039A,E01009946,1202,858,344,208,39,97
2011,Sandwell 039B,E01009948,1173,788,385,264,53,68
2011,Sandwell 039C,E01009949,1136,805,331,215,39,77
2011,Sandwell 039D,E01009950,1236,828,408,219,62,127
2011,Sandwell 039E,E01009951,1433,991,442,138,56,248
2011,Sandwell 039F,E01032592,1262,873,389,202,59,128
2011,Solihull 001A,E01010118,1042,729,313,172,49,92
2011,Solihull 001B,E01010120,1000,696,304,154,38,112
2011,Solihull 001C,E01010121,1008,711,297,187,37,73
2011,Solihull 001D,E01010122,1054,721,333,238,42,53
2011,Solihull 002A,E01010235,1056,681,375,133,67,175
2011,Solihull 002B,E01010236,1050,675,375,128,47,200
2011,Solihull 002C,E01010239,1115,752,363,162,56,145
2011,Solihull 002D,E01010240,967,641,326,128,57,141
2011,Solihull 003A,E01010117,1087,838,249,154,42,53
2011,Solihull 003B,E01010119,1052,775,277,189,42,46
2011,Solihull 003C,E01010123,1012,761,251,158,51,42
2011,Solihull 003D,E01010124,1135,837,298,206,32,60
2011,Solihull 004A,E01010146,1155,797,358,139,64,155
2011,Solihull 004B,E01010234,883,531,352,142,42,168
2011,Solihull 004C,E01010237,1380,929,451,228,71,152
2011,Solihull 004D,E01010238,1046,682,364,142,42,180
2011,Solihull 005A,E01010145,1026,705,321,163,44,114
2011,Solihull 005B,E01010147,999,663,336,76,53,207
2011,Solihull 005C,E01010148,1205,819,386,114,72,200
2011,Solihull 005D,E01010149,1088,764,324,175,49,100
2011,Solihull 006A,E01010125,1071,639,432,179,43,210
2011,Solihull 006B,E01010129,1105,686,419,172,47,200
2011,Solihull 006C,E01010139,769,508,261,161,25,75
2011,Solihull 006D,E01010141,1016,651,365,112,51,202
2011,Solihull 007A,E01010140,1088,704,384,153,50,181
2011,Solihull 007B,E01010142,992,598,394,131,59,204
2011,Solihull 007C,E01010143,1023,646,377,173,44,160
2011,Solihull 007D,E01010144,1200,825,375,198,53,124
2011,Solihull 008A,E01010111,1041,683,358,125,47,186
2011,Solihull 008B,E01010126,1080,677,403,180,31,192
2011,Solihull 008C,E01010127,1279,900,379,164,58,157
2011,Solihull 008D,E01010128,1048,707,341,163,43,135
2011,Solihull 008E,E01010130,1249,784,465,194,54,217
2011,Solihull 008F,E01010131,997,655,342,143,34,165
2011,Solihull 009A,E01010109,1062,771,291,186,35,70
2011,Solihull 009B,E01010110,1256,805,451,174,70,207
2011,Solihull 009C,E01010112,1197,898,299,145,45,109
2011,Solihull 009D,E01010113,944,630,314,179,36,99
2011,Solihull 009E,E01010114,1338,941,397,235,44,118
2011,Solihull 010A,E01010157,1056,814,242,136,37,69
2011,Solihull 010B,E01010159,999,727,272,125,47,100
2011,Solihull 010C,E01010162,1084,787,297,171,47,79
2011,Solihull 010D,E01010163,1043,779,264,139,49,76
2011,Solihull 011A,E01010132,975,670,305,184,45,76
2011,Solihull 011B,E01010133,1006,660,346,219,45,82
2011,Solihull 011C,E01010134,961,708,253,150,40,63
2011,Solihull 011D,E01010135,1066,770,296,181,36,79
2011,Solihull 011E,E01010138,1037,757,280,186,37,57
2011,Solihull 012A,E01010136,905,680,225,138,34,53
2011,Solihull 012B,E01010137,939,623,316,181,38,97
2011,Solihull 012C,E01010158,1003,658,345,141,50,154
2011,Solihull 012D,E01010160,1109,760,349,198,43,108
2011,Solihull 012E,E01010161,1086,794,292,161,60,71
2011,Solihull 013A,E01010174,1229,863,366,206,62,98
2011,Solihull 013B,E01010175,1229,845,384,246,72,66
2011,Solihull 013C,E01010177,949,699,250,133,36,81
2011,Solihull 013D,E01010178,1273,861,412,207,57,148
2011,Solihull 014A,E01010172,1093,815,278,167,58,53
2011,Solihull 014B,E01010173,1011,743,268,166,50,52
2011,Solihull 014C,E01010176,970,715,255,146,45,64
2011,Solihull 014D,E01010179,1085,770,315,192,40,83
2011,Solihull 015A,E01010115,1133,835,298,187,40,71
2011,Solihull 015B,E01010116,1153,834,319,210,48,61
2011,Solihull 015C,E01010227,1370,1001,369,238,54,77
2011,Solihull 015D,E01010228,1164,856,308,178,46,84
2011,Solihull 015E,E01010232,1484,1091,393,186,48,159
2011,Solihull 016A,E01010195,1094,746,348,220,54,74
2011,Solihull 016B,E01010226,989,691,298,178,25,95
2011,Solihull 016C,E01010229,1017,714,303,192,38,73
2011,Solihull 016D,E01010230,1243,877,366,195,47,124
2011,Solihull 016E,E01010231,1192,792,400,252,58,90
2011,Solihull 016F,E01010233,1322,972,350,165,51,134
2011,Solihull 017A,E01010108,1433,1032,401,230,62,109
2011,Solihull 017B,E01010164,1206,837,369,244,26,99
2011,Solihull 017C,E01010165,1052,742,310,196,27,87
2011,Solihull 017D,E01010167,1147,846,301,170,42,89
2011,Solihull 018A,E01010199,1213,904,309,184,50,75
2011,Solihull 018B,E01010200,934,595,339,192,54,93
2011,Solihull 018C,E01010201,1158,850,308,168,62,78
2011,Solihull 018D,E01010204,936,624,312,127,36,149
2011,Solihull 018E,E01010205,1059,760,299,170,75,54
2011,Solihull 018F,E01010206,1175,887,288,164,51,73
2011,Solihull 019A,E01010192,1162,834,328,181,73,74
2011,Solihull 019B,E01010196,1171,825,346,224,60,62
2011,Solihull 019C,E01010197,1169,783,386,242,76,68
2011,Solihull 019D,E01010198,1071,774,297,204,38,55
2011,Solihull 021A,E01010218,939,609,330,174,41,115
2011,Solihull 021B,E01010219,1179,863,316,209,44,63
2011,Solihull 021C,E01010221,1034,752,282,196,29,57
2011,Solihull 021D,E01010222,1135,811,324,210,36,78
2011,Solihull 022A,E01010191,1358,968,390,244,78,68
2011,Solihull 022B,E01010202,1096,817,279,179,39,61
2011,Solihull 022C,E01010203,1220,915,305,167,64,74
2011,Solihull 022D,E01010209,1269,939,330,183,58,89
2011,Solihull 022E,E01010213,1140,807,333,154,62,117
2011,Solihull 023A,E01010208,1062,771,291,184,39,68
2011,Solihull 023B,E01010210,1168,849,319,215,55,49
2011,Solihull 023C,E01010211,1044,670,374,249,41,84
2011,Solihull 023D,E01010217,1088,825,263,169,47,47
2011,Solihull 024A,E01010190,1235,920,315,170,70,75
2011,Solihull 024B,E01010193,1057,776,281,166,76,39
2011,Solihull 024C,E01010194,1219,937,282,174,60,48
2011,Solihull 024D,E01010207,1102,822,280,169,58,53
2011,Solihull 025A,E01010166,1016,704,312,216,42,54
2011,Solihull 025B,E01010168,1330,1017,313,204,47,62
2011,Solihull 025C,E01010169,1136,787,349,250,52,47
2011,Solihull 025D,E01010170,1135,832,303,205,47,51
2011,Solihull 025E,E01010171,995,707,288,170,49,69
2011,Solihull 026A,E01010151,1085,777,308,208,34,66
2011,Solihull 026B,E01010152,1042,726,316,198,65,53
2011,Solihull 026C,E01010153,1097,676,421,261,49,111
2011,Solihull 026D,E01010154,1111,753,358,235,48,75
2011,Solihull 026E,E01010155,1065,755,310,203,36,71
2011,Solihull 026F,E01010156,1135,786,349,249,48,52
2011,Solihull 027A,E01010212,1073,782,291,179,58,54
2011,Solihull 027B,E01010214,959,706,253,175,34,44
2011,Solihull 027C,E01010215,1251,915,336,215,52,69
2011,Solihull 027D,E01010216,1161,925,236,132,39,65
2011,Solihull 028A,E01010150,1146,816,330,252,33,45
2011,Solihull 028B,E01010184,997,716,281,146,37,98
2011,Solihull 028C,E01010185,1062,720,342,213,59,70
2011,Solihull 028D,E01010186,1316,1002,314,184,59,71
2011,Solihull 028E,E01010187,1058,816,242,114,72,56
2011,Solihull 028F,E01010188,1169,800,369,226,66,77
2011,Solihull 029A,E01010180,965,684,281,211,26,44
2011,Solihull 029B,E01010181,1412,1096,316,185,45,86
2011,Solihull 029D,E01010183,1009,725,284,212,35,37
2011,Solihull 029E,E01010189,1164,847,317,207,48,62
2011,Solihull 029F,E01032885,1010,914,96,28,23,45
2011,Solihull 029G,E01032886,1471,1206,265,109,68,88
2011,Solihull 030A,E01010220,1186,876,310,182,48,80
2011,Solihull 030B,E01010223,868,644,224,108,37,79
2011,Solihull 030C,E01010225,1057,826,231,133,39,59
2011,Solihull 030D,E01032590,1264,906,358,172,69,117
2011,Walsall 001A,E01010301,1099,706,393,186,37,170
2011,Walsall 001B,E01010303,1143,792,351,192,40,119
2011,Walsall 001C,E01010306,1470,1070,400,188,52,160
2011,Walsall 001D,E01010307,1279,1005,274,138,57,79
2011,Walsall 002A,E01010302,1106,700,406,183,48,175
2011,Walsall 002B,E01010304,1275,816,459,286,42,131
2011,Walsall 002C,E01010305,994,619,375,150,58,167
2011,Walsall 002D,E01010308,927,571,356,180,25,151
2011,Walsall 003A,E01010345,837,540,297,224,17,56
2011,Walsall 003B,E01010346,1040,767,273,178,42,53
2011,Walsall 003C,E01010347,1042,649,393,183,34,176
2011,Walsall 003D,E01010350,1054,807,247,131,39,77
2011,Walsall 004A,E01010249,1312,961,351,177,32,142
2011,Walsall 004B,E01010250,1037,677,360,211,51,98
2011,Walsall 004C,E01010252,1275,843,432,237,54,141
2011,Walsall 004D,E01010254,1090,751,339,193,42,104
2011,Walsall 005A,E01010348,1013,688,325,182,37,106
2011,Walsall 005B,E01010349,891,546,345,223,35,87
2011,Walsall 005C,E01010351,1230,821,409,259,38,112
2011,Walsall 005D,E01010352,1169,746,423,299,47,77
2011,Walsall 006A,E01010284,1071,695,376,173,37,166
2011,Walsall 006B,E01010285,1211,775,436,271,35,130
2011,Walsall 006C,E01010286,1147,671,476,173,50,253
2011,Walsall 006D,E01010290,1193,728,465,274,40,151
2011,Walsall 007A,E01010251,1079,821,258,147,47,64
2011,Walsall 007B,E01010253,891,570,321,193,36,92
2011,Walsall 007C,E01010255,957,606,351,279,27,45
2011,Walsall 007D,E01010256,1127,809,318,195,37,86
2011,Walsall 007E,E01010257,907,616,291,218,28,45
2011,Walsall 008A,E01010292,1240,758,482,207,32,243
2011,Walsall 008B,E01010294,1072,663,409,152,50,207
2011,Walsall 008C,E01010296,1158,911,247,121,61,65
2011,Walsall 008D,E01010297,1054,749,305,197,40,68
2011,Walsall 009A,E01010291,949,612,337,121,43,173
2011,Walsall 009B,E01010293,1079,657,422,230,41,151
2011,Walsall 009C,E01010298,866,612,254,122,24,108
2011,Walsall 009D,E01010299,1043,656,387,108,63,216
2011,Walsall 009E,E01010300,1011,624,387,156,40,191
2011,Walsall 010A,E01010319,1102,823,279,148,67,64
2011,Walsall 010B,E01010321,1127,754,373,170,51,152
2011,Walsall 010C,E01010353,1093,681,412,246,43,123
2011,Walsall 010D,E01010354,1109,710,399,241,40,118
2011,Walsall 011A,E01010395,1093,822,271,135,60,76
2011,Walsall 011B,E01010397,1157,711,446,151,45,250
2011,Walsall 011C,E01010398,1272,967,305,171,47,87
2011,Walsall 011D,E01010399,1224,934,290,125,49,116
2011,Walsall 012A,E01010282,903,593,310,89,45,176
2011,Walsall 012B,E01010287,1023,667,356,182,38,136
2011,Walsall 012C,E01010288,1145,730,415,154,50,211
2011,Walsall 012D,E01010289,1134,659,475,181,51,243
2011,Walsall 013B,E01010277,1141,706,435,162,62,211
2011,Walsall 013D,E01010283,1307,854,453,113,77,263
2011,Walsall 013E,E01032889,1304,754,550,162,62,326
2011,Walsall 014A,E01010393,1138,756,382,247,40,95
2011,Walsall 014B,E01010394,1087,771,316,186,29,101
2011,Walsall 014C,E01010396,1124,785,339,172,42,125
2011,Walsall 014D,E01010400,1339,893,446,205,26,215
2011,Walsall 015A,E01010241,1595,1100,495,324,60,111
2011,Walsall 015B,E01010242,1128,744,384,198,35,151
2011,Walsall 015C,E01010243,987,672,315,224,31,60
2011,Walsall 015D,E01010244,1001,668,333,133,37,163
2011,Walsall 016A,E01010320,987,675,312,160,37,115
2011,Walsall 016B,E01010322,1092,791,301,157,31,113
2011,Walsall 016C,E01010323,1054,723,331,196,28,107
2011,Walsall 016D,E01010324,1117,807,310,132,49,129
2011,Walsall 017A,E01010271,1243,841,402,113,48,241
2011,Walsall 017B,E01010272,1111,673,438,139,47,252
2011,Walsall 017C,E01010273,1036,664,372,108,51,213
2011,Walsall 017D,E01010295,1061,674,387,170,39,178
2011,Walsall 018B,E01010279,1169,739,430,155,38,237
2011,Walsall 018D,E01010374,1194,729,465,105,76,284
2011,Walsall 018E,E01010375,1445,907,538,81,118,339
2011,Walsall 018F,E01032888,1810,1031,779,277,68,434
2011,Walsall 019A,E01010378,982,696,286,182,32,72
2011,Walsall 019B,E01010379,1008,650,358,250,34,74
2011,Walsall 019C,E01010382,1171,748,423,258,50,115
2011,Walsall 019D,E01010383,1015,676,339,134,31,174
2011,Walsall 020A,E01010376,1114,816,298,145,47,106
2011,Walsall 020B,E01010377,1072,740,332,153,45,134
2011,Walsall 020C,E01010380,1149,724,425,336,37,52
2011,Walsall 020D,E01010381,1110,748,362,174,47,141
2011,Walsall 021A,E01010267,1244,889,355,193,34,128
2011,Walsall 021B,E01010268,1176,695,481,103,86,292
2011,Walsall 021C,E01010274,1101,674,427,137,66,224
2011,Walsall 021D,E01010275,1038,647,391,156,42,193
2011,Walsall 022A,E01010245,1093,736,357,245,53,59
2011,Walsall 022B,E01010246,1136,812,324,200,52,72
2011,Walsall 022C,E01010247,1140,753,387,261,50,76
2011,Walsall 022D,E01010248,1182,812,370,244,53,73
2011,Walsall 022E,E01010388,1118,789,329,212,52,65
2011,Walsall 023A,E01010258,1164,723,441,165,54,222
2011,Walsall 023B,E01010259,1141,779,362,177,54,131
2011,Walsall 023C,E01010260,1116,755,361,157,42,162
2011,Walsall 023D,E01010266,988,624,364,120,64,180
2011,Walsall 024A,E01010317,1171,759,412,282,39,91
2011,Walsall 024B,E01010318,1168,751,417,164,81,172
2011,Walsall 024C,E01010325,1239,877,362,172,58,132
2011,Walsall 024D,E01010369,1425,919,506,136,105,265
2011,Walsall 025A,E01010401,1049,658,391,148,41,202
2011,Walsall 025B,E01010403,1228,879,349,94,64,191
2011,Walsall 025C,E01010404,1296,877,419,144,74,201
2011,Walsall 025D,E01010407,1206,774,432,220,64,148
2011,Walsall 025E,E01010408,1128,786,342,102,39,201
2011,Walsall 026A,E01010269,1036,578,458,68,78,312
2011,Walsall 026B,E01010270,1282,836,446,152,71,223
2011,Walsall 026C,E01010362,1165,712,453,132,92,229
2011,Walsall 026D,E01010363,1347,873,474,108,85,281
2011,Walsall 027A,E01010402,1237,897,340,158,50,132
2011,Walsall 027B,E01010405,1254,880,374,138,49,187
2011,Walsall 027C,E01010406,1878,1296,582,183,92,307
2011,Walsall 027D,E01010409,1214,815,399,161,49,189
2011,Walsall 028A,E01010385,1158,811,347,225,60,62
2011,Walsall 028B,E01010386,1064,761,303,231,29,43
2011,Walsall 028C,E01010387,1138,795,343,231,61,51
2011,Walsall 028D,E01010392,1107,791,316,218,45,53
2011,Walsall 029A,E01010326,1211,835,376,172,77,127
2011,Walsall 029B,E01010327,1125,761,364,83,76,205
2011,Walsall 029C,E01010328,1039,707,332,194,66,72
2011,Walsall 029D,E01010330,1031,669,362,136,78,148
2011,Walsall 030A,E01010368,1467,981,486,116,53,317
2011,Walsall 030B,E01010370,1351,887,464,118,83,263
2011,Walsall 030C,E01010371,1619,953,666,94,164,408
2011,Walsall 030D,E01010372,1161,684,477,131,108,238
2011,Walsall 030E,E01010373,1449,893,556,139,300,117
2011,Walsall 031A,E01010361,1103,779,324,136,54,134
2011,Walsall 031B,E01010364,1021,615,406,98,85,223
2011,Walsall 031C,E01010365,1035,593,442,113,78,251
2011,Walsall 031D,E01010366,1211,702,509,155,89,265
2011,Walsall 031E,E01010367,1163,666,497,156,73,268
2011,Walsall 032A,E01010384,1096,805,291,193,41,57
2011,Walsall 032B,E01010389,1098,717,381,240,68,73
2011,Walsall 032C,E01010390,1318,937,381,271,42,68
2011,Walsall 032D,E01010391,1474,1067,407,271,60,76
2011,Walsall 033A,E01010261,1149,747,402,114,59,229
2011,Walsall 033B,E01010263,1151,671,480,107,73,300
2011,Walsall 033C,E01010264,1139,714,425,158,66,201
2011,Walsall 033D,E01010265,1282,803,479,111,78,290
2011,Walsall 034A,E01010336,1137,704,433,147,90,196
2011,Walsall 034B,E01010340,1178,645,533,107,96,330
2011,Walsall 034C,E01010341,1124,570,554,118,110,326
2011,Walsall 034D,E01010342,1076,600,476,71,117,288
2011,Walsall 034E,E01010343,1023,588,435,101,84,250
2011,Walsall 034F,E01010344,1107,601,506,151,89,266
2011,Walsall 035A,E01010331,1222,763,459,327,70,62
2011,Walsall 035B,E01010332,1305,903,402,226,80,96
2011,Walsall 035C,E01010333,1184,787,397,242,73,82
2011,Walsall 035D,E01010334,1126,756,370,223,71,76
2011,Walsall 036A,E01010262,1139,817,322,123,43,156
2011,Walsall 036B,E01010309,1319,890,429,137,76,216
2011,Walsall 036C,E01010311,1157,749,408,150,56,202
2011,Walsall 036D,E01010316,1144,725,419,141,41,237
2011,Walsall 037A,E01010335,1145,742,403,100,81,222
2011,Walsall 037B,E01010337,1009,709,300,131,51,118
2011,Walsall 037C,E01010338,1231,783,448,109,91,248
2011,Walsall 037D,E01010339,1077,729,348,136,66,146
2011,Walsall 038A,E01010310,1201,761,440,144,77,219
2011,Walsall 038B,E01010312,1198,816,382,136,59,187
2011,Walsall 038C,E01010313,1038,662,376,125,55,196
2011,Walsall 038D,E01010314,1125,678,447,176,72,199
2011,Walsall 038E,E01010315,955,619,336,148,43,145
2011,Walsall 039A,E01010329,1106,769,337,207,71,59
2011,Walsall 039B,E01010355,995,669,326,225,36,65
2011,Walsall 039C,E01010356,1092,762,330,212,50,68
2011,Walsall 039D,E01010357,1380,1035,345,227,42,76
2011,Walsall 039E,E01010358,1059,781,278,157,49,72
2011,Walsall 039F,E01010359,1123,817,306,166,57,83
2011,Walsall 039G,E01010360,1068,762,306,178,51,77
2011,Wolverhampton 001A,E01010434,1233,864,369,154,60,155
2011,Wolverhampton 001B,E01010436,1104,811,293,178,45,70
2011,Wolverhampton 001C,E01010437,1000,789,211,135,31,45
2011,Wolverhampton 001D,E01010438,1026,687,339,222,43,74
2011,Wolverhampton 001E,E01010439,936,621,315,157,47,111
2011,Wolverhampton 001F,E01010440,1073,662,411,168,66,177
2011,Wolverhampton 001G,E01010441,998,628,370,164,53,153
2011,Wolverhampton 002A,E01010495,1181,782,399,200,45,154
2011,Wolverhampton 002B,E01010497,966,717,249,129,44,76
2011,Wolverhampton 002C,E01010499,985,715,270,114,49,107
2011,Wolverhampton 002D,E01010500,934,614,320,87,67,166
2011,Wolverhampton 003A,E01010496,1025,731,294,108,45,141
2011,Wolverhampton 003B,E01010498,1176,932,244,126,45,73
2011,Wolverhampton 003C,E01010541,1064,699,365,102,58,205
2011,Wolverhampton 003D,E01010543,1023,675,348,97,49,202
2011,Wolverhampton 004A,E01010456,943,536,407,61,81,265
2011,Wolverhampton 004B,E01010457,1105,784,321,155,39,127
2011,Wolverhampton 004C,E01010462,1099,697,402,135,58,209
2011,Wolverhampton 004D,E01010481,1053,638,415,130,72,213
2011,Wolverhampton 005A,E01010555,1050,670,380,177,39,164
2011,Wolverhampton 005B,E01010556,1061,749,312,131,45,136
2011,Wolverhampton 005C,E01010557,1092,700,392,271,37,84
2011,Wolverhampton 005D,E01010559,999,631,368,194,40,134
2011,Wolverhampton 005E,E01010560,1152,723,429,200,42,187
2011,Wolverhampton 006A,E01010435,959,622,337,93,46,198
2011,Wolverhampton 006B,E01010501,1006,690,316,145,50,121
2011,Wolverhampton 006C,E01010502,973,709,264,112,56,96
2011,Wolverhampton 006D,E01010503,993,711,282,110,48,124
2011,Wolverhampton 007A,E01010482,913,539,374,128,71,175
2011,Wolverhampton 007B,E01010483,934,559,375,85,67,223
2011,Wolverhampton 007C,E01010484,961,601,360,95,57,208
2011,Wolverhampton 007D,E01010485,1112,691,421,92,61,268
2011,Wolverhampton 008A,E01010458,1223,873,350,170,38,142
2011,Wolverhampton 008B,E01010459,1208,890,318,131,59,128
2011,Wolverhampton 008C,E01010460,1186,867,319,161,50,108
2011,Wolverhampton 008D,E01010461,1150,835,315,164,45,106
2011,Wolverhampton 008E,E01010566,1236,813,423,206,50,167
2011,Wolverhampton 009A,E01010539,1177,883,294,128,54,112
2011,Wolverhampton 009B,E01010540,973,673,300,186,46,68
2011,Wolverhampton 009C,E01010542,1097,829,268,115,49,104
2011,Wolverhampton 009D,E01010544,1022,720,302,170,54,78
2011,Wolverhampton 009E,E01010545,1199,887,312,162,48,102
2011,Wolverhampton 010A,E01010554,1012,681,331,214,32,85
2011,Wolverhampton 010B,E01010558,1203,794,409,263,34,112
2011,Wolverhampton 010C,E01010562,1133,732,401,214,32,155
2011,Wolverhampton 010D,E01010563,1081,722,359,156,41,162
2011,Wolverhampton 010E,E01010567,1052,718,334,127,44,163
2011,Wolverhampton 011A,E01010478,996,624,372,64,66,242
2011,Wolverhampton 011B,E01010479,1148,770,378,139,56,183
2011,Wolverhampton 011C,E01010480,901,640,261,89,48,124
2011,Wolverhampton 011D,E01010486,1131,666,465,81,104,280
2011,Wolverhampton 012A,E01010474,1140,736,404,170,67,167
2011,Wolverhampton 012B,E01010561,1181,821,360,236,44,80
2011,Wolverhampton 012C,E01010564,1450,1031,419,108,79,232
2011,Wolverhampton 012D,E01010565,1414,980,434,245,56,133
2011,Wolverhampton 013A,E01010522,1208,777,431,50,101,280
2011,Wolverhampton 013B,E01010523,1194,850,344,104,88,152
2011,Wolverhampton 013C,E01010524,1069,643,426,114,96,216
2011,Wolverhampton 013D,E01010525,1000,663,337,69,62,206
2011,Wolverhampton 014A,E01010546,1026,691,335,178,70,87
2011,Wolverhampton 014B,E01010547,1101,707,394,266,64,64
2011,Wolverhampton 014C,E01010548,903,604,299,197,33,69
2011,Wolverhampton 014D,E01010549,1108,771,337,174,66,97
2011,Wolverhampton 014E,E01010553,1105,745,360,226,48,86
2011,Wolverhampton 015A,E01010471,1259,835,424,131,62,231
2011,Wolverhampton 015B,E01010472,1380,936,444,98,96,250
2011,Wolverhampton 015C,E01010473,1739,1079,660,115,145,400
2011,Wolverhampton 015D,E01010475,1207,866,341,148,59,134
2011,Wolverhampton 015E,E01010476,1404,979,425,119,66,240
2011,Wolverhampton 015F,E01010477,1244,848,396,136,88,172
2011,Wolverhampton 016A,E01010526,1040,649,391,67,120,204
2011,Wolverhampton 016B,E01010527,1370,838,532,115,139,278
2011,Wolverhampton 016C,E01010528,1621,806,815,51,615,149
2011,Wolverhampton 016D,E01010529,1317,781,536,79,263,194
2011,Wolverhampton 017A,E01010506,1395,1038,357,102,102,153
2011,Wolverhampton 017B,E01010508,1161,830,331,61,83,187
2011,Wolverhampton 017C,E01010510,1266,954,312,123,64,125
2011,Wolverhampton 017D,E01010511,1209,789,420,102,123,195
2011,Wolverhampton 017E,E01010512,1080,758,322,108,81,133
2011,Wolverhampton 018A,E01010442,953,608,345,137,50,158
2011,Wolverhampton 018B,E01010443,1139,708,431,117,88,226
2011,Wolverhampton 018C,E01010444,1035,638,397,223,49,125
2011,Wolverhampton 018D,E01010445,954,571,383,97,66,220
2011,Wolverhampton 018E,E01010447,1336,911,425,202,61,162
2011,Wolverhampton 018F,E01010448,1116,740,376,176,48,152
2011,Wolverhampton 019A,E01010509,1056,722,334,180,42,112
2011,Wolverhampton 019B,E01010550,1185,800,385,251,59,75
2011,Wolverhampton 019C,E01010551,1204,836,368,238,40,90
2011,Wolverhampton 019D,E01010552,1292,888,404,205,56,143
2011,Wolverhampton 020A,E01010463,1245,853,392,107,68,217
2011,Wolverhampton 020B,E01010464,1146,634,512,168,64,280
2011,Wolverhampton 020C,E01010465,1138,797,341,93,74,174
2011,Wolverhampton 020D,E01010466,1068,693,375,70,83,222
2011,Wolverhampton 020E,E01010470,1033,658,375,133,63,179
2011,Wolverhampton 020F,E01010521,2214,1393,821,83,566,172
2011,Wolverhampton 021A,E01010487,1107,812,295,182,46,67
2011,Wolverhampton 021B,E01010488,1011,684,327,185,41,101
2011,Wolverhampton 021C,E01010493,1095,783,312,157,64,91
2011,Wolverhampton 021D,E01010504,978,629,349,216,69,64
2011,Wolverhampton 021E,E01010505,971,696,275,178,38,59
2011,Wolverhampton 021F,E01010507,1010,675,335,230,41,64
2011,Wolverhampton 022A,E01010418,1168,864,304,150,45,109
2011,Wolverhampton 022B,E01010421,1120,636,484,146,88,250
2011,Wolverhampton 022C,E01010423,1127,665,462,198,64,200
2011,Wolverhampton 022D,E01010424,1180,825,355,179,55,121
2011,Wolverhampton 023A,E01010417,1178,737,441,192,44,205
2011,Wolverhampton 023B,E01010419,1016,660,356,157,57,142
2011,Wolverhampton 023C,E01010420,928,606,322,152,39,131
2011,Wolverhampton 023D,E01010425,983,644,339,158,44,137
2011,Wolverhampton 023E,E01010446,1194,767,427,199,66,162
2011,Wolverhampton 026A,E01010467,1181,794,387,156,70,161
2011,Wolverhampton 026B,E01010468,1064,781,283,127,64,92
2011,Wolverhampton 026C,E01010469,1090,824,266,124,54,88
2011,Wolverhampton 026D,E01010516,1074,764,310,168,64,78
2011,Wolverhampton 026E,E01010518,1145,802,343,182,68,93
2011,Wolverhampton 027A,E01010414,1405,905,500,164,61,275
2011,Wolverhampton 027B,E01010415,1166,736,430,113,80,237
2011,Wolverhampton 027C,E01010416,1171,661,510,200,54,256
2011,Wolverhampton 027D,E01010422,1232,808,424,185,64,175
2011,Wolverhampton 028A,E01010489,1120,709,411,222,61,128
2011,Wolverhampton 028B,E01010490,1233,825,408,155,45,208
2011,Wolverhampton 028C,E01010491,1039,718,321,163,48,110
2011,Wolverhampton 028D,E01010492,1037,788,249,152,44,53
2011,Wolverhampton 028E,E01010494,1131,813,318,187,60,71
2011,Wolverhampton 029A,E01010449,1690,1150,540,160,113,267
2011,Wolverhampton 029B,E01010450,1215,717,498,164,64,270
2011,Wolverhampton 029C,E01010451,1183,872,311,102,64,145
2011,Wolverhampton 029D,E01010452,1118,727,391,119,59,213
2011,Wolverhampton 029E,E01010455,1313,790,523,157,78,288
2011,Wolverhampton 030A,E01010427,1222,784,438,134,75,229
2011,Wolverhampton 030B,E01010431,1209,835,374,133,99,142
2011,Wolverhampton 030C,E01010432,1172,829,343,150,76,117
2011,Wolverhampton 030D,E01010519,1166,833,333,147,61,125
2011,Wolverhampton 030E,E01010520,1206,850,356,227,58,71
2011,Wolverhampton 031A,E01010513,1028,668,360,249,39,72
2011,Wolverhampton 031B,E01010514,1182,959,223,131,36,56
2011,Wolverhampton 031C,E01010515,1198,889,309,187,48,74
2011,Wolverhampton 031D,E01010517,1179,819,360,160,78,122
2011,Wolverhampton 032A,E01010533,1177,784,393,124,65,204
2011,Wolverhampton 032B,E01010535,1043,665,378,145,65,168
2011,Wolverhampton 032C,E01010536,1158,795,363,209,51,103
2011,Wolverhampton 032D,E01010537,1073,709,364,269,30,65
2011,Wolverhampton 033A,E01010410,1194,724,470,180,52,238
2011,Wolverhampton 033B,E01010411,1162,784,378,154,57,167
2011,Wolverhampton 033C,E01010412,1469,1017,452,172,58,222
2011,Wolverhampton 033D,E01010413,1155,674,481,199,48,234
2011,Wolverhampton 034A,E01010531,1212,799,413,208,50,155
2011,Wolverhampton 034B,E01010532,1201,762,439,162,60,217
2011,Wolverhampton 034C,E01010534,1196,873,323,107,81,135
2011,Wolverhampton 034D,E01010538,1150,811,339,157,55,127
2011,Wolverhampton 035A,E01010426,1121,747,374,117,139,118
2011,Wolverhampton 035B,E01010428,1064,657,407,76,109,222
2011,Wolverhampton 035C,E01010429,921,559,362,122,91,149
2011,Wolverhampton 035D,E01010430,1253,822,431,149,85,197
2011,Wolverhampton 035E,E01010433,795,464,331,87,64,180
2011,Wolverhampton 035F,E01010453,1290,820,470,151,81,238
2011,Wolverhampton 035G,E01010454,1159,706,453,136,93,224
2011,Wolverhampton 035H,E01010530,993,648,345,75,53,217
2011,Bromsgrove 001A,E01032138,937,654,283,185,50,48
2011,Bromsgrove 001B,E01032139,1092,811,281,177,45,59
2011,Bromsgrove 001C,E01032140,1113,786,327,209,60,58
2011,Bromsgrove 001D,E01032141,1034,742,292,168,55,69
2011,Bromsgrove 002A,E01032136,956,673,283,161,70,52
2011,Bromsgrove 002B,E01032137,1059,771,288,162,42,84
2011,Bromsgrove 002C,E01032168,782,536,246,160,28,58
2011,Bromsgrove 002D,E01032169,830,603,227,165,20,42
2011,Bromsgrove 002E,E01032176,1640,1216,424,300,53,71
2011,Bromsgrove 003A,E01032126,1535,1005,530,386,54,90
2011,Bromsgrove 003B,E01032170,1063,836,227,108,52,67
2011,Bromsgrove 003C,E01032171,1033,708,325,213,45,67
2011,Bromsgrove 003D,E01032172,1092,786,306,189,46,71
2011,Bromsgrove 004A,E01032133,1148,788,360,214,40,106
2011,Bromsgrove 004B,E01032135,1265,930,335,215,59,61
2011,Bromsgrove 004C,E01032145,1062,758,304,220,32,52
2011,Bromsgrove 004D,E01032147,832,532,300,220,27,53
2011,Bromsgrove 005A,E01032134,1180,836,344,210,39,95
2011,Bromsgrove 005B,E01032146,1193,852,341,242,38,61
2011,Bromsgrove 005C,E01032177,843,621,222,149,26,47
2011,Bromsgrove 005D,E01032178,929,625,304,225,32,47
2011,Bromsgrove 006A,E01032142,1137,840,297,198,48,51
2011,Bromsgrove 006B,E01032143,1059,728,331,228,47,56
2011,Bromsgrove 006C,E01032144,1201,847,354,215,60,79
2011,Bromsgrove 006D,E01032149,898,642,256,154,40,62
2011,Bromsgrove 007A,E01032127,1210,902,308,181,41,86
2011,Bromsgrove 007B,E01032128,1085,773,312,185,46,81
2011,Bromsgrove 007C,E01032129,1002,751,251,116,53,82
2011,Bromsgrove 007D,E01032152,944,655,289,167,25,97
2011,Bromsgrove 008A,E01032148,777,589,188,114,30,44
2011,Bromsgrove 008B,E01032150,1118,773,345,241,42,62
2011,Bromsgrove 008C,E01032151,1037,767,270,188,44,38
2011,Bromsgrove 008D,E01032153,1105,799,306,189,33,84
2011,Bromsgrove 008E,E01032155,1240,958,282,174,60,48
2011,Bromsgrove 009A,E01032122,1539,1039,500,271,66,163
2011,Bromsgrove 009B,E01032123,1133,783,350,255,43,52
2011,Bromsgrove 009C,E01032124,1093,797,296,190,35,71
2011,Bromsgrove 009D,E01032125,1003,763,240,152,33,55
2011,Bromsgrove 010A,E01032154,1326,1101,225,109,44,72
2011,Bromsgrove 010B,E01032159,1242,903,339,206,41,92
2011,Bromsgrove 010C,E01032160,1265,937,328,213,32,83
2011,Bromsgrove 010D,E01032161,1044,721,323,135,47,141
2011,Bromsgrove 011A,E01032156,1313,831,482,126,269,87
2011,Bromsgrove 011B,E01032157,1049,681,368,227,21,120
2011,Bromsgrove 011C,E01032173,1253,969,284,162,42,80
2011,Bromsgrove 011D,E01032175,1221,905,316,204,43,69
2011,Bromsgrove 012A,E01032158,1077,750,327,248,31,48
2011,Bromsgrove 012B,E01032162,1332,942,390,270,47,73
2011,Bromsgrove 012D,E01033059,1125,945,180,73,44,63
2011,Bromsgrove 012E,E01033061,1289,1013,276,166,46,64
2011,Bromsgrove 013A,E01032130,1980,1636,344,162,67,115
2011,Bromsgrove 013B,E01032131,1212,847,365,108,71,186
2011,Bromsgrove 013C,E01032132,1466,1077,389,174,52,163
2011,Bromsgrove 013D,E01032174,1134,822,312,146,45,121
2011,Bromsgrove 014C,E01032166,1571,1110,461,321,46,94
2011,Bromsgrove 014E,E01033060,1844,772,1072,131,50,891
2011,Bromsgrove 014F,E01033062,1861,1451,410,228,93,89
2011,Bromsgrove 014G,E01033243,1004,776,228,126,46,56
2011,Malvern Hills 001A,E01032193,1648,1099,549,350,62,137
2011,Malvern Hills 001B,E01032212,1417,1004,413,276,43,94
2011,Malvern Hills 001C,E01032213,1191,789,402,229,103,70
2011,Malvern Hills 001D,E01032214,1499,1036,463,260,46,157
2011,Malvern Hills 002A,E01032181,1534,1012,522,361,47,114
2011,Malvern Hills 002B,E01032190,1335,905,430,287,44,99
2011,Malvern Hills 002C,E01032199,1246,866,380,243,50,87
2011,Malvern Hills 002D,E01032223,1506,1077,429,299,56,74
2011,Malvern Hills 003A,E01032179,1257,881,376,244,38,94
2011,Malvern Hills 003B,E01032180,1379,937,442,292,39,111
2011,Malvern Hills 003C,E01032182,1407,1025,382,253,52,77
2011,Malvern Hills 003D,E01032183,1019,721,298,207,35,56
2011,Malvern Hills 004A,E01032194,1046,708,338,142,54,142
2011,Malvern Hills 004B,E01032195,1127,797,330,205,35,90
2011,Malvern Hills 004C,E01032196,1119,800,319,192,31,96
2011,Malvern Hills 004D,E01032197,1070,726,344,183,51,110
2011,Malvern Hills 005A,E01032205,775,507,268,177,26,65
2011,Malvern Hills 005B,E01032206,875,558,317,232,27,58
2011,Malvern Hills 005C,E01032207,1034,755,279,194,31,54
2011,Malvern Hills 005D,E01032217,1115,731,384,250,46,88
2011,Malvern Hills 006A,E01032188,1377,1004,373,176,59,138
2011,Malvern Hills 006B,E01032189,1407,994,413,279,47,87
2011,Malvern Hills 006C,E01032220,1131,858,273,153,40,80
2011,Malvern Hills 006D,E01032221,1087,731,356,192,117,47
2011,Malvern Hills 006E,E01032222,1021,769,252,125,37,90
2011,Malvern Hills 007A,E01032201,1066,681,385,190,48,147
2011,Malvern Hills 007B,E01032202,1188,758,430,166,61,203
2011,Malvern Hills 007C,E01032203,1087,768,319,156,44,119
2011,Malvern Hills 007D,E01032204,1066,651,415,114,57,244
2011,Malvern Hills 008A,E01032191,1700,1214,486,338,64,84
2011,Malvern Hills 008B,E01032192,1117,729,388,248,45,95
2011,Malvern Hills 008C,E01032211,1283,854,429,314,35,80
2011,Malvern Hills 009A,E01032184,1045,635,410,309,31,70
2011,Malvern Hills 009B,E01032185,996,601,395,300,31,64
2011,Malvern Hills 009C,E01032186,980,582,398,148,168,82
2011,Malvern Hills 009D,E01032187,1165,792,373,170,41,162
2011,Malvern Hills 010A,E01032208,1037,714,323,214,43,66
2011,Malvern Hills 010B,E01032209,1068,519,549,163,325,61
2011,Malvern Hills 010C,E01032210,769,490,279,205,23,51
2011,Malvern Hills 010D,E01032218,1173,751,422,230,104,88
2011,Malvern Hills 010E,E01032219,1230,859,371,278,27,66
2011,Malvern Hills 011A,E01032198,1522,1029,493,291,104,98
2011,Malvern Hills 011B,E01032200,1485,1023,462,313,53,96
2011,Malvern Hills 011C,E01032215,796,498,298,177,29,92
2011,Malvern Hills 011D,E01032216,1117,823,294,167,34,93
2011,Redditch 001A,E01032226,1508,1159,349,216,49,84
2011,Redditch 001B,E01032227,843,588,255,202,24,29
2011,Redditch 001C,E01032243,1147,881,266,180,49,37
2011,Redditch 001D,E01032244,946,712,234,135,29,70
2011,Redditch 002A,E01032240,1010,740,270,95,40,135
2011,Redditch 002B,E01032241,1002,748,254,82,55,117
2011,Redditch 002C,E01032242,1046,782,264,106,33,125
2011,Redditch 002D,E01032245,1036,719,317,107,48,162
2011,Redditch 003A,E01032232,1213,891,322,90,50,182
2011,Redditch 003B,E01032233,2212,1848,364,172,66,126
2011,Redditch 003C,E01032234,1210,786,424,160,55,209
2011,Redditch 003D,E01032235,1203,793,410,162,56,192
2011,Redditch 004A,E01032224,1312,952,360,92,77,191
2011,Redditch 004B,E01032225,819,545,274,110,31,133
2011,Redditch 004C,E01032239,1303,994,309,63,58,188
2011,Redditch 004D,E01032262,1544,1085,459,144,83,232
2011,Redditch 005A,E01032273,1105,841,264,163,43,58
2011,Redditch 005B,E01032275,1056,797,259,137,27,95
2011,Redditch 005C,E01032277,1010,767,243,90,41,112
2011,Redditch 005D,E01032278,1199,818,381,99,50,232
2011,Redditch 006A,E01032236,1342,979,363,157,48,158
2011,Redditch 006B,E01032237,1163,872,291,151,51,89
2011,Redditch 006C,E01032238,1042,781,261,139,34,88
2011,Redditch 006D,E01032264,1284,927,357,181,55,121
2011,Redditch 007A,E01032255,996,761,235,150,28,57
2011,Redditch 007B,E01032263,1316,911,405,225,64,116
2011,Redditch 007C,E01032266,1261,940,321,196,50,75
2011,Redditch 007D,E01032274,1021,806,215,137,21,57
2011,Redditch 008A,E01032259,1021,778,243,155,32,56
2011,Redditch 008B,E01032269,1222,910,312,195,36,81
2011,Redditch 008C,E01032270,1003,751,252,151,45,56
2011,Redditch 008D,E01032271,1008,798,210,134,30,46
2011,Redditch 008E,E01032272,939,723,216,154,17,45
2011,Redditch 009A,E01032253,994,751,243,150,29,64
2011,Redditch 009B,E01032265,1136,744,392,182,77,133
2011,Redditch 009C,E01032267,1228,906,322,135,46,141
2011,Redditch 009D,E01032268,979,763,216,142,31,43
2011,Redditch 009E,E01032276,1171,914,257,163,32,62
2011,Redditch 010A,E01032250,988,677,311,115,48,148
2011,Redditch 010B,E01032251,1316,995,321,118,55,148
2011,Redditch 010C,E01032252,983,641,342,95,57,190
2011,Redditch 010D,E01032254,1144,840,304,177,35,92
2011,Redditch 011A,E01032256,1130,798,332,183,45,104
2011,Redditch 011B,E01032257,1119,888,231,132,42,57
2011,Redditch 011C,E01032258,1093,793,300,187,34,79
2011,Redditch 011D,E01032260,996,671,325,152,44,129
2011,Redditch 012A,E01032246,1041,766,275,189,32,54
2011,Redditch 012B,E01032247,1044,777,267,144,35,88
2011,Redditch 012C,E01032248,1120,877,243,127,55,61
2011,Redditch 012D,E01032249,1184,934,250,118,33,99
2011,Redditch 012E,E01032261,1027,729,298,208,37,53
2011,Redditch 013A,E01032228,1031,798,233,145,30,58
2011,Redditch 013B,E01032229,1132,845,287,140,26,121
2011,Redditch 013C,E01032230,1092,830,262,168,38,56
2011,Redditch 013D,E01032231,1233,900,333,206,58,69
2011,Worcester 001A,E01032296,1207,945,262,146,31,85
2011,Worcester 001B,E01032297,1145,876,269,180,31,58
2011,Worcester 001C,E01032298,1273,884,389,296,32,61
2011,Worcester 001D,E01032299,1146,911,235,141,34,60
2011,Worcester 001E,E01032300,1118,771,347,232,38,77
2011,Worcester 002A,E01032303,800,515,285,108,44,133
2011,Worcester 002B,E01032304,985,652,333,131,29,173
2011,Worcester 002C,E01032331,1040,657,383,164,29,190
2011,Worcester 002D,E01032332,870,544,326,93,26,207
2011,Worcester 003A,E01032330,946,760,186,103,20,63
2011,Worcester 003B,E01032334,1793,1506,287,123,58,106
2011,Worcester 003C,E01032335,1143,960,183,93,31,59
2011,Worcester 003D,E01032336,1214,1016,198,94,37,67
2011,Worcester 004A,E01032279,960,719,241,105,33,103
2011,Worcester 004B,E01032312,1145,902,243,105,38,100
2011,Worcester 004C,E01032327,1201,912,289,153,49,87
2011,Worcester 004D,E01032328,1098,815,283,138,37,108
2011,Worcester 004E,E01032329,1513,1080,433,277,45,111
2011,Worcester 005A,E01032301,1056,725,331,176,33,122
2011,Worcester 005B,E01032302,906,597,309,100,37,172
2011,Worcester 005C,E01032310,1090,815,275,102,42,131
2011,Worcester 005D,E01032311,1075,703,372,136,51,185
2011,Worcester 005E,E01032313,921,610,311,83,52,176
2011,Worcester 005F,E01032333,1295,900,395,80,45,270
2011,Worcester 006A,E01032314,880,630,250,109,110,31
2011,Worcester 006B,E01032315,1819,1015,804,139,588,77
2011,Worcester 006C,E01032316,842,552,290,211,42,37
2011,Worcester 006D,E01032317,1122,779,343,212,76,55
2011,Worcester 007A,E01032280,1216,958,258,114,55,89
2011,Worcester 007B,E01032281,1086,872,214,97,51,66
2011,Worcester 007C,E01032282,1468,1148,320,91,110,119
2011,Worcester 007E,E01033246,908,659,249,125,48,76
2011,Worcester 007F,E01033247,1016,745,271,31,185,55
2011,Worcester 008A,E01032337,1463,1203,260,129,54,77
2011,Worcester 008B,E01032338,1501,1277,224,75,58,91
2011,Worcester 008C,E01032339,1175,967,208,96,49,63
2011,Worcester 009A,E01032318,1049,690,359,88,73,198
2011,Worcester 009B,E01032319,1302,880,422,244,118,60
2011,Worcester 009C,E01032320,1392,965,427,116,231,80
2011,Worcester 009D,E01032321,1072,728,344,139,82,123
2011,Worcester 009E,E01032322,1368,908,460,201,143,116
2011,Worcester 010A,E01032305,1257,979,278,133,49,96
2011,Worcester 010B,E01032306,1115,827,288,89,52,147
2011,Worcester 010C,E01032307,1254,851,403,146,66,191
2011,Worcester 010D,E01032309,1040,752,288,130,41,117
2011,Worcester 011A,E01032285,1197,953,244,123,37,84
2011,Worcester 011B,E01032292,1226,898,328,66,80,182
2011,Worcester 011D,E01032294,1028,761,267,122,40,105
2011,Worcester 011E,E01033248,882,653,229,77,59,93
2011,Worcester 011F,E01033249,1009,748,261,81,52,128
2011,Worcester 012A,E01032286,1279,946,333,182,60,91
2011,Worcester 012B,E01032287,1168,892,276,145,56,75
2011,Worcester 012C,E01032288,1111,827,284,159,34,91
2011,Worcester 012D,E01032289,1105,735,370,264,39,67
2011,Worcester 012E,E01032290,1116,777,339,267,23,49
2011,Worcester 013A,E01032283,1164,801,363,205,48,110
2011,Worcester 013B,E01032284,1437,1002,435,269,94,72
2011,Worcester 013C,E01032295,1919,1544,375,166,67,142
2011,Worcester 013D,E01032308,1142,815,327,207,41,79
2011,Worcester 014A,E01032323,1067,819,248,168,27,53
2011,Worcester 014B,E01032324,1048,880,168,86,33,49
2011,Worcester 014C,E01032325,1178,996,182,85,35,62
2011,Worcester 014D,E01032326,1021,759,262,172,38,52
2011,Wychavon 001A,E01032354,1778,1305,473,255,67,151
2011,Wychavon 001B,E01032386,1018,731,287,195,36,56
2011,Wychavon 001C,E01032387,1026,730,296,174,40,82
2011,Wychavon 001D,E01032401,1055,742,313,217,29,67
2011,Wychavon 002A,E01032368,910,592,318,135,35,148
2011,Wychavon 002B,E01032369,1069,755,314,98,47,169
2011,Wychavon 002C,E01032370,942,673,269,150,36,83
2011,Wychavon 002D,E01032371,995,716,279,145,32,102
2011,Wychavon 003A,E01032359,1170,789,381,249,23,109
2011,Wychavon 003B,E01032360,1383,964,419,248,43,128
2011,Wychavon 003C,E01032361,1296,975,321,232,29,60
2011,Wychavon 004A,E01032357,853,607,246,146,27,73
2011,Wychavon 004B,E01032358,1079,754,325,169,44,112
2011,Wychavon 004C,E01032365,1272,855,417,243,44,130
2011,Wychavon 004D,E01032367,1017,710,307,206,33,68
2011,Wychavon 005A,E01032362,1400,1049,351,216,50,85
2011,Wychavon 005B,E01032363,1198,884,314,232,40,42
2011,Wychavon 005C,E01032364,1255,948,307,204,53,50
2011,Wychavon 005D,E01032366,1155,810,345,243,28,74
2011,Wychavon 006A,E01032399,1219,883,336,210,41,85
2011,Wychavon 006B,E01032400,1607,1186,421,286,47,88
2011,Wychavon 006C,E01032404,1769,1221,548,344,71,133
2011,Wychavon 007A,E01032345,1063,800,263,168,39,56
2011,Wychavon 007B,E01032346,981,710,271,180,37,54
2011,Wychavon 007C,E01032395,919,672,247,160,33,54
2011,Wychavon 007D,E01032417,1100,777,323,209,52,62
2011,Wychavon 008A,E01032392,1160,779,381,274,42,65
2011,Wychavon 008B,E01032393,1130,793,337,244,34,59
2011,Wychavon 008C,E01032394,912,633,279,199,37,43
2011,Wychavon 008D,E01032416,823,584,239,161,29,49
2011,Wychavon 009A,E01032355,983,694,289,173,36,80
2011,Wychavon 009B,E01032356,821,625,196,132,20,44
2011,Wychavon 009C,E01032402,1038,860,178,83,54,41
2011,Wychavon 009D,E01032403,1056,809,247,163,28,56
2011,Wychavon 010A,E01032375,817,537,280,183,30,67
2011,Wychavon 010B,E01032382,923,660,263,166,36,61
2011,Wychavon 010C,E01032383,1082,744,338,219,61,58
2011,Wychavon 010D,E01032410,1034,666,368,273,32,63
2011,Wychavon 010E,E01032411,1086,729,357,221,49,87
2011,Wychavon 011A,E01032390,1013,723,290,170,37,83
2011,Wychavon 011B,E01032391,827,598,229,126,30,73
2011,Wychavon 011C,E01032414,1111,734,377,234,40,103
2011,Wychavon 011D,E01032415,1348,870,478,166,41,271
2011,Wychavon 012A,E01032405,965,659,306,224,20,62
2011,Wychavon 012B,E01032406,980,694,286,175,31,80
2011,Wychavon 012C,E01032407,1021,718,303,166,51,86
2011,Wychavon 012D,E01032408,973,668,305,242,17,46
2011,Wychavon 012E,E01032409,1102,768,334,185,36,113
2011,Wychavon 013A,E01032340,1023,699,324,167,44,113
2011,Wychavon 013B,E01032341,1015,731,284,191,29,64
2011,Wychavon 013C,E01032349,1141,858,283,172,32,79
2011,Wychavon 013D,E01032350,774,582,192,125,17,50
2011,Wychavon 013E,E01032388,967,680,287,204,25,58
2011,Wychavon 013F,E01032389,903,614,289,149,33,107
2011,Wychavon 014A,E01032343,1825,1470,355,169,34,152
2011,Wychavon 014B,E01032377,1309,972,337,163,37,137
2011,Wychavon 014C,E01032378,1207,886,321,150,41,130
2011,Wychavon 015A,E01032376,1124,812,312,195,46,71
2011,Wychavon 015B,E01032384,984,716,268,133,38,97
2011,Wychavon 015C,E01032385,879,509,370,295,21,54
2011,Wychavon 015D,E01032396,1203,982,221,122,35,64
2011,Wychavon 016A,E01032342,1132,844,288,133,31,124
2011,Wychavon 016B,E01032344,1037,751,286,183,44,59
2011,Wychavon 016C,E01032379,1441,1160,281,158,48,75
2011,Wychavon 016D,E01032380,1121,791,330,214,34,82
2011,Wychavon 017A,E01032381,1408,1084,324,133,53,138
2011,Wychavon 017B,E01032397,1266,892,374,199,28,147
2011,Wychavon 017C,E01032398,1327,1119,208,72,51,85
2011,Wychavon 018A,E01032351,985,662,323,250,23,50
2011,Wychavon 018B,E01032352,1129,796,333,212,29,92
2011,Wychavon 018C,E01032353,1104,757,347,224,25,98
2011,Wychavon 018D,E01032374,976,681,295,197,33,65
2011,Wychavon 019A,E01032347,900,675,225,157,31,37
2011,Wychavon 019B,E01032348,871,620,251,174,24,53
2011,Wychavon 019C,E01032372,1073,732,341,237,32,72
2011,Wychavon 019D,E01032373,955,648,307,233,37,37
2011,Wychavon 019E,E01032412,892,634,258,176,22,60
2011,Wychavon 019F,E01032413,776,520,256,184,30,42
2011,Wyre Forest 001A,E01032431,1083,773,310,212,30,68
2011,Wyre Forest 001B,E01032432,1009,616,393,179,115,99
2011,Wyre Forest 001C,E01032433,921,668,253,172,28,53
2011,Wyre Forest 001D,E01032439,996,648,348,252,30,66
2011,Wyre Forest 001E,E01032440,812,547,265,149,27,89
2011,Wyre Forest 001F,E01032479,1558,979,579,384,38,157
2011,Wyre Forest 002A,E01032441,992,675,317,231,30,56
2011,Wyre Forest 002B,E01032442,1136,874,262,178,21,63
2011,Wyre Forest 002C,E01032443,987,637,350,270,26,54
2011,Wyre Forest 002D,E01032444,893,660,233,147,25,61
2011,Wyre Forest 002E,E01032445,1077,700,377,192,38,147
2011,Wyre Forest 003A,E01032436,1166,822,344,215,51,78
2011,Wyre Forest 003B,E01032438,1174,870,304,197,38,69
2011,Wyre Forest 003C,E01032446,1020,733,287,188,38,61
2011,Wyre Forest 003D,E01032447,1117,906,211,102,35,74
2011,Wyre Forest 003E,E01032448,896,650,246,156,32,58
2011,Wyre Forest 004A,E01032434,1198,811,387,104,56,227
2011,Wyre Forest 004B,E01032435,1070,734,336,141,49,146
2011,Wyre Forest 004C,E01032437,1304,896,408,196,54,158
2011,Wyre Forest 004D,E01032450,1663,1245,418,165,50,203
2011,Wyre Forest 005A,E01032430,1240,853,387,241,42,104
2011,Wyre Forest 005B,E01032480,1355,930,425,287,45,93
2011,Wyre Forest 005C,E01032481,1297,783,514,309,44,161
2011,Wyre Forest 005D,E01032482,1043,731,312,225,26,61
2011,Wyre Forest 006A,E01032451,1125,783,342,249,29,64
2011,Wyre Forest 006B,E01032452,1116,756,360,244,24,92
2011,Wyre Forest 006C,E01032453,1126,730,396,170,32,194
2011,Wyre Forest 006D,E01032454,1216,884,332,186,34,112
2011,Wyre Forest 007A,E01032449,1232,933,299,105,46,148
2011,Wyre Forest 007B,E01032464,1098,653,445,249,30,166
2011,Wyre Forest 007C,E01032465,1005,627,378,143,48,187
2011,Wyre Forest 007D,E01032466,1041,699,342,234,38,70
2011,Wyre Forest 007E,E01032467,878,580,298,228,20,50
2011,Wyre Forest 007F,E01032468,908,586,322,236,26,60
2011,Wyre Forest 008A,E01032474,1305,989,316,116,40,160
2011,Wyre Forest 008B,E01032475,1265,1007,258,131,43,84
2011,Wyre Forest 008C,E01032476,1003,729,274,167,27,80
2011,Wyre Forest 008D,E01032477,893,591,302,232,22,48
2011,Wyre Forest 008E,E01032478,1095,746,349,170,52,127
2011,Wyre Forest 009A,E01032469,1234,776,458,169,51,238
2011,Wyre Forest 009B,E01032470,1291,876,415,190,43,182
2011,Wyre Forest 009C,E01032471,1118,617,501,119,57,325
2011,Wyre Forest 010A,E01032418,1056,759,297,195,40,62
2011,Wyre Forest 010B,E01032419,953,624,329,255,34,40
2011,Wyre Forest 010C,E01032420,993,785,208,122,28,58
2011,Wyre Forest 010D,E01032421,973,712,261,170,40,51
2011,Wyre Forest 010E,E01032422,1070,841,229,55,44,130
2011,Wyre Forest 011A,E01032427,1148,759,389,284,34,71
2011,Wyre Forest 011B,E01032428,1314,898,416,306,26,84
2011,Wyre Forest 011C,E01032429,1132,746,386,285,31,70
2011,Wyre Forest 011D,E01032472,928,626,302,223,27,52
2011,Wyre Forest 011E,E01032473,910,615,295,196,24,75
2011,Wyre Forest 012A,E01032455,1093,722,371,253,49,69
2011,Wyre Forest 012B,E01032456,871,608,263,131,29,103
2011,Wyre Forest 012C,E01032457,902,610,292,172,29,91
2011,Wyre Forest 012D,E01032458,995,642,353,283,23,47
2011,Wyre Forest 012E,E01032459,1026,714,312,183,46,83
2011,Wyre Forest 013A,E01032460,1301,930,371,240,30,101
2011,Wyre Forest 013B,E01032461,1574,1169,405,214,36,155
2011,Wyre Forest 013C,E01032462,1624,1187,437,259,45,133
2011,Wyre Forest 013D,E01032463,1186,780,406,300,32,74
2011,Wyre Forest 014A,E01032423,1147,680,467,296,41,130
2011,Wyre Forest 014B,E01032424,1013,642,371,153,36,182
2011,Wyre Forest 014C,E01032425,1044,649,395,267,25,103
2011,Wyre Forest 014D,E01032426,1122,711,411,284,34,93
2011,Bedford 001A,E01017540,1109,793,316,200,34,82
2011,Bedford 001B,E01017541,934,646,288,179,42,67
2011,Bedford 001C,E01017544,998,699,299,206,29,64
2011,Bedford 001D,E01017545,1080,789,291,149,59,83
2011,Bedford 002A,E01017464,1034,728,306,201,36,69
2011,Bedford 002B,E01017465,1024,672,352,222,45,85
2011,Bedford 002C,E01017503,941,658,283,136,76,71
2011,Bedford 002D,E01017504,1352,1003,349,181,57,111
2011,Bedford 002E,E01017546,894,667,227,135,28,64
2011,Bedford 002F,E01017547,1175,855,320,210,42,68
2011,Bedford 003A,E01017478,1273,901,372,231,58,83
2011,Bedford 003B,E01017479,918,616,302,210,28,64
2011,Bedford 003C,E01017480,1485,1071,414,142,61,211
2011,Bedford 003D,E01017481,833,625,208,116,30,62
2011,Bedford 003E,E01017528,1778,1308,470,300,74,96
2011,Bedford 004B,E01017495,1467,1089,378,237,42,99
2011,Bedford 004C,E01017496,1105,763,342,237,31,74
2011,Bedford 004D,E01017542,1079,775,304,190,32,82
2011,Bedford 004E,E01017543,1125,812,313,160,34,119
2011,Bedford 004F,E01033431,909,728,181,45,43,93
2011,Bedford 004G,E01033432,1586,1121,465,297,69,99
2011,Bedford 005A,E01017453,938,657,281,141,26,114
2011,Bedford 005B,E01017454,1088,779,309,206,43,60
2011,Bedford 005C,E01017455,1058,763,295,184,36,75
2011,Bedford 005D,E01017456,994,659,335,222,51,62
2011,Bedford 005E,E01017457,830,601,229,117,38,74
2011,Bedford 005F,E01017458,955,729,226,132,28,66
2011,Bedford 006A,E01017529,951,685,266,164,43,59
2011,Bedford 006B,E01017530,1023,751,272,203,34,35
2011,Bedford 006C,E01017531,965,605,360,177,56,127
2011,Bedford 006D,E01017532,862,607,255,174,32,49
2011,Bedford 006E,E01017533,905,626,279,202,34,43
2011,Bedford 006F,E01017534,1067,755,312,218,39,55
2011,Bedford 007A,E01017488,977,637,340,214,51,75
2011,Bedford 007B,E01017489,1047,741,306,100,62,144
2011,Bedford 007C,E01017490,954,646,308,113,53,142
2011,Bedford 007D,E01017491,1087,779,308,148,85,75
2011,Bedford 007E,E01017492,1025,708,317,116,46,155
2011,Bedford 007F,E01017493,1167,868,299,96,70,133
2011,Bedford 008A,E01017459,1206,885,321,222,39,60
2011,Bedford 008B,E01017460,1172,883,289,168,48,73
2011,Bedford 008C,E01017461,1402,1032,370,162,73,135
2011,Bedford 008D,E01017462,1136,838,298,194,30,74
2011,Bedford 008E,E01017463,936,634,302,218,29,55
2011,Bedford 009A,E01017482,970,660,310,124,64,122
2011,Bedford 009B,E01017483,1611,983,628,179,392,57
2011,Bedford 009C,E01017484,899,529,370,79,198,93
2011,Bedford 009D,E01017485,1068,857,211,66,66,79
2011,Bedford 010A,E01017497,1117,832,285,66,145,74
2011,Bedford 010B,E01017498,989,705,284,146,73,65
2011,Bedford 010C,E01017499,1040,764,276,74,84,118
2011,Bedford 010D,E01017500,922,676,246,58,92,96
2011,Bedford 010E,E01017501,876,579,297,93,101,103
2011,Bedford 010F,E01017502,1316,739,577,180,69,328
2011,Bedford 011A,E01017524,1130,833,297,131,80,86
2011,Bedford 011B,E01017525,870,629,241,108,60,73
2011,Bedford 011C,E01017526,1080,856,224,104,56,64
2011,Bedford 011D,E01017527,872,656,216,110,44,62
2011,Bedford 012A,E01017466,1489,1061,428,56,134,238
2011,Bedford 012B,E01017467,964,762,202,92,54,56
2011,Bedford 012C,E01017468,1015,778,237,108,58,71
2011,Bedford 012D,E01017469,1337,997,340,119,124,97
2011,Bedford 012E,E01017470,932,737,195,90,74,31
2011,Bedford 012F,E01017471,1223,819,404,81,82,241
2011,Bedford 013A,E01017535,980,664,316,97,75,144
2011,Bedford 013B,E01017536,1716,1209,507,71,140,296
2011,Bedford 013C,E01017537,900,572,328,79,70,179
2011,Bedford 013D,E01017538,1210,716,494,76,119,299
2011,Bedford 013E,E01017539,1026,650,376,78,93,205
2011,Bedford 014A,E01017518,1062,787,275,91,50,134
2011,Bedford 014B,E01017519,1081,705,376,111,60,205
2011,Bedford 014C,E01017520,1115,856,259,113,53,93
2011,Bedford 014D,E01017521,1110,840,270,121,30,119
2011,Bedford 014E,E01017522,1286,921,365,125,60,180
2011,Bedford 014F,E01017523,1006,689,317,68,68,181
2011,Bedford 015A,E01017472,997,672,325,74,66,185
2011,Bedford 015B,E01017473,1767,1366,401,59,123,219
2011,Bedford 015C,E01017474,1224,901,323,62,69,192
2011,Bedford 015D,E01017475,1089,851,238,78,32,128
2011,Bedford 015E,E01017476,1032,746,286,132,47,107
2011,Bedford 015F,E01017477,817,495,322,89,47,186
2011,Bedford 016A,E01017509,839,614,225,84,30,111
2011,Bedford 016B,E01017510,1131,881,250,146,25,79
2011,Bedford 016C,E01017511,971,719,252,134,45,73
2011,Bedford 016D,E01017512,1073,809,264,85,49,130
2011,Bedford 017A,E01017505,1160,843,317,158,33,126
2011,Bedford 017B,E01017506,1120,856,264,92,48,124
2011,Bedford 017C,E01017507,984,754,230,102,46,82
2011,Bedford 017D,E01017508,1191,896,295,137,52,106
2011,Bedford 018A,E01017513,1102,830,272,139,50,83
2011,Bedford 018B,E01017514,1158,783,375,142,55,178
2011,Bedford 018C,E01017515,1110,772,338,130,52,156
2011,Bedford 018D,E01017516,1063,825,238,128,47,63
2011,Bedford 018E,E01017517,1184,893,291,145,51,95
2011,Bedford 019A,E01017486,1224,933,291,147,37,107
2011,Bedford 019B,E01017487,1281,996,285,106,57,122
2011,Bedford 019C,E01017548,1349,1037,312,160,43,109
2011,Bedford 019D,E01017549,1043,714,329,236,28,65
2011,Bedford 019E,E01017550,1969,1561,408,184,72,152
2011,Bedford 020A,E01017551,1060,805,255,137,51,67
2011,Bedford 020B,E01017552,812,644,168,69,29,70
2011,Bedford 020C,E01017553,942,676,266,171,39,56
2011,Bedford 020D,E01017554,1016,662,354,222,44,88
2011,Central Bedfordshire 001A,E01017433,1100,814,286,110,47,129
2011,Central Bedfordshire 001B,E01017434,1269,967,302,148,46,108
2011,Central Bedfordshire 001C,E01017436,1720,1388,332,163,65,104
2011,Central Bedfordshire 002A,E01017430,1035,750,285,157,30,98
2011,Central Bedfordshire 002B,E01017431,1152,872,280,155,33,92
2011,Central Bedfordshire 002C,E01017432,1120,817,303,184,44,75
2011,Central Bedfordshire 002D,E01017435,1185,910,275,136,40,99
2011,Central Bedfordshire 003A,E01017425,825,633,192,122,24,46
2011,Central Bedfordshire 003B,E01017426,1026,762,264,157,40,67
2011,Central Bedfordshire 003C,E01017427,1274,969,305,157,46,102
2011,Central Bedfordshire 003D,E01017428,1166,880,286,164,43,79
2011,Central Bedfordshire 003E,E01017429,1067,863,204,129,26,49
2011,Central Bedfordshire 004A,E01017412,1141,841,300,154,77,69
2011,Central Bedfordshire 004B,E01017422,1113,786,327,224,37,66
2011,Central Bedfordshire 004C,E01017423,1115,776,339,232,32,75
2011,Central Bedfordshire 004D,E01017424,1042,761,281,169,41,71
2011,Central Bedfordshire 005A,E01017383,1452,1157,295,156,43,96
2011,Central Bedfordshire 005B,E01017384,1112,846,266,122,36,108
2011,Central Bedfordshire 005C,E01017385,1216,947,269,139,26,104
2011,Central Bedfordshire 005D,E01017386,1323,1045,278,145,37,96
2011,Central Bedfordshire 005E,E01017387,1006,779,227,123,34,70
2011,Central Bedfordshire 005F,E01017388,1035,770,265,139,43,83
2011,Central Bedfordshire 006A,E01017381,1082,784,298,214,32,52
2011,Central Bedfordshire 006B,E01017382,963,730,233,120,35,78
2011,Central Bedfordshire 006C,E01017389,1424,1119,305,156,51,98
2011,Central Bedfordshire 006D,E01017390,1436,1073,363,142,59,162
2011,Central Bedfordshire 007A,E01017379,857,641,216,132,32,52
2011,Central Bedfordshire 007B,E01017380,931,652,279,180,35,64
2011,Central Bedfordshire 007C,E01017394,1139,817,322,130,118,74
2011,Central Bedfordshire 007F,E01017397,1248,835,413,176,157,80
2011,Central Bedfordshire 007G,E01033194,2092,1067,1025,186,716,123
2011,Central Bedfordshire 008A,E01017410,908,633,275,191,31,53
2011,Central Bedfordshire 008B,E01017411,1131,834,297,177,47,73
2011,Central Bedfordshire 008C,E01017419,1135,828,307,194,48,65
2011,Central Bedfordshire 008D,E01017420,1112,807,305,164,43,98
2011,Central Bedfordshire 008E,E01017421,1259,901,358,237,44,77
2011,Central Bedfordshire 009A,E01017416,1476,1123,353,171,74,108
2011,Central Bedfordshire 009B,E01017417,1743,1396,347,141,100,106
2011,Central Bedfordshire 009C,E01017418,1136,813,323,161,48,114
2011,Central Bedfordshire 009D,E01017451,1038,799,239,138,28,73
2011,Central Bedfordshire 009E,E01017452,844,570,274,184,32,58
2011,Central Bedfordshire 010A,E01017376,1421,1184,237,109,32,96
2011,Central Bedfordshire 010B,E01017377,1479,1175,304,136,56,112
2011,Central Bedfordshire 010C,E01017378,1313,967,346,150,44,152
2011,Central Bedfordshire 010D,E01017413,1301,977,324,233,30,61
2011,Central Bedfordshire 010E,E01017414,1284,948,336,196,44,96
2011,Central Bedfordshire 010F,E01017415,1322,1041,281,179,33,69
2011,Central Bedfordshire 011A,E01017437,1147,852,295,141,50,104
2011,Central Bedfordshire 011B,E01017438,1215,938,277,168,45,64
2011,Central Bedfordshire 011C,E01017439,1167,936,231,101,39,91
2011,Central Bedfordshire 011D,E01017440,973,728,245,102,26,117
2011,Central Bedfordshire 011E,E01017441,1402,1147,255,109,54,92
2011,Central Bedfordshire 011F,E01017444,1347,1012,335,204,49,82
2011,Central Bedfordshire 012A,E01017371,895,630,265,200,28,37
2011,Central Bedfordshire 012B,E01017372,1037,804,233,140,31,62
2011,Central Bedfordshire 012C,E01017373,1055,823,232,132,46,54
2011,Central Bedfordshire 012D,E01017374,1090,795,295,157,50,88
2011,Central Bedfordshire 012E,E01017375,1011,787,224,118,51,55
2011,Central Bedfordshire 013A,E01017391,984,726,258,125,28,105
2011,Central Bedfordshire 013B,E01017392,1091,779,312,212,44,56
2011,Central Bedfordshire 013C,E01017393,1248,977,271,157,41,73
2011,Central Bedfordshire 013D,E01017442,1536,1180,356,199,50,107
2011,Central Bedfordshire 013E,E01017443,1334,1116,218,84,32,102
2011,Central Bedfordshire 014A,E01017446,1245,943,302,163,42,97
2011,Central Bedfordshire 014B,E01017447,1531,1180,351,217,54,80
2011,Central Bedfordshire 014D,E01017449,1104,831,273,191,26,56
2011,Central Bedfordshire 014E,E01033188,1051,768,283,182,27,74
2011,Central Bedfordshire 014F,E01033189,1133,922,211,92,35,84
2011,Central Bedfordshire 014G,E01033190,1038,881,157,63,22,72
2011,Central Bedfordshire 015A,E01017399,1092,893,199,85,48,66
2011,Central Bedfordshire 015B,E01017400,1040,689,351,137,53,161
2011,Central Bedfordshire 015C,E01017401,959,749,210,108,46,56
2011,Central Bedfordshire 015D,E01017402,1154,819,335,245,42,48
2011,Central Bedfordshire 016A,E01017403,1040,783,257,148,49,60
2011,Central Bedfordshire 016B,E01017404,1064,848,216,130,43,43
2011,Central Bedfordshire 016C,E01017405,1130,928,202,106,35,61
2011,Central Bedfordshire 016D,E01017406,1175,960,215,120,38,57
2011,Central Bedfordshire 016E,E01017407,1286,1041,245,127,56,62
2011,Central Bedfordshire 017A,E01017398,1783,1286,497,301,69,127
2011,Central Bedfordshire 017B,E01017408,790,594,196,113,35,48
2011,Central Bedfordshire 017C,E01017409,903,634,269,169,51,49
2011,Central Bedfordshire 017D,E01017445,1340,953,387,216,89,82
2011,Central Bedfordshire 017E,E01017450,1735,1273,462,250,78,134
2011,Central Bedfordshire 018A,E01017558,1329,1034,295,144,52,99
2011,Central Bedfordshire 018B,E01017559,1186,859,327,187,56,84
2011,Central Bedfordshire 018C,E01017560,1093,768,325,225,39,61
2011,Central Bedfordshire 018D,E01017616,1708,1328,380,174,79,127
2011,Central Bedfordshire 019A,E01017577,1636,1230,406,255,39,112
2011,Central Bedfordshire 019B,E01017615,1573,1086,487,310,54,123
2011,Central Bedfordshire 019C,E01017620,1355,1047,308,181,54,73
2011,Central Bedfordshire 019D,E01017621,1146,826,320,229,45,46
2011,Central Bedfordshire 019E,E01017622,1191,870,321,162,64,95
2011,Central Bedfordshire 020A,E01017603,1134,880,254,141,32,81
2011,Central Bedfordshire 020B,E01017604,1287,1030,257,149,41,67
2011,Central Bedfordshire 020C,E01017605,994,739,255,72,46,137
2011,Central Bedfordshire 020D,E01017606,1116,793,323,230,28,65
2011,Central Bedfordshire 020E,E01017607,1011,667,344,229,38,77
2011,Central Bedfordshire 021A,E01017555,1419,1057,362,146,61,155
2011,Central Bedfordshire 021B,E01017556,1199,964,235,115,52,68
2011,Central Bedfordshire 021C,E01017557,1240,923,317,161,43,113
2011,Central Bedfordshire 021D,E01017608,1241,945,296,161,45,90
2011,Central Bedfordshire 021E,E01017609,1155,804,351,155,47,149
2011,Central Bedfordshire 022A,E01017589,1286,1008,278,116,53,109
2011,Central Bedfordshire 022B,E01017590,1094,736,358,256,26,76
2011,Central Bedfordshire 022C,E01017591,1301,958,343,209,48,86
2011,Central Bedfordshire 022D,E01017610,885,630,255,177,28,50
2011,Central Bedfordshire 023A,E01017611,997,762,235,147,41,47
2011,Central Bedfordshire 023B,E01017612,1000,784,216,138,24,54
2011,Central Bedfordshire 023C,E01017613,1040,773,267,179,24,64
2011,Central Bedfordshire 023D,E01017614,1141,894,247,147,33,67
2011,Central Bedfordshire 025A,E01017600,1484,1186,298,85,49,164
2011,Central Bedfordshire 025B,E01017601,982,653,329,100,70,159
2011,Central Bedfordshire 025C,E01017602,1114,802,312,114,47,151
2011,Central Bedfordshire 025D,E01017618,1068,741,327,76,86,165
2011,Central Bedfordshire 025E,E01017619,1449,1017,432,135,72,225
2011,Central Bedfordshire 024A,E01017573,1043,761,282,192,36,54
2011,Central Bedfordshire 024C,E01017575,1847,1462,385,183,48,154
2011,Central Bedfordshire 024D,E01017576,1048,806,242,143,25,74
2011,Central Bedfordshire 024E,E01033191,1015,870,145,34,29,82
2011,Central Bedfordshire 024F,E01033192,1086,927,159,24,26,109
2011,Central Bedfordshire 024G,E01033193,1153,938,215,96,38,81
2011,Central Bedfordshire 026A,E01017578,1295,1003,292,143,38,111
2011,Central Bedfordshire 026B,E01017579,1085,774,311,136,57,118
2011,Central Bedfordshire 026C,E01017580,1533,1211,322,63,72,187
2011,Central Bedfordshire 026D,E01017581,1291,929,362,171,43,148
2011,Central Bedfordshire 026E,E01017617,935,671,264,155,27,82
2011,Central Bedfordshire 027A,E01017582,1106,831,275,163,39,73
2011,Central Bedfordshire 027B,E01017583,1336,1020,316,152,70,94
2011,Central Bedfordshire 027C,E01017584,1335,976,359,192,50,117
2011,Central Bedfordshire 027D,E01017585,1052,767,285,181,55,49
2011,Central Bedfordshire 028A,E01017566,1128,805,323,233,45,45
2011,Central Bedfordshire 028B,E01017595,854,590,264,112,45,107
2011,Central Bedfordshire 028C,E01017596,1024,731,293,110,32,151
2011,Central Bedfordshire 028D,E01017597,1021,738,283,145,28,110
2011,Central Bedfordshire 028E,E01017598,811,612,199,124,28,47
2011,Central Bedfordshire 028F,E01017599,1532,1173,359,129,74,156
2011,Central Bedfordshire 029A,E01017565,1081,726,355,261,43,51
2011,Central Bedfordshire 029B,E01017567,1186,867,319,132,60,127
2011,Central Bedfordshire 029C,E01017568,1327,1001,326,113,54,159
2011,Central Bedfordshire 029D,E01017569,1169,908,261,121,43,97
2011,Central Bedfordshire 029E,E01017570,1480,1175,305,135,45,125
2011,Central Bedfordshire 030A,E01017592,1124,830,294,149,48,97
2011,Central Bedfordshire 030B,E01017593,1091,753,338,204,49,85
2011,Central Bedfordshire 030C,E01017594,1400,1010,390,101,58,231
2011,Central Bedfordshire 031A,E01017623,1270,993,277,125,44,108
2011,Central Bedfordshire 031B,E01017624,1425,1082,343,188,44,111
2011,Central Bedfordshire 031C,E01017625,1199,820,379,284,43,52
2011,Central Bedfordshire 031D,E01017626,1352,981,371,250,57,64
2011,Central Bedfordshire 032A,E01017571,899,622,277,168,33,76
2011,Central Bedfordshire 032B,E01017572,1010,749,261,165,38,58
2011,Central Bedfordshire 032C,E01017586,1066,780,286,166,42,78
2011,Central Bedfordshire 032D,E01017587,1170,799,371,260,35,76
2011,Central Bedfordshire 032E,E01017588,878,603,275,177,27,71
2011,Central Bedfordshire 033A,E01017561,1165,859,306,204,28,74
2011,Central Bedfordshire 033B,E01017562,1058,703,355,229,33,93
2011,Central Bedfordshire 033C,E01017563,1149,811,338,233,30,75
2011,Central Bedfordshire 033D,E01017564,1082,812,270,166,32,72
2011,Luton 001A,E01015706,1023,767,256,153,29,74
2011,Luton 001B,E01015707,1110,830,280,181,45,54
2011,Luton 001C,E01015708,1056,819,237,144,47,46
2011,Luton 001D,E01015709,1125,878,247,144,47,56
2011,Luton 001E,E01015710,1136,899,237,122,41,74
2011,Luton 001F,E01015770,1010,720,290,221,26,43
2011,Luton 002A,E01015801,1243,861,382,145,64,173
2011,Luton 002B,E01015803,1144,815,329,215,46,68
2011,Luton 002C,E01015804,1254,911,343,125,61,157
2011,Luton 002D,E01015805,986,715,271,156,48,67
2011,Luton 003A,E01015769,871,639,232,90,41,101
2011,Luton 003B,E01015771,997,613,384,102,66,216
2011,Luton 003C,E01015772,1018,665,353,97,95,161
2011,Luton 003D,E01015773,900,612,288,63,46,179
2011,Luton 003E,E01015774,988,671,317,65,76,176
2011,Luton 003F,E01015802,1050,687,363,130,59,174
2011,Luton 004A,E01015744,1023,709,314,107,56,151
2011,Luton 004B,E01015746,1044,697,347,209,32,106
2011,Luton 004C,E01015747,1067,744,323,203,56,64
2011,Luton 004D,E01015748,1129,733,396,247,49,100
2011,Luton 005A,E01015749,1283,827,456,97,88,271
2011,Luton 005B,E01015751,1145,764,381,151,77,153
2011,Luton 005C,E01015752,972,650,322,116,66,140
2011,Luton 005D,E01015753,1091,843,248,122,37,89
2011,Luton 005E,E01015754,1222,746,476,183,69,224
2011,Luton 005F,E01015755,1142,761,381,223,47,111
2011,Luton 006A,E01015764,1081,749,332,219,40,73
2011,Luton 006B,E01015765,1178,829,349,146,68,135
2011,Luton 006C,E01015766,1127,805,322,107,80,135
2011,Luton 006D,E01015767,1165,835,330,170,53,107
2011,Luton 006E,E01015768,1015,689,326,195,42,89
2011,Luton 006F,E01015783,1166,775,391,85,77,229
2011,Luton 006G,E01015785,1499,1073,426,140,97,189
2011,Luton 007A,E01015693,1111,817,294,144,60,90
2011,Luton 007B,E01015694,977,687,290,140,40,110
2011,Luton 007C,E01015695,1100,772,328,110,83,135
2011,Luton 007D,E01015696,966,791,175,66,34,75
2011,Luton 007E,E01015697,1221,965,256,105,65,86
2011,Luton 007F,E01015745,1124,768,356,190,89,77
2011,Luton 008A,E01015797,969,705,264,180,38,46
2011,Luton 008B,E01015798,971,704,267,121,47,99
2011,Luton 008C,E01015799,1038,757,281,187,44,50
2011,Luton 008D,E01015800,1110,851,259,113,54,92
2011,Luton 008E,E01015812,1047,862,185,105,24,56
2011,Luton 008F,E01015813,1012,669,343,193,55,95
2011,Luton 009A,E01015756,1144,878,266,68,56,142
2011,Luton 009B,E01015757,1057,664,393,145,63,185
2011,Luton 009C,E01015758,1068,811,257,38,84,135
2011,Luton 009D,E01015759,1034,654,380,145,76,159
2011,Luton 009E,E01015760,1023,667,356,107,57,192
2011,Luton 009F,E01015761,1061,763,298,103,47,148
2011,Luton 010A,E01015700,1654,1101,553,142,118,293
2011,Luton 010B,E01015701,1469,853,616,104,137,375
2011,Luton 010C,E01015704,1329,764,565,64,134,367
2011,Luton 010D,E01015782,1351,850,501,137,114,250
2011,Luton 010E,E01015784,1412,857,555,81,132,342
2011,Luton 010F,E01015786,1481,860,621,103,194,324
2011,Luton 011A,E01015711,1149,733,416,109,104,203
2011,Luton 011B,E01015712,1180,788,392,145,83,164
2011,Luton 011C,E01015715,1201,709,492,84,114,294
2011,Luton 011D,E01015716,1227,843,384,73,100,211
2011,Luton 011E,E01015717,1027,695,332,87,65,180
2011,Luton 011F,E01015750,1504,1075,429,97,103,229
2011,Luton 012A,E01015740,1166,884,282,118,73,91
2011,Luton 012B,E01015775,1196,899,297,150,71,76
2011,Luton 012C,E01015776,1311,910,401,171,83,147
2011,Luton 012D,E01015777,1285,938,347,129,109,109
2011,Luton 012E,E01015778,1278,1004,274,113,71,90
2011,Luton 012F,E01015796,1066,736,330,198,45,87
2011,Luton 013A,E01015713,952,641,311,142,52,117
2011,Luton 013B,E01015714,1205,831,374,182,66,126
2011,Luton 013C,E01015718,1181,853,328,145,85,98
2011,Luton 013D,E01015762,1205,843,362,169,63,130
2011,Luton 013E,E01015763,1078,706,372,199,41,132
2011,Luton 014A,E01015721,1081,822,259,130,34,95
2011,Luton 014B,E01015722,942,708,234,93,48,93
2011,Luton 014C,E01015806,1023,851,172,73,28,71
2011,Luton 014D,E01015808,1101,914,187,67,36,84
2011,Luton 014E,E01015809,1125,879,246,122,45,79
2011,Luton 014F,E01015810,1027,802,225,62,59,104
2011,Luton 014G,E01015811,1129,929,200,108,32,60
2011,Luton 015A,E01015703,1418,771,647,114,120,413
2011,Luton 015B,E01015726,1576,921,655,90,159,406
2011,Luton 015C,E01015731,1321,880,441,86,103,252
2011,Luton 015D,E01015787,1352,811,541,108,111,322
2011,Luton 015E,E01015788,1362,755,607,106,124,377
2011,Luton 016A,E01015719,1062,806,256,141,33,82
2011,Luton 016B,E01015720,1114,764,350,78,103,169
2011,Luton 016C,E01015723,966,738,228,80,41,107
2011,Luton 016D,E01015779,1026,700,326,86,60,180
2011,Luton 016E,E01015780,1222,941,281,108,69,104
2011,Luton 016F,E01015781,1090,790,300,116,61,123
2011,Luton 016G,E01015807,953,675,278,108,43,127
2011,Luton 017A,E01015698,1290,757,533,86,173,274
2011,Luton 017B,E01015699,1312,812,500,72,151,277
2011,Luton 017C,E01015702,1183,713,470,78,94,298
2011,Luton 017D,E01015705,1259,743,516,40,179,297
2011,Luton 017E,E01015725,1073,564,509,73,119,317
2011,Luton 017F,E01015727,1292,760,532,67,167,298
2011,Luton 018A,E01015739,1537,1249,288,74,97,117
2011,Luton 018B,E01015741,1796,1217,579,106,203,270
2011,Luton 018C,E01015742,1416,1078,338,77,126,135
2011,Luton 018D,E01015743,1227,831,396,80,131,185
2011,Luton 018E,E01015789,1301,803,498,131,172,195
2011,Luton 018F,E01015794,2285,1490,795,46,555,194
2011,Luton 019A,E01015724,1574,1050,524,78,132,314
2011,Luton 019B,E01015728,1154,732,422,89,116,217
2011,Luton 019C,E01015729,1442,933,509,86,143,280
2011,Luton 019D,E01015730,1660,1118,542,77,153,312
2011,Luton 020A,E01015732,1038,657,381,117,87,177
2011,Luton 020B,E01015733,1135,734,401,123,69,209
2011,Luton 020C,E01015734,1351,1021,330,132,72,126
2011,Luton 020D,E01015735,1357,980,377,55,142,180
2011,Luton 020E,E01015736,1146,725,421,109,66,246
2011,Luton 020F,E01015737,1061,747,314,91,67,156
2011,Luton 021A,E01015738,1462,1050,412,84,175,153
2011,Luton 021B,E01015790,1212,892,320,98,123,99
2011,Luton 021C,E01015791,2011,1307,704,97,378,229
2011,Luton 021D,E01015792,1382,1032,350,67,146,137
2011,Luton 021E,E01015793,1342,985,357,115,97,145
2011,Luton 021F,E01015795,1820,1346,474,37,217,220
2011,Peterborough 001A,E01015629,1243,887,356,227,47,82
2011,Peterborough 001B,E01015635,1131,798,333,257,30,46
2011,Peterborough 001C,E01015636,842,597,245,156,31,58
2011,Peterborough 001D,E01015679,1355,1038,317,171,37,109
2011,Peterborough 002A,E01015678,1079,861,218,83,40,95
2011,Peterborough 002B,E01015680,1081,778,303,90,47,166
2011,Peterborough 002C,E01015681,1164,951,213,103,41,69
2011,Peterborough 002D,E01015682,1096,877,219,108,41,70
2011,Peterborough 003A,E01015630,1164,889,275,152,32,91
2011,Peterborough 003B,E01015631,978,754,224,148,28,48
2011,Peterborough 003C,E01015659,1489,1247,242,117,40,85
2011,Peterborough 003D,E01015684,1074,739,335,248,28,59
2011,Peterborough 003E,E01015685,1220,885,335,251,21,63
2011,Peterborough 004A,E01015589,1186,806,380,250,48,82
2011,Peterborough 004B,E01015590,860,587,273,186,32,55
2011,Peterborough 004C,E01015626,1039,879,160,39,25,96
2011,Peterborough 004D,E01015628,1861,1600,261,126,39,96
2011,Peterborough 005A,E01015617,984,734,250,149,28,73
2011,Peterborough 005B,E01015618,786,545,241,133,34,74
2011,Peterborough 005C,E01015619,1455,1070,385,179,56,150
2011,Peterborough 005D,E01015620,1246,905,341,223,45,73
2011,Peterborough 006A,E01015674,1053,782,271,112,40,119
2011,Peterborough 006B,E01015675,1128,857,271,155,22,94
2011,Peterborough 006C,E01015676,1146,834,312,167,35,110
2011,Peterborough 006D,E01015683,1329,885,444,331,29,84
2011,Peterborough 006E,E01015686,1122,710,412,328,29,55
2011,Peterborough 007A,E01015607,975,648,327,123,36,168
2011,Peterborough 007B,E01015609,1211,762,449,84,90,275
2011,Peterborough 007C,E01015656,1109,735,374,143,40,191
2011,Peterborough 007D,E01015657,1321,933,388,76,65,247
2011,Peterborough 007E,E01015658,1045,641,404,108,60,236
2011,Peterborough 007F,E01015660,1102,800,302,125,23,154
2011,Peterborough 008A,E01015605,1088,708,380,141,55,184
2011,Peterborough 008B,E01015608,1105,735,370,134,49,187
2011,Peterborough 008C,E01015610,1082,720,362,116,41,205
2011,Peterborough 008D,E01015633,1557,995,562,236,50,276
2011,Peterborough 008E,E01015634,1240,821,419,161,50,208
2011,Peterborough 009A,E01015593,1022,694,328,114,53,161
2011,Peterborough 009B,E01015596,1147,823,324,99,56,169
2011,Peterborough 009C,E01015662,1019,740,279,74,65,140
2011,Peterborough 009D,E01015663,1041,676,365,107,56,202
2011,Peterborough 009E,E01015664,1191,825,366,95,45,226
2011,Peterborough 010A,E01015603,1601,1090,511,85,105,321
2011,Peterborough 010B,E01015604,1309,797,512,50,107,355
2011,Peterborough 010C,E01015632,1438,1014,424,109,63,252
2011,Peterborough 010D,E01015661,1315,818,497,145,30,322
2011,Peterborough 010E,E01015677,801,613,188,66,22,100
2011,Peterborough 011A,E01015591,1115,814,301,175,40,86
2011,Peterborough 011B,E01015592,1104,778,326,170,29,127
2011,Peterborough 011C,E01015594,1356,1012,344,154,42,148
2011,Peterborough 011D,E01015595,1065,718,347,164,40,143
2011,Peterborough 011E,E01015597,1102,789,313,75,51,187
2011,Peterborough 012A,E01015601,1375,817,558,64,141,353
2011,Peterborough 012B,E01015651,1418,1015,403,149,64,190
2011,Peterborough 012C,E01015652,1386,989,397,64,86,247
2011,Peterborough 012D,E01015653,1339,950,389,149,97,143
2011,Peterborough 012E,E01015654,1526,1126,400,113,69,218
2011,Peterborough 013A,E01015606,1277,886,391,175,56,160
2011,Peterborough 013B,E01015611,1497,1001,496,191,52,253
2011,Peterborough 013C,E01015613,1099,787,312,118,29,165
2011,Peterborough 013D,E01015614,1337,1054,283,101,31,151
2011,Peterborough 013E,E01015615,1079,713,366,140,46,180
2011,Peterborough 013F,E01015616,1208,772,436,95,64,277
2011,Peterborough 014A,E01015599,1374,936,438,71,93,274
2011,Peterborough 014B,E01015600,1256,837,419,84,65,270
2011,Peterborough 014C,E01015602,1531,1188,343,75,62,206
2011,Peterborough 014D,E01015612,1584,1182,402,134,47,221
2011,Peterborough 014E,E01015655,1599,1252,347,97,93,157
2011,Peterborough 015A,E01015598,1163,817,346,226,48,72
2011,Peterborough 015B,E01015687,1143,722,421,279,52,90
2011,Peterborough 015C,E01015689,1057,685,372,264,39,69
2011,Peterborough 015D,E01015690,899,617,282,162,51,69
2011,Peterborough 015E,E01015691,889,583,306,175,42,89
2011,Peterborough 016A,E01015622,1845,1489,356,116,44,196
2011,Peterborough 016C,E01015665,1149,792,357,103,63,191
2011,Peterborough 016D,E01015688,1069,774,295,147,41,107
2011,Peterborough 016E,E01015692,965,692,273,75,42,156
2011,Peterborough 016F,E01033173,1396,1199,197,57,44,96
2011,Peterborough 016G,E01033182,1086,825,261,77,35,149
2011,Peterborough 017A,E01015621,1499,1175,324,114,41,169
2011,Peterborough 017B,E01015623,1276,960,316,152,41,123
2011,Peterborough 017C,E01015624,1233,1004,229,89,28,112
2011,Peterborough 017D,E01015666,956,626,330,152,30,148
2011,Peterborough 017E,E01015668,1344,990,354,123,54,177
2011,Peterborough 018A,E01015627,1240,899,341,232,38,71
2011,Peterborough 018B,E01015644,1471,1188,283,111,42,130
2011,Peterborough 018C,E01015645,1272,1010,262,153,41,68
2011,Peterborough 018D,E01015646,1429,962,467,348,39,80
2011,Peterborough 018E,E01015648,1076,756,320,235,24,61
2011,Peterborough 019A,E01015667,992,773,219,105,27,87
2011,Peterborough 019B,E01015669,1067,750,317,199,27,91
2011,Peterborough 019C,E01015670,1040,709,331,190,34,107
2011,Peterborough 019D,E01015671,1127,848,279,179,26,74
2011,Peterborough 019E,E01015672,1139,843,296,182,30,84
2011,Peterborough 019F,E01015673,1054,715,339,136,34,169
2011,Peterborough 021A,E01015637,1028,702,326,77,40,209
2011,Peterborough 021B,E01015639,1124,787,337,98,45,194
2011,Peterborough 021C,E01015640,1096,832,264,102,29,133
2011,Peterborough 021D,E01015641,886,600,286,118,41,127
2011,Peterborough 021E,E01015642,1033,721,312,80,40,192
2011,Peterborough 021F,E01015647,940,596,344,115,53,176
2011,Peterborough 022A,E01015638,1110,723,387,220,36,131
2011,Peterborough 022B,E01015650,1512,1175,337,179,39,119
2011,Peterborough 022C,E01033174,817,628,189,47,28,114
2011,Peterborough 022D,E01033179,1089,799,290,152,38,100
2011,Peterborough 022E,E01033181,1113,912,201,53,42,106
2011,Peterborough 023A,E01015643,1024,744,280,125,29,126
2011,Peterborough 023B,E01033175,1011,844,167,41,40,86
2011,Peterborough 023C,E01033176,1090,908,182,33,51,98
2011,Peterborough 023D,E01033177,1000,855,145,33,28,84
2011,Peterborough 023E,E01033178,1018,819,199,20,37,142
2011,Peterborough 023F,E01033180,1094,899,195,11,48,136
2011,Southend-on-Sea 001A,E01015833,1111,792,319,218,21,80
2011,Southend-on-Sea 001B,E01015834,1094,760,334,236,27,71
2011,Southend-on-Sea 001C,E01015835,1158,798,360,211,33,116
2011,Southend-on-Sea 001D,E01015836,1108,757,351,244,32,75
2011,Southend-on-Sea 001E,E01015837,1187,859,328,203,34,91
2011,Southend-on-Sea 001F,E01015838,1058,723,335,251,30,54
2011,Southend-on-Sea 002A,E01015863,1755,1306,449,263,39,147
2011,Southend-on-Sea 002B,E01015864,936,655,281,171,30,80
2011,Southend-on-Sea 002C,E01015865,1061,712,349,217,32,100
2011,Southend-on-Sea 002D,E01015866,1098,787,311,203,30,78
2011,Southend-on-Sea 002E,E01015867,1032,600,432,198,45,189
2011,Southend-on-Sea 002F,E01015868,1134,797,337,144,45,148
2011,Southend-on-Sea 003A,E01015814,1000,673,327,202,32,93
2011,Southend-on-Sea 003B,E01015815,1141,828,313,186,45,82
2011,Southend-on-Sea 003C,E01015816,1012,651,361,266,10,85
2011,Southend-on-Sea 003D,E01015817,1095,685,410,303,24,83
2011,Southend-on-Sea 003E,E01015818,1195,778,417,258,39,120
2011,Southend-on-Sea 003F,E01015819,1012,695,317,137,43,137
2011,Southend-on-Sea 004A,E01015857,1076,760,316,216,43,57
2011,Southend-on-Sea 004B,E01015858,1231,891,340,206,33,101
2011,Southend-on-Sea 004C,E01015859,1329,926,403,223,57,123
2011,Southend-on-Sea 004D,E01015860,1117,805,312,187,53,72
2011,Southend-on-Sea 004E,E01015861,1158,778,380,153,47,180
2011,Southend-on-Sea 004F,E01015862,1107,807,300,120,45,135
2011,Southend-on-Sea 005A,E01015820,1035,659,376,136,46,194
2011,Southend-on-Sea 005B,E01015821,1119,800,319,195,39,85
2011,Southend-on-Sea 005C,E01015822,890,647,243,154,27,62
2011,Southend-on-Sea 005D,E01015823,1178,901,277,141,53,83
2011,Southend-on-Sea 005E,E01015824,1090,721,369,149,50,170
2011,Southend-on-Sea 005F,E01015825,1132,735,397,193,47,157
2011,Southend-on-Sea 005G,E01015826,981,682,299,175,25,99
2011,Southend-on-Sea 006A,E01015869,1138,823,315,126,50,139
2011,Southend-on-Sea 006B,E01015870,1185,911,274,117,44,113
2011,Southend-on-Sea 006C,E01015871,1133,786,347,172,55,120
2011,Southend-on-Sea 006D,E01015872,1210,904,306,136,37,133
2011,Southend-on-Sea 006E,E01015873,955,719,236,104,34,98
2011,Southend-on-Sea 006F,E01015874,1229,901,328,142,60,126
2011,Southend-on-Sea 006G,E01015875,1169,760,409,135,43,231
2011,Southend-on-Sea 007A,E01015901,1076,820,256,67,46,143
2011,Southend-on-Sea 007B,E01015902,1227,914,313,86,57,170
2011,Southend-on-Sea 007C,E01015903,1183,915,268,96,56,116
2011,Southend-on-Sea 007D,E01015904,1216,941,275,107,41,127
2011,Southend-on-Sea 007E,E01015905,1023,763,260,104,43,113
2011,Southend-on-Sea 007F,E01015906,1141,888,253,73,33,147
2011,Southend-on-Sea 007G,E01015907,1059,800,259,84,47,128
2011,Southend-on-Sea 008A,E01015908,1118,793,325,200,42,83
2011,Southend-on-Sea 008B,E01015909,1092,840,252,128,38,86
2011,Southend-on-Sea 008C,E01015910,1082,754,328,214,41,73
2011,Southend-on-Sea 008D,E01015911,929,652,277,168,36,73
2011,Southend-on-Sea 008E,E01015912,1046,748,298,200,36,62
2011,Southend-on-Sea 008F,E01015913,1223,901,322,198,45,79
2011,Southend-on-Sea 009A,E01015883,968,624,344,232,35,77
2011,Southend-on-Sea 009B,E01015884,1470,1039,431,177,44,210
2011,Southend-on-Sea 009C,E01015885,1115,674,441,312,30,99
2011,Southend-on-Sea 009D,E01015886,1017,584,433,154,54,225
2011,Southend-on-Sea 009E,E01015887,1074,698,376,130,56,190
2011,Southend-on-Sea 009F,E01015888,1017,615,402,242,48,112
2011,Southend-on-Sea 010A,E01015895,1482,954,528,146,70,312
2011,Southend-on-Sea 010B,E01015896,1304,890,414,124,60,230
2011,Southend-on-Sea 010C,E01015897,1518,983,535,184,57,294
2011,Southend-on-Sea 010D,E01015898,1142,801,341,134,40,167
2011,Southend-on-Sea 010E,E01015899,1414,991,423,150,83,190
2011,Southend-on-Sea 010F,E01015900,1087,812,275,75,57,143
2011,Southend-on-Sea 011A,E01015845,1210,979,231,108,31,92
2011,Southend-on-Sea 011B,E01015846,1235,973,262,113,32,117
2011,Southend-on-Sea 011C,E01015847,1280,1041,239,96,25,118
2011,Southend-on-Sea 011D,E01015848,1238,899,339,225,23,91
2011,Southend-on-Sea 011E,E01015849,1254,989,265,125,38,102
2011,Southend-on-Sea 011F,E01015850,1181,911,270,120,43,107
2011,Southend-on-Sea 012A,E01015827,1169,789,380,215,35,130
2011,Southend-on-Sea 012B,E01015828,1344,953,391,100,26,265
2011,Southend-on-Sea 012C,E01015829,1091,848,243,130,28,85
2011,Southend-on-Sea 012D,E01015830,1099,800,299,163,38,98
2011,Southend-on-Sea 012E,E01015831,1619,1328,291,96,50,145
2011,Southend-on-Sea 012F,E01015832,1047,727,320,169,23,128
2011,Southend-on-Sea 013A,E01015876,1616,1160,456,248,53,155
2011,Southend-on-Sea 013B,E01015877,1337,915,422,190,35,197
2011,Southend-on-Sea 013C,E01015878,1063,800,263,122,48,93
2011,Southend-on-Sea 013D,E01015879,987,698,289,103,45,141
2011,Southend-on-Sea 013E,E01015880,1049,643,406,148,51,207
2011,Southend-on-Sea 013F,E01015881,1013,688,325,201,48,76
2011,Southend-on-Sea 013G,E01015882,1166,810,356,133,40,183
2011,Southend-on-Sea 014A,E01015839,1235,879,356,105,78,173
2011,Southend-on-Sea 014B,E01015840,1245,932,313,98,51,164
2011,Southend-on-Sea 014C,E01015841,1814,1344,470,140,70,260
2011,Southend-on-Sea 014D,E01015842,1367,853,514,134,50,330
2011,Southend-on-Sea 014E,E01015843,1238,907,331,97,54,180
2011,Southend-on-Sea 014F,E01015844,1346,965,381,161,50,170
2011,Southend-on-Sea 015A,E01015851,1259,858,401,231,16,154
2011,Southend-on-Sea 015B,E01015852,1351,972,379,89,83,207
2011,Southend-on-Sea 015C,E01015853,1342,1018,324,190,42,92
2011,Southend-on-Sea 015D,E01015854,1627,1146,481,80,199,202
2011,Southend-on-Sea 015E,E01015855,1511,1127,384,115,71,198
2011,Southend-on-Sea 015F,E01015856,1341,1008,333,115,63,155
2011,Southend-on-Sea 016A,E01015889,976,648,328,217,30,81
2011,Southend-on-Sea 016B,E01015890,1072,696,376,220,58,98
2011,Southend-on-Sea 016C,E01015891,1093,783,310,156,33,121
2011,Southend-on-Sea 016D,E01015892,1228,938,290,141,52,97
2011,Southend-on-Sea 016E,E01015893,1020,542,478,383,26,69
2011,Southend-on-Sea 016F,E01015894,1096,810,286,186,40,60
2011,Southend-on-Sea 017A,E01015914,1011,672,339,201,47,91
2011,Southend-on-Sea 017B,E01015915,1062,754,308,190,36,82
2011,Southend-on-Sea 017C,E01015916,980,587,393,106,56,231
2011,Southend-on-Sea 017D,E01015917,1149,736,413,120,56,237
2011,Southend-on-Sea 017E,E01015918,984,711,273,111,52,110
2011,Southend-on-Sea 017F,E01015919,921,630,291,142,37,112
2011,Southend-on-Sea 017G,E01015920,1069,691,378,246,33,99
2011,Thurrock 001A,E01015943,1137,818,319,232,23,64
2011,Thurrock 001B,E01015944,855,586,269,190,21,58
2011,Thurrock 001C,E01015946,1150,808,342,220,33,89
2011,Thurrock 001D,E01015997,1121,823,298,185,45,68
2011,Thurrock 001E,E01015999,1040,793,247,155,20,72
2011,Thurrock 002A,E01015945,877,592,285,185,29,71
2011,Thurrock 002B,E01015983,1091,712,379,247,41,91
2011,Thurrock 002C,E01015987,1076,720,356,165,65,126
2011,Thurrock 002D,E01015988,963,627,336,153,47,136
2011,Thurrock 002E,E01015998,1199,853,346,208,40,98
2011,Thurrock 003A,E01015984,979,705,274,175,20,79
2011,Thurrock 003B,E01015985,986,559,427,313,25,89
2011,Thurrock 003C,E01015986,1056,735,321,121,42,158
2011,Thurrock 003D,E01015990,1101,797,304,145,36,123
2011,Thurrock 003E,E01016001,1000,734,266,171,28,67
2011,Thurrock 004A,E01015977,1314,985,329,196,33,100
2011,Thurrock 004B,E01015978,985,713,272,174,26,72
2011,Thurrock 004C,E01015979,1052,868,184,99,31,54
2011,Thurrock 004D,E01015980,1175,823,352,225,33,94
2011,Thurrock 005A,E01015989,1159,896,263,103,54,106
2011,Thurrock 005B,E01015991,1052,764,288,180,27,81
2011,Thurrock 005C,E01015992,1391,1063,328,147,37,144
2011,Thurrock 005D,E01016000,1102,803,299,198,25,76
2011,Thurrock 005E,E01016002,1090,795,295,197,32,66
2011,Thurrock 006A,E01015932,1130,811,319,128,48,143
2011,Thurrock 006B,E01015971,1083,771,312,154,29,129
2011,Thurrock 006C,E01015972,1190,863,327,146,58,123
2011,Thurrock 006D,E01015973,1194,851,343,129,39,175
2011,Thurrock 006E,E01015974,1083,800,283,144,24,115
2011,Thurrock 006F,E01015975,1159,837,322,154,41,127
2011,Thurrock 007A,E01015927,1239,903,336,101,63,172
2011,Thurrock 007B,E01015928,1241,917,324,128,47,149
2011,Thurrock 007C,E01015929,1057,706,351,123,35,193
2011,Thurrock 007D,E01015930,1246,920,326,93,46,187
2011,Thurrock 007E,E01015931,977,699,278,68,33,177
2011,Thurrock 007F,E01015976,1299,915,384,129,45,210
2011,Thurrock 008A,E01015922,1078,735,343,125,42,176
2011,Thurrock 008B,E01015923,1155,867,288,102,42,144
2011,Thurrock 008C,E01015924,1073,826,247,92,28,127
2011,Thurrock 008D,E01015925,1128,815,313,179,40,94
2011,Thurrock 008E,E01015926,1086,791,295,159,27,109
2011,Thurrock 009A,E01015957,1064,730,334,155,37,142
2011,Thurrock 009B,E01015958,973,718,255,118,36,101
2011,Thurrock 009C,E01015993,1072,796,276,140,43,93
2011,Thurrock 009D,E01015994,1028,671,357,205,40,112
2011,Thurrock 009E,E01015995,1270,922,348,225,56,67
2011,Thurrock 009F,E01015996,1108,794,314,152,45,117
2011,Thurrock 010A,E01015963,822,561,261,105,33,123
2011,Thurrock 010B,E01015964,1145,818,327,202,40,85
2011,Thurrock 010C,E01015965,1076,737,339,235,28,76
2011,Thurrock 010D,E01015966,1134,789,345,231,31,83
2011,Thurrock 012A,E01015933,1049,750,299,142,26,131
2011,Thurrock 012B,E01015934,1031,727,304,102,53,149
2011,Thurrock 012C,E01015935,1126,778,348,140,47,161
2011,Thurrock 012D,E01015936,1157,757,400,210,35,155
2011,Thurrock 012E,E01015937,1238,801,437,284,40,113
2011,Thurrock 012F,E01015938,1276,829,447,175,40,232
2011,Thurrock 013A,E01015947,1056,807,249,72,45,132
2011,Thurrock 013B,E01015948,1130,855,275,126,49,100
2011,Thurrock 013C,E01015949,1261,1006,255,105,43,107
2011,Thurrock 013D,E01015950,1330,974,356,217,34,105
2011,Thurrock 014A,E01015960,1058,764,294,170,44,80
2011,Thurrock 014B,E01015967,1154,909,245,136,44,65
2011,Thurrock 014C,E01015968,1038,776,262,143,39,80
2011,Thurrock 014D,E01015969,1277,947,330,215,31,84
2011,Thurrock 014E,E01015970,960,746,214,115,27,72
2011,Thurrock 015A,E01015921,894,709,185,73,25,87
2011,Thurrock 015B,E01016011,1163,972,191,56,26,109
2011,Thurrock 015C,E01016012,1801,1398,403,108,67,228
2011,Thurrock 015D,E01016013,1698,1407,291,68,53,170
2011,Thurrock 015E,E01016014,1756,1381,375,64,74,237
2011,Thurrock 015F,E01016015,1268,986,282,116,55,111
2011,Thurrock 016A,E01015955,1190,958,232,94,22,116
2011,Thurrock 016B,E01015956,1544,1193,351,100,69,182
2011,Thurrock 016C,E01015959,1222,878,344,138,54,152
2011,Thurrock 016D,E01015961,1104,844,260,109,50,101
2011,Thurrock 016E,E01015962,1176,907,269,86,46,137
2011,Thurrock 017A,E01015951,1224,940,284,76,52,156
2011,Thurrock 017B,E01015952,1487,1168,319,62,62,195
2011,Thurrock 017C,E01015953,1638,1350,288,71,37,180
2011,Thurrock 017D,E01015954,1640,1243,397,88,61,248
2011,Thurrock 018A,E01016003,1444,1062,382,155,45,182
2011,Thurrock 018B,E01016004,1099,766,333,121,39,173
2011,Thurrock 018C,E01016005,1112,804,308,110,47,151
2011,Thurrock 018D,E01016006,1075,700,375,98,35,242
2011,Thurrock 018E,E01016007,1062,702,360,113,46,201
2011,Thurrock 018F,E01016008,1132,857,275,92,46,137
2011,Thurrock 018G,E01016009,1211,824,387,124,53,210
2011,Thurrock 018H,E01016010,995,632,363,106,51,206
2011,Thurrock 019A,E01015982,1794,1501,293,68,66,159
2011,Thurrock 019B,E01033610,1120,972,148,21,29,98
2011,Thurrock 019C,E01033611,1204,1060,144,20,32,92
2011,Thurrock 019D,E01033613,1114,962,152,52,26,74
2011,Thurrock 020A,E01015939,1137,937,200,74,35,91
2011,Thurrock 020B,E01015941,1027,849,178,58,45,75
2011,Thurrock 020C,E01015942,1132,892,240,86,47,107
2011,Thurrock 020D,E01033612,1176,1007,169,43,47,79
2011,Thurrock 020E,E01033614,1283,1042,241,69,59,113
2011,Cambridge 001A,E01017975,1157,819,338,136,52,150
2011,Cambridge 001B,E01017976,1319,1039,280,102,84,94
2011,Cambridge 001C,E01017977,1270,958,312,85,85,142
2011,Cambridge 001D,E01017978,1128,835,293,97,53,143
2011,Cambridge 001E,E01017979,1186,871,315,81,66,168
2011,Cambridge 001F,E01017980,868,665,203,95,35,73
2011,Cambridge 002A,E01017949,1378,970,408,81,228,99
2011,Cambridge 002B,E01017950,1108,781,327,81,183,63
2011,Cambridge 002C,E01017951,1128,808,320,106,75,139
2011,Cambridge 002D,E01017952,1065,772,293,113,65,115
2011,Cambridge 002E,E01017953,1203,813,390,140,110,140
2011,Cambridge 002F,E01017954,1013,747,266,98,56,112
2011,Cambridge 003B,E01017971,1236,891,345,99,87,159
2011,Cambridge 003C,E01017972,1208,909,299,125,54,120
2011,Cambridge 003D,E01017973,1242,907,335,141,79,115
2011,Cambridge 003E,E01017974,1349,1003,346,121,84,141
2011,Cambridge 003F,E01032792,1020,809,211,59,59,93
2011,Cambridge 003G,E01032802,1033,769,264,87,96,81
2011,Cambridge 004A,E01018006,1324,1034,290,107,120,63
2011,Cambridge 004B,E01018007,1175,892,283,128,95,60
2011,Cambridge 004C,E01018008,1264,946,318,102,126,90
2011,Cambridge 004D,E01018009,1548,1072,476,90,222,164
2011,Cambridge 004E,E01018010,1477,1103,374,106,179,89
2011,Cambridge 005A,E01017955,1127,805,322,150,107,65
2011,Cambridge 005B,E01017956,1339,670,669,100,518,51
2011,Cambridge 005C,E01017957,1311,683,628,68,523,37
2011,Cambridge 005D,E01017958,4972,780,4192,70,4042,80
2011,Cambridge 006A,E01017943,1439,1116,323,70,147,106
2011,Cambridge 006B,E01017944,1048,800,248,64,57,127
2011,Cambridge 006C,E01017945,1377,1061,316,86,98,132
2011,Cambridge 006D,E01017946,1168,829,339,95,65,179
2011,Cambridge 006E,E01017947,1236,908,328,117,75,136
2011,Cambridge 006F,E01017948,1222,875,347,78,58,211
2011,Cambridge 007C,E01017983,1517,1138,379,118,180,81
2011,Cambridge 007D,E01017984,1190,740,450,116,242,92
2011,Cambridge 007E,E01017985,2108,900,1208,119,999,90
2011,Cambridge 007F,E01017986,3388,609,2779,41,2695,43
2011,Cambridge 007G,E01032797,4971,1197,3774,95,3587,92
2011,Cambridge 008A,E01017987,1437,985,452,76,292,84
2011,Cambridge 008B,E01017988,1472,898,574,54,474,46
2011,Cambridge 008C,E01017989,1867,1365,502,66,319,117
2011,Cambridge 008D,E01017990,1036,837,199,52,105,42
2011,Cambridge 008E,E01017991,1217,756,461,86,274,101
2011,Cambridge 009A,E01017997,1844,1418,426,121,154,151
2011,Cambridge 009B,E01017998,1473,1130,343,61,213,69
2011,Cambridge 009C,E01017999,1396,1042,354,90,146,118
2011,Cambridge 009D,E01018000,1491,1135,356,44,241,71
2011,Cambridge 009E,E01018001,1427,1141,286,63,166,57
2011,Cambridge 010A,E01017965,1320,906,414,152,163,99
2011,Cambridge 010B,E01017966,2257,1592,665,108,459,98
2011,Cambridge 010C,E01017967,1339,928,411,111,176,124
2011,Cambridge 010D,E01017968,1188,870,318,106,152,60
2011,Cambridge 010E,E01017969,1143,864,279,96,90,93
2011,Cambridge 011A,E01017959,1282,983,299,134,69,96
2011,Cambridge 011B,E01017960,931,705,226,82,51,93
2011,Cambridge 011C,E01017961,889,663,226,88,49,89
2011,Cambridge 011D,E01017962,1177,885,292,139,52,101
2011,Cambridge 011E,E01017963,1169,857,312,152,47,113
2011,Cambridge 011F,E01017964,990,728,262,143,65,54
2011,Cambridge 012A,E01018002,1183,911,272,122,72,78
2011,Cambridge 012B,E01018003,1156,855,301,146,56,99
2011,Cambridge 012D,E01018005,1575,937,638,100,410,128
2011,Cambridge 012E,E01032794,928,611,317,136,100,81
2011,Cambridge 012F,E01032795,1183,853,330,63,149,118
2011,Cambridge 013A,E01017992,1317,987,330,111,115,104
2011,Cambridge 013B,E01017993,1649,1177,472,154,229,89
2011,Cambridge 013C,E01017994,1149,844,305,110,83,112
2011,Cambridge 013D,E01017995,1031,725,306,176,81,49
2011,Cambridge 013E,E01017996,1655,774,881,92,725,64
2011,East Cambridgeshire 001A,E01018042,1008,746,262,150,20,92
2011,East Cambridgeshire 001B,E01018043,1482,1068,414,215,46,153
2011,East Cambridgeshire 001C,E01018044,1308,968,340,190,28,122
2011,East Cambridgeshire 001D,E01018045,1022,808,214,95,30,89
2011,East Cambridgeshire 001E,E01018046,1438,1089,349,134,41,174
2011,East Cambridgeshire 002A,E01018020,1148,893,255,140,38,77
2011,East Cambridgeshire 002B,E01018021,1096,825,271,166,35,70
2011,East Cambridgeshire 002C,E01018022,1031,721,310,197,26,87
2011,East Cambridgeshire 002D,E01018055,1571,1187,384,261,40,83
2011,East Cambridgeshire 002E,E01018056,1364,1025,339,166,38,135
2011,East Cambridgeshire 003A,E01018027,1192,854,338,216,25,97
2011,East Cambridgeshire 003C,E01018029,1923,1569,354,189,42,123
2011,East Cambridgeshire 003D,E01018032,1826,1361,465,280,61,124
2011,East Cambridgeshire 003E,E01018033,1375,916,459,260,53,146
2011,East Cambridgeshire 003F,E01033426,1022,792,230,92,26,112
2011,East Cambridgeshire 003G,E01033430,1014,707,307,123,43,141
2011,East Cambridgeshire 004A,E01018024,810,587,223,151,17,55
2011,East Cambridgeshire 004B,E01018025,1101,780,321,121,120,80
2011,East Cambridgeshire 004C,E01018026,1067,819,248,163,27,58
2011,East Cambridgeshire 004D,E01018030,762,528,234,137,23,74
2011,East Cambridgeshire 004F,E01033425,1341,1118,223,89,38,96
2011,East Cambridgeshire 004G,E01033428,1084,865,219,118,38,63
2011,East Cambridgeshire 005A,E01018036,1187,888,299,174,28,97
2011,East Cambridgeshire 005B,E01018037,1048,801,247,130,36,81
2011,East Cambridgeshire 005C,E01018038,1134,843,291,184,47,60
2011,East Cambridgeshire 005D,E01018039,932,707,225,160,27,38
2011,East Cambridgeshire 005E,E01018053,1263,926,337,198,33,106
2011,East Cambridgeshire 005F,E01018054,1680,1295,385,236,44,105
2011,East Cambridgeshire 006A,E01018047,1376,1064,312,152,33,127
2011,East Cambridgeshire 006C,E01018049,1205,926,279,138,41,100
2011,East Cambridgeshire 006D,E01018050,1040,808,232,104,29,99
2011,East Cambridgeshire 006E,E01018051,1238,919,319,163,29,127
2011,East Cambridgeshire 006F,E01018052,1358,1073,285,165,20,100
2011,East Cambridgeshire 006G,E01033427,933,804,129,28,28,73
2011,East Cambridgeshire 006H,E01033429,1503,1214,289,160,30,99
2011,East Cambridgeshire 007A,E01018034,1150,863,287,165,31,91
2011,East Cambridgeshire 007B,E01018035,1615,1237,378,199,48,131
2011,East Cambridgeshire 007C,E01018040,926,690,236,129,26,81
2011,East Cambridgeshire 007D,E01018041,787,594,193,102,21,70
2011,East Cambridgeshire 008A,E01018013,1227,899,328,225,42,61
2011,East Cambridgeshire 008B,E01018014,1264,1002,262,156,33,73
2011,East Cambridgeshire 008C,E01018015,977,774,203,116,26,61
2011,East Cambridgeshire 008D,E01018016,966,706,260,135,28,97
2011,East Cambridgeshire 009A,E01018011,1868,1372,496,284,57,155
2011,East Cambridgeshire 009B,E01018012,934,683,251,155,24,72
2011,East Cambridgeshire 009C,E01018057,1453,1104,349,195,43,111
2011,East Cambridgeshire 011A,E01018017,917,645,272,179,19,74
2011,East Cambridgeshire 011B,E01018019,750,556,194,130,12,52
2011,East Cambridgeshire 011C,E01018023,1653,1263,390,204,67,119
2011,East Cambridgeshire 011D,E01032611,1345,1038,307,205,27,75
2011,Fenland 001A,E01018094,1258,765,493,303,33,157
2011,Fenland 001B,E01018095,1166,753,413,266,40,107
2011,Fenland 001C,E01018096,1156,768,388,257,35,96
2011,Fenland 001D,E01018097,1089,696,393,242,30,121
2011,Fenland 002A,E01018063,1691,1233,458,197,54,207
2011,Fenland 002B,E01018073,1681,1149,532,252,53,227
2011,Fenland 002C,E01018107,1192,780,412,151,51,210
2011,Fenland 002D,E01018108,1416,877,539,214,56,269
2011,Fenland 002E,E01018109,1307,893,414,217,42,155
2011,Fenland 003A,E01018069,1291,935,356,214,33,109
2011,Fenland 003B,E01018070,1286,942,344,124,33,187
2011,Fenland 003C,E01018071,1208,805,403,226,32,145
2011,Fenland 003E,E01018093,1745,1224,521,259,51,211
2011,Fenland 003F,E01018103,862,576,286,94,38,154
2011,Fenland 003G,E01018104,927,647,280,149,43,88
2011,Fenland 003H,E01033111,1030,696,334,179,29,126
2011,Fenland 003I,E01033112,884,680,204,91,28,85
2011,Fenland 004A,E01018066,1025,653,372,228,27,117
2011,Fenland 004B,E01018067,1311,912,399,241,36,122
2011,Fenland 004C,E01018068,1159,791,368,182,41,145
2011,Fenland 004D,E01018090,1260,787,473,266,42,165
2011,Fenland 004E,E01018091,1074,738,336,166,36,134
2011,Fenland 004F,E01018092,1239,809,430,234,43,153
2011,Fenland 005A,E01018081,1513,1019,494,183,59,252
2011,Fenland 005B,E01018082,1402,999,403,238,42,123
2011,Fenland 005C,E01018083,1363,982,381,161,62,158
2011,Fenland 005D,E01018084,1493,955,538,340,45,153
2011,Fenland 006A,E01018064,1445,1085,360,184,51,125
2011,Fenland 006B,E01018072,1197,844,353,175,45,133
2011,Fenland 006C,E01018074,886,617,269,168,22,79
2011,Fenland 006D,E01018075,837,565,272,148,25,99
2011,Fenland 006E,E01018098,917,630,287,203,19,65
2011,Fenland 006F,E01018099,959,708,251,175,27,49
2011,Fenland 006G,E01018100,856,618,238,136,24,78
2011,Fenland 006H,E01018101,994,706,288,199,26,63
2011,Fenland 007A,E01018077,1302,951,351,187,24,140
2011,Fenland 007B,E01018078,1078,628,450,257,32,161
2011,Fenland 007C,E01018079,1225,784,441,286,37,118
2011,Fenland 007D,E01018080,1685,1183,502,302,44,156
2011,Fenland 008A,E01018058,1161,811,350,243,26,81
2011,Fenland 008B,E01018059,1011,765,246,155,16,75
2011,Fenland 008C,E01018060,1418,1033,385,191,57,137
2011,Fenland 008D,E01018061,928,721,207,110,26,71
2011,Fenland 009A,E01018085,1177,755,422,299,36,87
2011,Fenland 009B,E01018086,1223,846,377,240,32,105
2011,Fenland 009C,E01018087,1455,945,510,298,34,178
2011,Fenland 009D,E01018088,1099,725,374,246,33,95
2011,Fenland 010A,E01018065,1645,1196,449,261,48,140
2011,Fenland 010B,E01018076,1522,1101,421,218,44,159
2011,Fenland 010C,E01018111,1615,1070,545,353,53,139
2011,Fenland 011A,E01018062,1794,1268,526,286,55,185
2011,Fenland 011B,E01018102,1905,1411,494,232,59,203
2011,Fenland 011C,E01018105,803,598,205,115,30,60
2011,Fenland 011D,E01018106,1174,879,295,182,39,74
2011,Fenland 011E,E01018110,1919,1322,597,346,68,183
2011,Huntingdonshire 001A,E01018212,1199,868,331,177,32,122
2011,Huntingdonshire 001B,E01018213,1414,1094,320,142,39,139
2011,Huntingdonshire 001C,E01018214,1445,1079,366,164,51,151
2011,Huntingdonshire 001D,E01018215,1039,799,240,149,28,63
2011,Huntingdonshire 001E,E01018216,1805,1418,387,208,51,128
2011,Huntingdonshire 001F,E01018217,1218,866,352,242,25,85
2011,Huntingdonshire 002A,E01018127,1162,842,320,196,41,83
2011,Huntingdonshire 002B,E01018128,859,607,252,165,19,68
2011,Huntingdonshire 002C,E01018200,1233,919,314,186,60,68
2011,Huntingdonshire 002D,E01018201,1059,823,236,141,32,63
2011,Huntingdonshire 003A,E01018156,1272,915,357,232,34,91
2011,Huntingdonshire 003B,E01018157,1530,1145,385,199,42,144
2011,Huntingdonshire 003C,E01018158,1233,900,333,183,36,114
2011,Huntingdonshire 003D,E01018159,1064,806,258,157,32,69
2011,Huntingdonshire 003E,E01018160,1186,822,364,167,47,150
2011,Huntingdonshire 004A,E01018191,849,631,218,134,35,49
2011,Huntingdonshire 004B,E01018192,1101,827,274,166,45,63
2011,Huntingdonshire 004C,E01018193,914,691,223,159,28,36
2011,Huntingdonshire 004D,E01018194,1036,783,253,156,29,68
2011,Huntingdonshire 004E,E01018195,911,693,218,106,24,88
2011,Huntingdonshire 005A,E01018208,1203,889,314,189,28,97
2011,Huntingdonshire 005B,E01018209,1130,843,287,160,36,91
2011,Huntingdonshire 005C,E01018210,1034,786,248,127,36,85
2011,Huntingdonshire 005D,E01018211,1327,947,380,238,50,92
2011,Huntingdonshire 006A,E01018196,941,696,245,156,23,66
2011,Huntingdonshire 006B,E01018197,1097,860,237,117,40,80
2011,Huntingdonshire 006C,E01018198,1231,937,294,176,33,85
2011,Huntingdonshire 006D,E01018199,1157,906,251,159,32,60
2011,Huntingdonshire 006E,E01018206,1354,1119,235,75,51,109
2011,Huntingdonshire 006F,E01018207,1147,846,301,177,26,98
2011,Huntingdonshire 007A,E01018121,1035,776,259,175,37,47
2011,Huntingdonshire 007B,E01018122,840,585,255,175,27,53
2011,Huntingdonshire 007C,E01018123,1220,971,249,153,35,61
2011,Huntingdonshire 007D,E01018124,1479,1125,354,221,40,93
2011,Huntingdonshire 008A,E01018143,1150,777,373,137,36,200
2011,Huntingdonshire 008B,E01018144,1021,748,273,94,46,133
2011,Huntingdonshire 008C,E01018145,942,703,239,75,31,133
2011,Huntingdonshire 008D,E01018146,1574,1220,354,102,65,187
2011,Huntingdonshire 008E,E01018147,1230,918,312,93,53,166
2011,Huntingdonshire 009A,E01018139,1140,869,271,122,35,114
2011,Huntingdonshire 009B,E01018140,988,704,284,187,31,66
2011,Huntingdonshire 009C,E01018141,1221,921,300,206,30,64
2011,Huntingdonshire 009D,E01018142,1007,663,344,235,34,75
2011,Huntingdonshire 010B,E01018113,1091,778,313,201,37,75
2011,Huntingdonshire 010D,E01018116,890,642,248,126,38,84
2011,Huntingdonshire 010E,E01018117,1140,774,366,256,37,73
2011,Huntingdonshire 010F,E01018118,1452,1143,309,172,49,88
2011,Huntingdonshire 010G,E01033433,1697,1196,501,294,45,162
2011,Huntingdonshire 011A,E01018161,1085,872,213,107,40,66
2011,Huntingdonshire 011B,E01018162,1251,990,261,145,38,78
2011,Huntingdonshire 011C,E01018163,1066,875,191,60,26,105
2011,Huntingdonshire 011D,E01018164,967,777,190,112,17,61
2011,Huntingdonshire 011E,E01018165,968,788,180,96,20,64
2011,Huntingdonshire 011F,E01018170,1009,708,301,196,39,66
2011,Huntingdonshire 011G,E01018171,1132,835,297,188,37,72
2011,Huntingdonshire 012A,E01018138,1519,1176,343,152,36,155
2011,Huntingdonshire 012B,E01018148,1781,1450,331,96,83,152
2011,Huntingdonshire 012C,E01018149,1088,899,189,80,42,67
2011,Huntingdonshire 012D,E01018150,1268,1026,242,77,36,129
2011,Huntingdonshire 012E,E01018151,1362,1153,209,95,24,90
2011,Huntingdonshire 013A,E01018166,1084,783,301,192,36,73
2011,Huntingdonshire 013B,E01018167,1092,776,316,203,46,67
2011,Huntingdonshire 013C,E01018168,1399,1087,312,174,38,100
2011,Huntingdonshire 013D,E01018169,1142,814,328,175,44,109
2011,Huntingdonshire 014A,E01018131,1093,837,256,146,25,85
2011,Huntingdonshire 014B,E01018132,1233,911,322,223,25,74
2011,Huntingdonshire 014C,E01018133,1220,967,253,128,50,75
2011,Huntingdonshire 014D,E01018134,1383,1093,290,139,54,97
2011,Huntingdonshire 015A,E01018125,1143,813,330,190,49,91
2011,Huntingdonshire 015B,E01018126,1194,872,322,180,53,89
2011,Huntingdonshire 015C,E01018152,1095,806,289,184,35,70
2011,Huntingdonshire 015D,E01018153,1319,924,395,201,100,94
2011,Huntingdonshire 016A,E01018129,1158,892,266,155,35,76
2011,Huntingdonshire 016B,E01018130,1271,1018,253,154,29,70
2011,Huntingdonshire 016C,E01018202,1013,671,342,246,34,62
2011,Huntingdonshire 016D,E01018203,1006,722,284,206,25,53
2011,Huntingdonshire 016E,E01018204,984,710,274,165,40,69
2011,Huntingdonshire 016F,E01018205,1401,932,469,348,35,86
2011,Huntingdonshire 017A,E01018115,2118,1114,1004,226,76,702
2011,Huntingdonshire 017B,E01018119,1152,834,318,218,42,58
2011,Huntingdonshire 017C,E01018120,1196,842,354,224,45,85
2011,Huntingdonshire 017D,E01018137,1262,965,297,195,29,73
2011,Huntingdonshire 018A,E01018135,2129,1655,474,173,65,236
2011,Huntingdonshire 018B,E01018136,1287,921,366,229,42,95
2011,Huntingdonshire 018C,E01018154,1313,963,350,229,32,89
2011,Huntingdonshire 018D,E01018155,1123,828,295,203,33,59
2011,Huntingdonshire 019A,E01018187,1391,1075,316,157,52,107
2011,Huntingdonshire 019B,E01018188,1063,784,279,158,33,88
2011,Huntingdonshire 019C,E01018189,959,693,266,188,25,53
2011,Huntingdonshire 019D,E01018190,1098,789,309,162,48,99
2011,Huntingdonshire 020A,E01018172,985,689,296,211,27,58
2011,Huntingdonshire 020B,E01018173,927,783,144,74,19,51
2011,Huntingdonshire 020C,E01018174,1184,889,295,187,28,80
2011,Huntingdonshire 020D,E01018175,1037,793,244,160,26,58
2011,Huntingdonshire 020E,E01018176,964,680,284,215,23,46
2011,Huntingdonshire 021A,E01018181,2104,1725,379,184,52,143
2011,Huntingdonshire 021B,E01018182,1144,903,241,119,40,82
2011,Huntingdonshire 021C,E01018183,1143,833,310,141,48,121
2011,Huntingdonshire 021D,E01018184,956,696,260,116,42,102
2011,Huntingdonshire 021E,E01018185,1255,862,393,228,41,124
2011,Huntingdonshire 021F,E01018186,1332,1001,331,186,41,104
2011,Huntingdonshire 022A,E01018177,1129,826,303,224,22,57
2011,Huntingdonshire 022B,E01018178,1078,772,306,203,30,73
2011,Huntingdonshire 022C,E01018179,1030,779,251,121,29,101
2011,Huntingdonshire 022D,E01018180,994,740,254,106,30,118
2011,South Cambridgeshire 001A,E01018304,1340,1047,293,154,29,110
2011,South Cambridgeshire 001B,E01018305,962,733,229,137,44,48
2011,South Cambridgeshire 001C,E01018306,1096,851,245,150,29,66
2011,South Cambridgeshire 001D,E01018307,1638,1303,335,199,51,85
2011,South Cambridgeshire 002A,E01018233,1183,890,293,188,40,65
2011,South Cambridgeshire 002B,E01018234,1209,958,251,149,43,59
2011,South Cambridgeshire 002C,E01018235,1167,896,271,155,43,73
2011,South Cambridgeshire 002D,E01018236,1098,816,282,149,42,91
2011,South Cambridgeshire 003A,E01018237,1097,872,225,124,34,67
2011,South Cambridgeshire 003B,E01018266,1966,1577,389,243,39,107
2011,South Cambridgeshire 003C,E01018284,932,732,200,134,23,43
2011,South Cambridgeshire 003D,E01018285,893,729,164,83,27,54
2011,South Cambridgeshire 004A,E01018298,1395,1198,197,48,36,113
2011,South Cambridgeshire 004B,E01018299,1217,946,271,163,35,73
2011,South Cambridgeshire 004C,E01018300,885,634,251,145,20,86
2011,South Cambridgeshire 004D,E01018301,1021,796,225,147,26,52
2011,South Cambridgeshire 005A,E01018221,1284,1078,206,109,45,52
2011,South Cambridgeshire 005B,E01018222,1176,895,281,186,40,55
2011,South Cambridgeshire 005C,E01018223,1401,1098,303,173,43,87
2011,South Cambridgeshire 006A,E01018257,965,714,251,137,41,73
2011,South Cambridgeshire 006B,E01018258,1121,848,273,165,52,56
2011,South Cambridgeshire 006C,E01018259,981,751,230,121,52,57
2011,South Cambridgeshire 006D,E01018260,1213,959,254,149,46,59
2011,South Cambridgeshire 006F,E01018262,1020,783,237,156,41,40
2011,South Cambridgeshire 006G,E01033120,1112,861,251,52,88,111
2011,South Cambridgeshire 006H,E01033121,1174,972,202,8,74,120
2011,South Cambridgeshire 007A,E01018272,964,767,197,109,32,56
2011,South Cambridgeshire 007B,E01018273,1178,837,341,165,40,136
2011,South Cambridgeshire 007C,E01018274,1365,1161,204,56,52,96
2011,South Cambridgeshire 007D,E01018297,1257,984,273,162,36,75
2011,South Cambridgeshire 009A,E01018224,985,735,250,127,40,83
2011,South Cambridgeshire 009B,E01018225,754,524,230,147,38,45
2011,South Cambridgeshire 009C,E01018248,1813,1039,774,145,547,82
2011,South Cambridgeshire 009D,E01018249,700,527,173,111,24,38
2011,South Cambridgeshire 009E,E01018250,846,626,220,124,35,61
2011,South Cambridgeshire 010A,E01018231,1772,1351,421,241,76,104
2011,South Cambridgeshire 010B,E01018232,1647,1198,449,291,76,82
2011,South Cambridgeshire 010C,E01018251,935,779,156,79,29,48
2011,South Cambridgeshire 010D,E01018252,1073,860,213,96,49,68
2011,South Cambridgeshire 010E,E01018255,811,588,223,139,34,50
2011,South Cambridgeshire 011A,E01018242,928,672,256,172,33,51
2011,South Cambridgeshire 011B,E01018243,1306,1002,304,111,70,123
2011,South Cambridgeshire 011C,E01018244,1131,794,337,225,47,65
2011,South Cambridgeshire 011D,E01018286,1180,936,244,107,43,94
2011,South Cambridgeshire 011E,E01018287,1036,858,178,64,47,67
2011,South Cambridgeshire 011F,E01018296,786,584,202,119,23,60
2011,South Cambridgeshire 012A,E01018292,988,723,265,142,54,69
2011,South Cambridgeshire 012B,E01018293,960,684,276,171,45,60
2011,South Cambridgeshire 012C,E01018294,1205,903,302,186,35,81
2011,South Cambridgeshire 012D,E01018295,1089,780,309,184,50,75
2011,South Cambridgeshire 013A,E01018245,1250,931,319,200,38,81
2011,South Cambridgeshire 013B,E01018246,1186,884,302,183,46,73
2011,South Cambridgeshire 013C,E01018247,1198,941,257,144,41,72
2011,South Cambridgeshire 013D,E01018275,1685,1213,472,320,57,95
2011,South Cambridgeshire 014A,E01018240,866,627,239,144,29,66
2011,South Cambridgeshire 014B,E01018253,799,576,223,142,31,50
2011,South Cambridgeshire 014C,E01018254,949,681,268,177,29,62
2011,South Cambridgeshire 014D,E01018256,1078,758,320,209,39,72
2011,South Cambridgeshire 014E,E01018291,853,602,251,162,30,59
2011,South Cambridgeshire 015A,E01018279,1036,755,281,164,29,88
2011,South Cambridgeshire 015B,E01018280,1150,889,261,168,23,70
2011,South Cambridgeshire 015C,E01018281,1137,833,304,166,29,109
2011,South Cambridgeshire 015D,E01018282,979,789,190,108,27,55
2011,South Cambridgeshire 015E,E01018283,974,749,225,134,32,59
2011,South Cambridgeshire 016A,E01018218,1300,888,412,258,45,109
2011,South Cambridgeshire 016B,E01018219,996,756,240,163,26,51
2011,South Cambridgeshire 016C,E01018220,1132,834,298,160,39,99
2011,South Cambridgeshire 016D,E01018263,1101,836,265,156,44,65
2011,South Cambridgeshire 016E,E01018264,1086,797,289,165,37,87
2011,South Cambridgeshire 016F,E01018265,1258,958,300,187,45,68
2011,South Cambridgeshire 017A,E01018238,1031,786,245,145,27,73
2011,South Cambridgeshire 017B,E01018239,982,716,266,174,37,55
2011,South Cambridgeshire 017C,E01018288,817,609,208,134,35,39
2011,South Cambridgeshire 017D,E01018289,853,659,194,107,33,54
2011,South Cambridgeshire 017E,E01018302,1133,911,222,122,35,65
2011,South Cambridgeshire 017F,E01018303,845,611,234,149,38,47
2011,South Cambridgeshire 018A,E01018241,874,681,193,124,22,47
2011,South Cambridgeshire 018B,E01018267,1642,1192,450,308,50,92
2011,South Cambridgeshire 018C,E01018268,1391,1082,309,179,46,84
2011,South Cambridgeshire 018D,E01018269,979,734,245,140,23,82
2011,South Cambridgeshire 018E,E01018270,829,608,221,142,26,53
2011,South Cambridgeshire 018F,E01018271,1034,722,312,151,52,109
2011,South Cambridgeshire 019A,E01018226,1129,817,312,88,24,200
2011,South Cambridgeshire 019B,E01018227,1384,1059,325,172,49,104
2011,South Cambridgeshire 019C,E01018228,1222,918,304,165,53,86
2011,South Cambridgeshire 019D,E01018290,1775,1293,482,311,53,118
2011,South Cambridgeshire 020A,E01033113,718,585,133,43,14,76
2011,South Cambridgeshire 020B,E01033114,1059,877,182,53,44,85
2011,South Cambridgeshire 020C,E01033115,924,767,157,37,36,84
2011,South Cambridgeshire 020D,E01033117,875,750,125,21,21,83
2011,South Cambridgeshire 020E,E01033119,1250,1067,183,42,37,104
2011,South Cambridgeshire 021A,E01018276,1024,808,216,89,36,91
2011,South Cambridgeshire 021B,E01018277,1270,969,301,171,41,89
2011,South Cambridgeshire 021C,E01018278,1254,980,274,122,41,111
2011,South Cambridgeshire 021D,E01033116,1161,877,284,150,33,101
2011,South Cambridgeshire 021E,E01033118,1056,855,201,99,35,67
2011,Basildon 001A,E01021237,1007,672,335,204,42,89
2011,Basildon 001B,E01021238,1027,729,298,176,48,74
2011,Basildon 001C,E01021242,958,669,289,189,41,59
2011,Basildon 001D,E01021250,1141,829,312,199,37,76
2011,Basildon 001E,E01021251,1160,835,325,176,60,89
2011,Basildon 002A,E01021245,1009,698,311,142,35,134
2011,Basildon 002B,E01021246,1051,760,291,182,28,81
2011,Basildon 002C,E01021248,1054,810,244,140,29,75
2011,Basildon 002D,E01021249,1138,821,317,202,26,89
2011,Basildon 002E,E01021252,1059,814,245,127,35,83
2011,Basildon 003A,E01021239,1031,678,353,203,42,108
2011,Basildon 003B,E01021240,1189,901,288,170,39,79
2011,Basildon 003C,E01021241,1088,819,269,144,42,83
2011,Basildon 003D,E01021243,1252,935,317,184,54,79
2011,Basildon 003E,E01021247,1014,678,336,228,26,82
2011,Basildon 004A,E01021244,996,651,345,231,32,82
2011,Basildon 004B,E01021253,1216,788,428,290,33,105
2011,Basildon 004C,E01021255,970,647,323,224,29,70
2011,Basildon 004D,E01021256,1047,711,336,230,31,75
2011,Basildon 004E,E01021258,1136,814,322,176,38,108
2011,Basildon 005A,E01021334,1155,787,368,239,30,99
2011,Basildon 005B,E01021336,1153,823,330,214,28,88
2011,Basildon 005C,E01021338,1047,743,304,185,25,94
2011,Basildon 005D,E01021339,993,654,339,181,23,135
2011,Basildon 006A,E01021264,1078,742,336,191,45,100
2011,Basildon 006B,E01021329,1033,698,335,237,23,75
2011,Basildon 006C,E01021330,1165,829,336,229,29,78
2011,Basildon 006D,E01021332,1035,690,345,230,35,80
2011,Basildon 006E,E01021333,1155,794,361,258,21,82
2011,Basildon 007A,E01021335,1081,849,232,110,42,80
2011,Basildon 007B,E01021337,1043,721,322,228,30,64
2011,Basildon 007C,E01021340,1212,888,324,201,39,84
2011,Basildon 007D,E01021341,1163,839,324,189,35,100
2011,Basildon 007E,E01021345,1414,1195,219,85,28,106
2011,Basildon 008A,E01021331,1163,850,313,188,33,92
2011,Basildon 008B,E01021342,1143,815,328,178,31,119
2011,Basildon 008C,E01021343,1282,1060,222,64,33,125
2011,Basildon 008D,E01021344,1630,1319,311,141,25,145
2011,Basildon 008E,E01021346,1469,1171,298,159,33,106
2011,Basildon 009A,E01021254,1074,718,356,212,36,108
2011,Basildon 009B,E01021257,1090,743,347,234,41,72
2011,Basildon 009C,E01021259,1107,855,252,143,35,74
2011,Basildon 009D,E01021260,1706,1121,585,216,32,337
2011,Basildon 010A,E01021261,1252,915,337,171,35,131
2011,Basildon 010B,E01021262,1179,872,307,168,27,112
2011,Basildon 010C,E01021263,1387,1094,293,131,47,115
2011,Basildon 010D,E01021274,1296,964,332,178,33,121
2011,Basildon 010E,E01021279,1186,845,341,102,54,185
2011,Basildon 011A,E01021301,1090,747,343,125,43,175
2011,Basildon 011B,E01021303,994,744,250,119,25,106
2011,Basildon 011C,E01021307,1023,800,223,82,24,117
2011,Basildon 011D,E01021308,1004,829,175,55,43,77
2011,Basildon 011E,E01021309,1036,816,220,96,35,89
2011,Basildon 011F,E01021312,1207,812,395,184,36,175
2011,Basildon 012A,E01021265,1066,778,288,124,27,137
2011,Basildon 012B,E01021267,1182,842,340,152,41,147
2011,Basildon 012C,E01021269,1159,835,324,112,47,165
2011,Basildon 012D,E01021270,1063,770,293,93,41,159
2011,Basildon 012E,E01021272,1077,811,266,106,19,141
2011,Basildon 013A,E01021271,1225,820,405,91,59,255
2011,Basildon 013B,E01021302,1033,629,404,99,41,264
2011,Basildon 013C,E01021304,1051,677,374,120,36,218
2011,Basildon 013D,E01021305,1065,668,397,157,48,192
2011,Basildon 013E,E01021306,1095,699,396,138,41,217
2011,Basildon 014A,E01021273,1201,845,356,177,26,153
2011,Basildon 014B,E01021275,1252,868,384,201,48,135
2011,Basildon 014C,E01021276,1103,791,312,153,32,127
2011,Basildon 014D,E01021277,1053,736,317,176,31,110
2011,Basildon 014E,E01021278,1202,845,357,146,42,169
2011,Basildon 015A,E01021266,1120,781,339,156,42,141
2011,Basildon 015B,E01021268,935,614,321,128,33,160
2011,Basildon 015C,E01021318,1460,1034,426,141,54,231
2011,Basildon 015D,E01021320,1190,877,313,130,49,134
2011,Basildon 015E,E01021321,1107,786,321,130,41,150
2011,Basildon 016A,E01021286,1272,914,358,108,63,187
2011,Basildon 016B,E01021288,1066,656,410,67,81,262
2011,Basildon 016C,E01021289,1268,926,342,112,48,182
2011,Basildon 016D,E01021290,1195,759,436,99,76,261
2011,Basildon 016E,E01021291,1202,824,378,171,50,157
2011,Basildon 017A,E01021287,1094,816,278,151,30,97
2011,Basildon 017B,E01021292,1092,752,340,200,33,107
2011,Basildon 017C,E01021293,1197,862,335,182,51,102
2011,Basildon 017D,E01021298,1114,819,295,144,35,116
2011,Basildon 017E,E01021319,1141,794,347,134,41,172
2011,Basildon 018A,E01021313,1164,827,337,202,40,95
2011,Basildon 018B,E01021314,980,662,318,116,35,167
2011,Basildon 018C,E01021315,1090,721,369,168,36,165
2011,Basildon 018D,E01021316,1072,677,395,191,29,175
2011,Basildon 018E,E01021317,1141,764,377,141,58,178
2011,Basildon 019A,E01021322,1098,741,357,125,48,184
2011,Basildon 019B,E01021323,1175,770,405,96,58,251
2011,Basildon 019C,E01021324,1134,737,397,99,62,236
2011,Basildon 019D,E01021325,1049,694,355,112,45,198
2011,Basildon 019E,E01021327,1176,809,367,141,39,187
2011,Basildon 020A,E01021294,1175,854,321,183,50,88
2011,Basildon 020B,E01021295,1183,831,352,177,47,128
2011,Basildon 020C,E01021296,1232,899,333,153,42,138
2011,Basildon 020D,E01021297,1226,940,286,124,37,125
2011,Basildon 020E,E01021299,1141,764,377,240,39,98
2011,Basildon 021A,E01021280,1147,933,214,79,40,95
2011,Basildon 021B,E01021281,1129,837,292,189,34,69
2011,Basildon 021C,E01021282,1165,787,378,247,39,92
2011,Basildon 021D,E01021283,1201,879,322,129,45,148
2011,Basildon 021E,E01021284,1141,901,240,99,49,92
2011,Basildon 021F,E01021285,1021,795,226,110,37,79
2011,Basildon 022A,E01021300,1520,1076,444,145,45,254
2011,Basildon 022B,E01021310,1077,808,269,156,18,95
2011,Basildon 022C,E01021311,1041,683,358,173,36,149
2011,Basildon 022D,E01021326,1317,969,348,140,48,160
2011,Basildon 022E,E01021328,1132,783,349,124,54,171
2011,Braintree 001A,E01021375,844,623,221,122,30,69
2011,Braintree 001B,E01021376,1043,783,260,152,36,72
2011,Braintree 001C,E01021414,1633,1143,490,269,70,151
2011,Braintree 001D,E01021430,1573,1125,448,252,48,148
2011,Braintree 002A,E01021398,1121,800,321,209,40,72
2011,Braintree 002B,E01021406,1651,1143,508,328,44,136
2011,Braintree 002C,E01021407,1571,1095,476,301,45,130
2011,Braintree 003A,E01021382,914,660,254,167,37,50
2011,Braintree 003B,E01021397,1297,1010,287,153,43,91
2011,Braintree 003C,E01021399,1178,806,372,230,38,104
2011,Braintree 003D,E01021400,1225,889,336,204,36,96
2011,Braintree 004A,E01021387,1485,1152,333,179,30,124
2011,Braintree 004B,E01021388,1167,864,303,164,38,101
2011,Braintree 004C,E01021391,1148,741,407,153,54,200
2011,Braintree 004D,E01021392,1227,904,323,174,29,120
2011,Braintree 004E,E01021393,1105,821,284,148,34,102
2011,Braintree 005A,E01021404,1574,1131,443,265,58,120
2011,Braintree 005B,E01021411,886,660,226,134,29,63
2011,Braintree 005C,E01021412,1090,838,252,146,31,75
2011,Braintree 005D,E01021413,957,699,258,159,30,69
2011,Braintree 006A,E01021389,1247,909,338,207,30,101
2011,Braintree 006B,E01021390,1114,805,309,212,20,77
2011,Braintree 006C,E01021408,1259,883,376,233,28,115
2011,Braintree 006D,E01021409,1320,984,336,189,55,92
2011,Braintree 006E,E01021410,1138,803,335,184,33,118
2011,Braintree 007A,E01021349,1087,904,183,77,28,78
2011,Braintree 007B,E01021351,1169,965,204,91,39,74
2011,Braintree 007C,E01021352,1163,922,241,123,34,84
2011,Braintree 007D,E01021355,1407,1019,388,228,24,136
2011,Braintree 007E,E01021356,1021,707,314,205,23,86
2011,Braintree 007F,E01021381,875,574,301,221,21,59
2011,Braintree 008A,E01021354,954,637,317,146,19,152
2011,Braintree 008B,E01021357,1138,839,299,155,29,115
2011,Braintree 008C,E01021358,1472,1071,401,169,43,189
2011,Braintree 008D,E01021359,1434,1005,429,181,52,196
2011,Braintree 009A,E01021350,1256,897,359,243,31,85
2011,Braintree 009B,E01021353,1309,991,318,154,40,124
2011,Braintree 009D,E01021365,1759,1343,416,197,48,171
2011,Braintree 009E,E01033458,1044,896,148,47,11,90
2011,Braintree 009F,E01033459,1335,1064,271,114,39,118
2011,Braintree 010A,E01021364,1217,928,289,160,43,86
2011,Braintree 010B,E01021366,1152,825,327,224,30,73
2011,Braintree 010C,E01021383,1438,1097,341,160,60,121
2011,Braintree 010D,E01021405,1719,1293,426,229,45,152
2011,Braintree 011A,E01021368,1126,843,283,123,29,131
2011,Braintree 011B,E01021370,1119,781,338,121,29,188
2011,Braintree 011C,E01021372,1381,1068,313,160,28,125
2011,Braintree 011D,E01021373,1823,1407,416,226,33,157
2011,Braintree 011E,E01021374,1086,767,319,119,35,165
2011,Braintree 012A,E01021360,1357,992,365,161,39,165
2011,Braintree 012B,E01021361,1204,965,239,129,22,88
2011,Braintree 012C,E01021367,1084,769,315,125,56,134
2011,Braintree 012D,E01021369,1998,1575,423,150,51,222
2011,Braintree 012E,E01021380,1675,1155,520,317,46,157
2011,Braintree 013A,E01021347,1696,1278,418,221,63,134
2011,Braintree 013B,E01021371,1251,938,313,189,19,105
2011,Braintree 013C,E01021384,1635,1286,349,178,51,120
2011,Braintree 013D,E01021385,932,755,177,66,28,83
2011,Braintree 013E,E01021386,1159,918,241,129,37,75
2011,Braintree 014A,E01021377,1257,874,383,209,43,131
2011,Braintree 014B,E01021378,1096,745,351,194,35,122
2011,Braintree 014C,E01021379,1328,981,347,227,42,78
2011,Braintree 014D,E01021401,1048,725,323,190,36,97
2011,Braintree 014E,E01021402,1497,1106,391,201,53,137
2011,Braintree 014F,E01021403,1167,853,314,199,34,81
2011,Braintree 015A,E01021362,1116,824,292,143,41,108
2011,Braintree 015B,E01021417,1126,805,321,173,28,120
2011,Braintree 015C,E01021418,1054,766,288,105,43,140
2011,Braintree 015D,E01021419,1255,875,380,224,39,117
2011,Braintree 015E,E01021426,1005,708,297,129,38,130
2011,Braintree 015F,E01021428,1094,752,342,240,22,80
2011,Braintree 016A,E01021423,1092,797,295,100,41,154
2011,Braintree 016B,E01021425,1097,822,275,102,42,131
2011,Braintree 016C,E01021427,1019,753,266,105,35,126
2011,Braintree 016D,E01021429,981,716,265,115,24,126
2011,Braintree 017A,E01021415,955,645,310,202,23,85
2011,Braintree 017B,E01021416,1202,929,273,161,20,92
2011,Braintree 017C,E01021420,1306,963,343,185,39,119
2011,Braintree 017E,E01021422,1164,825,339,207,31,101
2011,Braintree 017F,E01033460,947,733,214,127,30,57
2011,Braintree 017G,E01033461,1109,959,150,36,28,86
2011,Braintree 017H,E01033462,796,623,173,64,24,85
2011,Braintree 018A,E01021348,1162,794,368,216,40,112
2011,Braintree 018B,E01021394,1043,744,299,168,30,101
2011,Braintree 018C,E01021395,1016,713,303,195,29,79
2011,Braintree 018D,E01021396,1046,777,269,162,32,75
2011,Braintree 018E,E01021424,1498,1163,335,176,40,119
2011,Brentwood 001A,E01021441,1119,793,326,167,56,103
2011,Brentwood 001B,E01021442,1008,694,314,193,47,74
2011,Brentwood 001C,E01021443,1068,752,316,174,40,102
2011,Brentwood 001D,E01021444,1204,837,367,205,56,106
2011,Brentwood 001E,E01021469,856,574,282,162,50,70
2011,Brentwood 001F,E01021470,798,552,246,133,37,76
2011,Brentwood 001G,E01021471,1144,746,398,277,44,77
2011,Brentwood 002A,E01021457,1043,696,347,196,56,95
2011,Brentwood 002B,E01021458,1123,758,365,228,49,88
2011,Brentwood 002C,E01021459,940,605,335,221,61,53
2011,Brentwood 002D,E01021460,1161,817,344,188,59,97
2011,Brentwood 003A,E01021448,986,677,309,172,40,97
2011,Brentwood 003B,E01021449,1085,827,258,124,47,87
2011,Brentwood 003C,E01021450,1455,1093,362,199,75,88
2011,Brentwood 003D,E01021451,1059,800,259,94,51,114
2011,Brentwood 003E,E01021452,1000,700,300,203,33,64
2011,Brentwood 004A,E01021431,1111,870,241,115,40,86
2011,Brentwood 004B,E01021432,1225,907,318,162,44,112
2011,Brentwood 004C,E01021434,890,667,223,99,35,89
2011,Brentwood 004D,E01021461,1070,734,336,157,37,142
2011,Brentwood 004E,E01021464,1108,805,303,182,39,82
2011,Brentwood 005A,E01021447,1712,1107,605,352,98,155
2011,Brentwood 005B,E01021453,849,597,252,132,46,74
2011,Brentwood 005C,E01021455,942,537,405,217,64,124
2011,Brentwood 005D,E01021465,1288,943,345,177,48,120
2011,Brentwood 005E,E01021466,1265,796,469,239,82,148
2011,Brentwood 005F,E01021467,1175,838,337,184,58,95
2011,Brentwood 006A,E01021438,1475,1100,375,211,62,102
2011,Brentwood 006B,E01021462,1040,757,283,178,36,69
2011,Brentwood 006C,E01021463,1128,759,369,201,59,109
2011,Brentwood 006D,E01021468,1347,994,353,180,71,102
2011,Brentwood 007A,E01021433,1420,1123,297,146,50,101
2011,Brentwood 007B,E01021436,1650,1296,354,154,78,122
2011,Brentwood 007C,E01021439,1822,1514,308,121,36,151
2011,Brentwood 007E,E01021475,1129,891,238,124,35,79
2011,Brentwood 007F,E01033063,997,786,211,76,40,95
2011,Brentwood 007G,E01033064,1010,786,224,101,34,89
2011,Brentwood 008A,E01021435,1304,920,384,179,65,140
2011,Brentwood 008B,E01021437,1161,838,323,120,54,149
2011,Brentwood 008C,E01021472,1130,853,277,112,50,115
2011,Brentwood 008D,E01021473,1002,657,345,163,44,138
2011,Brentwood 008E,E01021474,1119,790,329,192,43,94
2011,Brentwood 009A,E01021445,1547,1139,408,229,63,116
2011,Brentwood 009B,E01021446,1094,784,310,203,35,72
2011,Brentwood 009C,E01021454,946,748,198,121,33,44
2011,Brentwood 009D,E01021456,954,692,262,121,50,91
2011,Castle Point 001A,E01021513,1235,845,390,269,28,93
2011,Castle Point 001B,E01021514,1110,830,280,183,18,79
2011,Castle Point 001C,E01021515,995,724,271,160,35,76
2011,Castle Point 001D,E01021525,1123,832,291,165,20,106
2011,Castle Point 001E,E01021527,1243,844,399,279,35,85
2011,Castle Point 002A,E01021509,990,654,336,219,30,87
2011,Castle Point 002B,E01021510,1031,649,382,286,22,74
2011,Castle Point 002C,E01021511,982,640,342,227,31,84
2011,Castle Point 002D,E01021528,1159,786,373,241,28,104
2011,Castle Point 002E,E01021531,1034,730,304,184,45,75
2011,Castle Point 003A,E01021476,1423,1005,418,252,40,126
2011,Castle Point 003B,E01021477,1128,766,362,252,32,78
2011,Castle Point 003C,E01021478,1284,892,392,239,47,106
2011,Castle Point 003D,E01021516,1030,704,326,219,33,74
2011,Castle Point 004A,E01021479,1089,759,330,205,41,84
2011,Castle Point 004B,E01021481,1110,799,311,207,26,78
2011,Castle Point 004C,E01021483,1257,881,376,229,45,102
2011,Castle Point 004D,E01021512,1153,808,345,231,34,80
2011,Castle Point 004E,E01021526,1234,840,394,261,33,100
2011,Castle Point 005A,E01021517,1147,757,390,264,43,83
2011,Castle Point 005B,E01021519,1066,720,346,245,34,67
2011,Castle Point 005C,E01021530,1018,691,327,233,24,70
2011,Castle Point 005D,E01021532,1073,702,371,273,23,75
2011,Castle Point 006A,E01021482,1118,769,349,213,42,94
2011,Castle Point 006B,E01021518,1373,993,380,204,43,133
2011,Castle Point 006C,E01021520,1104,815,289,188,29,72
2011,Castle Point 006D,E01021529,1069,741,328,168,42,118
2011,Castle Point 007A,E01021480,1348,995,353,220,38,95
2011,Castle Point 007B,E01021521,1047,768,279,186,17,76
2011,Castle Point 007C,E01021522,1253,921,332,183,45,104
2011,Castle Point 007D,E01021523,1009,660,349,266,23,60
2011,Castle Point 007E,E01021524,1143,808,335,220,30,85
2011,Castle Point 008A,E01021487,1039,655,384,242,25,117
2011,Castle Point 008B,E01021494,1142,793,349,189,37,123
2011,Castle Point 008C,E01021504,1161,907,254,92,51,111
2011,Castle Point 008D,E01021505,1102,835,267,141,33,93
2011,Castle Point 008E,E01021506,999,750,249,104,29,116
2011,Castle Point 009A,E01021492,1275,818,457,269,24,164
2011,Castle Point 009B,E01021493,1143,773,370,229,27,114
2011,Castle Point 009C,E01021495,1440,622,818,702,16,100
2011,Castle Point 009D,E01021496,1031,645,386,213,30,143
2011,Castle Point 010A,E01021485,893,553,340,166,29,145
2011,Castle Point 010B,E01021486,848,557,291,102,33,156
2011,Castle Point 010C,E01021488,1031,638,393,208,38,147
2011,Castle Point 010D,E01021503,1048,736,312,163,31,118
2011,Castle Point 010E,E01021507,1146,769,377,118,52,207
2011,Castle Point 010F,E01021508,979,753,226,67,41,118
2011,Castle Point 011A,E01021484,1032,643,389,251,25,113
2011,Castle Point 011B,E01021498,1155,785,370,217,33,120
2011,Castle Point 011C,E01021499,1300,858,442,289,25,128
2011,Castle Point 011D,E01021501,1034,668,366,230,20,116
2011,Castle Point 011E,E01021502,1675,1162,513,241,40,232
2011,Castle Point 012A,E01021489,1085,715,370,233,23,114
2011,Castle Point 012B,E01021490,1142,740,402,219,35,148
2011,Castle Point 012C,E01021491,1233,849,384,230,38,116
2011,Castle Point 012D,E01021497,1093,703,390,218,33,139
2011,Castle Point 012E,E01021500,1222,825,397,221,28,148
2011,Chelmsford 001A,E01021538,1953,1487,466,231,66,169
2011,Chelmsford 001B,E01021539,917,657,260,147,32,81
2011,Chelmsford 001C,E01021540,1180,865,315,193,28,94
2011,Chelmsford 001D,E01021541,1031,674,357,215,42,100
2011,Chelmsford 002A,E01021542,1481,1071,410,209,59,142
2011,Chelmsford 002B,E01021543,1170,860,310,197,38,75
2011,Chelmsford 002C,E01021587,1044,725,319,240,32,47
2011,Chelmsford 002D,E01021590,1097,809,288,187,50,51
2011,Chelmsford 002E,E01021591,1137,838,299,176,32,91
2011,Chelmsford 003A,E01021550,1060,791,269,168,31,70
2011,Chelmsford 003B,E01021597,1001,776,225,98,46,81
2011,Chelmsford 003C,E01021598,1008,703,305,145,34,126
2011,Chelmsford 003D,E01021600,912,683,229,143,36,50
2011,Chelmsford 003E,E01021601,1062,756,306,146,46,114
2011,Chelmsford 004A,E01021616,1132,889,243,145,44,54
2011,Chelmsford 004B,E01021617,1030,808,222,115,23,84
2011,Chelmsford 004C,E01021619,1130,919,211,109,37,65
2011,Chelmsford 004D,E01021620,1097,852,245,135,26,84
2011,Chelmsford 004E,E01021623,954,712,242,156,23,63
2011,Chelmsford 004F,E01021624,841,582,259,195,25,39
2011,Chelmsford 005A,E01021536,1171,852,319,166,37,116
2011,Chelmsford 005B,E01021537,1502,1086,416,226,114,76
2011,Chelmsford 005D,E01021568,1128,722,406,242,51,113
2011,Chelmsford 005E,E01033142,1501,1225,276,78,65,133
2011,Chelmsford 005F,E01033144,1272,1014,258,53,57,148
2011,Chelmsford 006A,E01021576,1101,763,338,93,57,188
2011,Chelmsford 006B,E01021588,960,676,284,147,33,104
2011,Chelmsford 006C,E01021589,1109,815,294,131,58,105
2011,Chelmsford 006D,E01021592,1077,743,334,137,37,160
2011,Chelmsford 006E,E01021596,1067,743,324,123,33,168
2011,Chelmsford 007A,E01021618,1123,922,201,97,40,64
2011,Chelmsford 007B,E01021621,1167,996,171,63,26,82
2011,Chelmsford 007C,E01021622,1026,670,356,232,44,80
2011,Chelmsford 007D,E01021625,1026,752,274,180,30,64
2011,Chelmsford 007E,E01021626,1042,788,254,155,37,62
2011,Chelmsford 008A,E01021544,1024,833,191,94,30,67
2011,Chelmsford 008B,E01021545,1134,940,194,110,32,52
2011,Chelmsford 008C,E01021546,1090,864,226,94,37,95
2011,Chelmsford 008D,E01021547,1256,1048,208,72,43,93
2011,Chelmsford 008E,E01021628,1253,989,264,125,49,90
2011,Chelmsford 008F,E01021629,1211,927,284,118,41,125
2011,Chelmsford 009A,E01021573,1256,946,310,134,61,115
2011,Chelmsford 009B,E01021575,1250,966,284,105,63,116
2011,Chelmsford 009C,E01021599,1343,1005,338,181,42,115
2011,Chelmsford 009E,E01021631,1290,915,375,139,63,173
2011,Chelmsford 009F,E01033138,1147,887,260,119,38,103
2011,Chelmsford 009G,E01033139,1145,980,165,35,39,91
2011,Chelmsford 010A,E01021574,2060,1561,499,52,357,90
2011,Chelmsford 010B,E01021578,1360,1139,221,85,37,99
2011,Chelmsford 010D,E01021582,1510,1238,272,115,49,108
2011,Chelmsford 010E,E01021627,1241,791,450,171,37,242
2011,Chelmsford 010F,E01033140,902,772,130,54,19,57
2011,Chelmsford 010G,E01033141,783,659,124,43,28,53
2011,Chelmsford 011A,E01021551,1005,677,328,202,36,90
2011,Chelmsford 011B,E01021632,1007,650,357,248,23,86
2011,Chelmsford 011C,E01021633,1075,638,437,165,225,47
2011,Chelmsford 011D,E01021634,1134,804,330,206,62,62
2011,Chelmsford 011E,E01021635,997,696,301,219,20,62
2011,Chelmsford 011F,E01021636,785,510,275,161,35,79
2011,Chelmsford 012A,E01021556,1192,902,290,163,44,83
2011,Chelmsford 012B,E01021577,1055,824,231,118,42,71
2011,Chelmsford 012C,E01021579,1100,870,230,110,39,81
2011,Chelmsford 012D,E01021580,1019,764,255,124,64,67
2011,Chelmsford 012E,E01021584,859,601,258,187,29,42
2011,Chelmsford 013A,E01021548,1025,804,221,120,38,63
2011,Chelmsford 013B,E01021560,1146,793,353,238,32,83
2011,Chelmsford 013C,E01021561,1297,902,395,262,54,79
2011,Chelmsford 013D,E01021564,1066,712,354,248,29,77
2011,Chelmsford 013E,E01021571,1116,778,338,205,56,77
2011,Chelmsford 014A,E01021562,1282,912,370,218,43,109
2011,Chelmsford 014B,E01021563,1233,918,315,113,49,153
2011,Chelmsford 014C,E01021565,1141,796,345,145,35,165
2011,Chelmsford 014D,E01021566,1253,870,383,224,40,119
2011,Chelmsford 014F,E01033137,1140,893,247,117,36,94
2011,Chelmsford 014G,E01033145,988,702,286,169,25,92
2011,Chelmsford 015A,E01021557,983,748,235,155,31,49
2011,Chelmsford 015B,E01021558,978,749,229,147,28,54
2011,Chelmsford 015C,E01021583,1122,866,256,120,49,87
2011,Chelmsford 015D,E01021585,945,727,218,144,24,50
2011,Chelmsford 015E,E01021586,1157,818,339,244,34,61
2011,Chelmsford 016A,E01021533,1729,1241,488,304,48,136
2011,Chelmsford 016B,E01021535,1291,923,368,203,55,110
2011,Chelmsford 016C,E01021569,1164,768,396,281,38,77
2011,Chelmsford 016D,E01021570,1359,893,466,303,48,115
2011,Chelmsford 016E,E01021572,1077,745,332,174,50,108
2011,Chelmsford 017A,E01021552,1085,711,374,239,40,95
2011,Chelmsford 017B,E01021553,1038,759,279,154,36,89
2011,Chelmsford 017C,E01021554,1078,747,331,181,32,118
2011,Chelmsford 017D,E01021555,992,725,267,162,35,70
2011,Chelmsford 017E,E01021559,1127,803,324,208,43,73
2011,Chelmsford 018B,E01021602,1196,801,395,229,36,130
2011,Chelmsford 018D,E01021604,1649,1213,436,249,53,134
2011,Chelmsford 018E,E01033143,1908,1241,667,466,48,153
2011,Chelmsford 019A,E01021611,1121,858,263,132,48,83
2011,Chelmsford 019B,E01021612,1132,816,316,208,37,71
2011,Chelmsford 019C,E01021613,1359,1113,246,116,47,83
2011,Chelmsford 019D,E01021614,1343,1005,338,209,47,82
2011,Chelmsford 019E,E01021615,1089,829,260,169,21,70
2011,Chelmsford 020A,E01021605,992,769,223,126,46,51
2011,Chelmsford 020B,E01021606,1290,996,294,119,60,115
2011,Chelmsford 020C,E01021607,1139,952,187,86,35,66
2011,Chelmsford 020D,E01021608,865,701,164,93,18,53
2011,Chelmsford 020E,E01021609,1057,830,227,120,29,78
2011,Chelmsford 020F,E01021610,1016,806,210,97,36,77
2011,Chelmsford 021A,E01021593,1221,760,461,270,31,160
2011,Chelmsford 021B,E01021594,1269,880,389,236,33,120
2011,Chelmsford 021C,E01021595,1243,846,397,259,34,104
2011,Colchester 001A,E01021655,1018,696,322,204,38,80
2011,Colchester 001B,E01021656,1105,760,345,206,40,99
2011,Colchester 001C,E01021659,1532,1094,438,254,57,127
2011,Colchester 001D,E01021661,1268,927,341,196,42,103
2011,Colchester 002A,E01021668,1271,1018,253,82,53,118
2011,Colchester 002B,E01021669,1113,862,251,89,38,124
2011,Colchester 002C,E01021670,1087,773,314,119,59,136
2011,Colchester 002D,E01021671,1092,737,355,177,54,124
2011,Colchester 002F,E01033720,1458,1182,276,54,67,155
2011,Colchester 002G,E01033721,1219,1035,184,37,44,103
2011,Colchester 003A,E01021660,1117,788,329,179,43,107
2011,Colchester 003B,E01021728,1175,817,358,243,45,70
2011,Colchester 003C,E01021729,1217,910,307,172,38,97
2011,Colchester 003D,E01021730,1265,894,371,220,39,112
2011,Colchester 004A,E01021679,1778,1439,339,114,56,169
2011,Colchester 004B,E01021680,2040,1587,453,179,58,216
2011,Colchester 004C,E01021681,2030,1657,373,183,62,128
2011,Colchester 004D,E01021682,2021,1596,425,172,93,160
2011,Colchester 007A,E01021646,1516,1192,324,143,84,97
2011,Colchester 007B,E01021647,1367,986,381,212,61,108
2011,Colchester 007C,E01021648,1851,1348,503,210,125,168
2011,Colchester 007D,E01021649,1503,1101,402,136,110,156
2011,Colchester 007E,E01021650,1566,1302,264,80,86,98
2011,Colchester 008A,E01021696,1126,651,475,143,114,218
2011,Colchester 008B,E01021697,1217,766,451,180,109,162
2011,Colchester 008C,E01021698,1228,728,500,98,298,104
2011,Colchester 008D,E01021699,1143,670,473,152,187,134
2011,Colchester 008E,E01021700,1116,647,469,87,196,186
2011,Colchester 008G,E01033719,1538,612,926,7,861,58
2011,Colchester 008H,E01033722,1306,732,574,95,345,134
2011,Colchester 009A,E01021673,938,604,334,231,45,58
2011,Colchester 009B,E01021674,976,739,237,88,48,101
2011,Colchester 009C,E01021675,946,684,262,157,38,67
2011,Colchester 009D,E01021676,950,645,305,174,52,79
2011,Colchester 010A,E01021654,1331,1009,322,194,31,97
2011,Colchester 010B,E01021662,1185,829,356,201,44,111
2011,Colchester 010C,E01021663,816,569,247,160,22,65
2011,Colchester 010D,E01021677,938,678,260,178,27,55
2011,Colchester 010E,E01021678,1016,761,255,137,31,87
2011,Colchester 011A,E01021683,2148,1875,273,59,66,148
2011,Colchester 011B,E01021684,1118,862,256,123,43,90
2011,Colchester 011C,E01021685,1496,1075,421,56,205,160
2011,Colchester 011D,E01021686,1477,1084,393,82,128,183
2011,Colchester 011E,E01021687,1267,988,279,84,82,113
2011,Colchester 011F,E01021688,1046,811,235,79,76,80
2011,Colchester 012A,E01021718,1167,932,235,134,32,69
2011,Colchester 012B,E01021719,1099,771,328,211,27,90
2011,Colchester 012C,E01021720,1047,742,305,161,26,118
2011,Colchester 012D,E01021721,1442,1043,399,256,53,90
2011,Colchester 012E,E01021722,1200,866,334,193,44,97
2011,Colchester 013A,E01021651,1177,950,227,65,58,104
2011,Colchester 013B,E01021652,1119,806,313,156,71,86
2011,Colchester 013C,E01021653,965,765,200,99,58,43
2011,Colchester 013D,E01021717,1279,979,300,138,71,91
2011,Colchester 014A,E01021689,989,681,308,170,56,82
2011,Colchester 014B,E01021690,998,760,238,117,29,92
2011,Colchester 014C,E01021691,1055,712,343,235,37,71
2011,Colchester 014D,E01021692,1087,766,321,201,45,75
2011,Colchester 014E,E01021693,1096,698,398,267,38,93
2011,Colchester 015A,E01021711,894,602,292,142,32,118
2011,Colchester 015C,E01021713,850,574,276,135,37,104
2011,Colchester 015D,E01021714,1272,1011,261,71,52,138
2011,Colchester 015E,E01021715,1057,824,233,94,40,99
2011,Colchester 015G,E01033723,1646,1273,373,28,54,291
2011,Colchester 016A,E01021657,1203,916,287,163,44,80
2011,Colchester 016B,E01021658,776,578,198,112,22,64
2011,Colchester 016C,E01021664,1515,1099,416,174,117,125
2011,Colchester 016D,E01021665,999,695,304,115,34,155
2011,Colchester 016E,E01021666,1011,793,218,105,40,73
2011,Colchester 016F,E01021667,1027,708,319,127,51,141
2011,Colchester 017A,E01021736,3115,1182,1933,105,1759,69
2011,Colchester 017B,E01021737,913,617,296,152,76,68
2011,Colchester 017C,E01021738,1600,1137,463,259,98,106
2011,Colchester 017D,E01021739,1180,816,364,223,71,70
2011,Colchester 017E,E01021740,1286,833,453,243,124,86
2011,Colchester 018A,E01021637,896,652,244,121,22,101
2011,Colchester 018B,E01021638,915,640,275,105,35,135
2011,Colchester 018C,E01021639,1523,1248,275,98,44,133
2011,Colchester 018D,E01021640,898,675,223,85,39,99
2011,Colchester 018E,E01021641,989,721,268,101,40,127
2011,Colchester 018F,E01021642,1454,1096,358,148,54,156
2011,Colchester 019A,E01021643,1808,1335,473,285,50,138
2011,Colchester 019B,E01021644,1271,894,377,203,44,130
2011,Colchester 019C,E01021645,1128,810,318,215,38,65
2011,Colchester 019D,E01021694,1095,770,325,202,35,88
2011,Colchester 019E,E01021695,822,584,238,160,19,59
2011,Colchester 020A,E01021723,1222,813,409,278,29,102
2011,Colchester 020B,E01021724,1179,795,384,256,38,90
2011,Colchester 020C,E01021725,983,672,311,219,31,61
2011,Colchester 020D,E01021726,1124,745,379,195,29,155
2011,Colchester 020E,E01021727,1111,750,361,253,33,75
2011,Colchester 021A,E01021731,1013,677,336,244,23,69
2011,Colchester 021B,E01021732,1060,723,337,195,33,109
2011,Colchester 021C,E01021733,1073,687,386,282,16,88
2011,Colchester 021D,E01021734,964,611,353,263,19,71
2011,Colchester 021E,E01021735,917,581,336,241,25,70
2011,Colchester 022D,E01021702,994,720,274,154,48,72
2011,Colchester 022E,E01021703,856,574,282,76,53,153
2011,Colchester 022F,E01021704,1103,778,325,130,59,136
2011,Colchester 022G,E01021705,1583,1183,400,227,84,89
2011,Colchester 022H,E01021706,1027,732,295,95,112,88
2011,Colchester 022I,E01021707,981,660,321,180,47,94
2011,Colchester 022A,E01021708,1075,744,331,214,28,89
2011,Colchester 022B,E01021709,1022,653,369,293,32,44
2011,Colchester 022C,E01021710,1481,1013,468,306,55,107
2011,Epping Forest 001A,E01021768,1555,1138,417,220,58,139
2011,Epping Forest 001B,E01021795,1573,1284,289,163,50,76
2011,Epping Forest 001C,E01021797,1008,765,243,149,25,69
2011,Epping Forest 001D,E01021798,1104,753,351,223,38,90
2011,Epping Forest 001E,E01021799,1142,831,311,152,40,119
2011,Epping Forest 002A,E01021741,1479,1090,389,202,59,128
2011,Epping Forest 002B,E01021792,919,603,316,200,40,76
2011,Epping Forest 002C,E01021793,1126,759,367,233,52,82
2011,Epping Forest 002D,E01021794,831,590,241,143,34,64
2011,Epping Forest 002E,E01021801,1669,1178,491,288,69,134
2011,Epping Forest 003A,E01021769,1628,1148,480,251,74,155
2011,Epping Forest 003B,E01021796,1562,1112,450,273,41,136
2011,Epping Forest 003C,E01021800,1696,1192,504,247,77,180
2011,Epping Forest 004A,E01021753,1018,760,258,129,38,91
2011,Epping Forest 004B,E01021754,1089,731,358,230,48,80
2011,Epping Forest 004C,E01021755,785,519,266,172,42,52
2011,Epping Forest 004D,E01021802,1515,1118,397,189,56,152
2011,Epping Forest 005A,E01021760,1080,773,307,164,48,95
2011,Epping Forest 005B,E01021761,1306,928,378,193,43,142
2011,Epping Forest 005C,E01021762,936,648,288,161,30,97
2011,Epping Forest 005D,E01021763,1081,806,275,147,29,99
2011,Epping Forest 006A,E01021756,1120,826,294,164,45,85
2011,Epping Forest 006B,E01021757,1184,865,319,210,36,73
2011,Epping Forest 006C,E01021758,1140,797,343,199,36,108
2011,Epping Forest 006D,E01021759,1051,794,257,123,38,96
2011,Epping Forest 007A,E01021811,992,690,302,147,37,118
2011,Epping Forest 007B,E01021813,1055,744,311,209,36,66
2011,Epping Forest 007C,E01021814,1055,791,264,134,41,89
2011,Epping Forest 007D,E01021815,1139,830,309,130,55,124
2011,Epping Forest 007E,E01021816,925,616,309,144,38,127
2011,Epping Forest 008A,E01021807,1091,795,296,149,47,100
2011,Epping Forest 008B,E01021808,1074,776,298,133,41,124
2011,Epping Forest 008C,E01021809,1073,728,345,168,41,136
2011,Epping Forest 008D,E01021810,1370,1117,253,108,29,116
2011,Epping Forest 008E,E01021817,1806,1326,480,197,76,207
2011,Epping Forest 009A,E01021806,1639,1078,561,340,52,169
2011,Epping Forest 009B,E01021812,954,651,303,189,19,95
2011,Epping Forest 009C,E01021818,1325,1001,324,147,35,142
2011,Epping Forest 010A,E01021770,1439,989,450,237,52,161
2011,Epping Forest 010B,E01021803,949,663,286,154,57,75
2011,Epping Forest 010C,E01021804,1027,745,282,147,46,89
2011,Epping Forest 010D,E01021805,867,609,258,151,41,66
2011,Epping Forest 011A,E01021774,1021,763,258,77,47,134
2011,Epping Forest 011B,E01021775,1023,712,311,100,56,155
2011,Epping Forest 011C,E01021776,994,646,348,176,61,111
2011,Epping Forest 011D,E01021777,998,711,287,141,61,85
2011,Epping Forest 011E,E01021778,1070,795,275,78,87,110
2011,Epping Forest 011F,E01021779,1107,814,293,112,55,126
2011,Epping Forest 012A,E01021786,917,687,230,127,40,63
2011,Epping Forest 012B,E01021787,1186,898,288,139,77,72
2011,Epping Forest 012C,E01021788,1141,799,342,189,63,90
2011,Epping Forest 012D,E01021789,1119,795,324,148,54,122
2011,Epping Forest 012E,E01021790,1014,755,259,79,71,109
2011,Epping Forest 012F,E01021791,1162,838,324,150,86,88
2011,Epping Forest 013A,E01021771,1080,755,325,117,47,161
2011,Epping Forest 013B,E01021772,1078,703,375,175,79,121
2011,Epping Forest 013C,E01021773,1105,838,267,100,74,93
2011,Epping Forest 013D,E01021783,1141,843,298,164,55,79
2011,Epping Forest 013E,E01021784,1115,827,288,156,50,82
2011,Epping Forest 014A,E01021780,1042,713,329,139,65,125
2011,Epping Forest 014B,E01021781,1107,809,298,159,36,103
2011,Epping Forest 014C,E01021782,1015,766,249,130,48,71
2011,Epping Forest 014D,E01021785,1160,865,295,103,57,135
2011,Epping Forest 015A,E01021742,977,716,261,125,39,97
2011,Epping Forest 015B,E01021743,1163,864,299,158,40,101
2011,Epping Forest 015C,E01021744,1158,899,259,147,39,73
2011,Epping Forest 015D,E01021745,1126,860,266,120,53,93
2011,Epping Forest 015E,E01021746,1271,958,313,159,56,98
2011,Epping Forest 015F,E01021747,1216,849,367,210,52,105
2011,Epping Forest 015G,E01021748,1266,985,281,147,33,101
2011,Epping Forest 016A,E01021749,1666,1170,496,296,62,138
2011,Epping Forest 016B,E01021750,945,644,301,117,85,99
2011,Epping Forest 016C,E01021751,1014,744,270,114,76,80
2011,Epping Forest 016D,E01021752,1142,849,293,127,60,106
2011,Epping Forest 017A,E01021764,1208,839,369,98,54,217
2011,Epping Forest 017B,E01021765,1201,861,340,130,80,130
2011,Epping Forest 017C,E01021766,1074,738,336,135,83,118
2011,Epping Forest 017D,E01021767,1223,839,384,195,85,104
2011,Harlow 001A,E01021854,1219,920,299,169,38,92
2011,Harlow 001B,E01021855,957,696,261,137,38,86
2011,Harlow 001C,E01021856,1054,795,259,142,47,70
2011,Harlow 001D,E01021857,1818,1406,412,207,65,140
2011,Harlow 002A,E01021844,991,748,243,101,35,107
2011,Harlow 002B,E01021845,995,735,260,91,40,129
2011,Harlow 002C,E01021846,962,689,273,91,60,122
2011,Harlow 002D,E01021847,954,672,282,147,31,104
2011,Harlow 002E,E01021848,1114,840,274,109,44,121
2011,Harlow 003A,E01021849,1145,828,317,137,50,130
2011,Harlow 003B,E01021850,998,731,267,97,35,135
2011,Harlow 003C,E01021851,1089,834,255,107,39,109
2011,Harlow 003D,E01021852,1031,734,297,115,40,142
2011,Harlow 003E,E01021853,956,728,228,103,31,94
2011,Harlow 004A,E01021839,1091,842,249,128,35,86
2011,Harlow 004B,E01021840,1041,798,243,89,34,120
2011,Harlow 004C,E01021841,965,720,245,105,32,108
2011,Harlow 004D,E01021842,1079,798,281,103,49,129
2011,Harlow 004E,E01021843,1539,1245,294,107,42,145
2011,Harlow 005A,E01021824,1182,959,223,109,39,75
2011,Harlow 005B,E01021825,1151,939,212,93,39,80
2011,Harlow 005C,E01021826,1166,923,243,127,35,81
2011,Harlow 005D,E01021827,1227,949,278,127,44,107
2011,Harlow 005E,E01021828,1608,1344,264,118,43,103
2011,Harlow 006A,E01021819,1079,814,265,107,36,122
2011,Harlow 006B,E01021820,1048,755,293,144,41,108
2011,Harlow 006C,E01021822,1100,784,316,151,46,119
2011,Harlow 006D,E01021823,1179,855,324,121,34,169
2011,Harlow 006E,E01021870,915,678,237,109,31,97
2011,Harlow 007A,E01021831,992,694,298,146,29,123
2011,Harlow 007B,E01021868,1154,865,289,155,40,94
2011,Harlow 007C,E01021869,954,681,273,139,35,99
2011,Harlow 007D,E01021871,1002,689,313,138,36,139
2011,Harlow 007E,E01021872,1317,977,340,82,82,176
2011,Harlow 008A,E01021821,927,675,252,106,26,120
2011,Harlow 008B,E01021834,1037,742,295,125,39,131
2011,Harlow 008C,E01021835,1036,754,282,128,40,114
2011,Harlow 008D,E01021836,1016,721,295,107,36,152
2011,Harlow 008E,E01021837,1048,759,289,160,27,102
2011,Harlow 009A,E01021829,1115,853,262,137,33,92
2011,Harlow 009B,E01021830,882,627,255,156,31,68
2011,Harlow 009C,E01021832,967,756,211,115,25,71
2011,Harlow 009D,E01021833,899,641,258,153,21,84
2011,Harlow 009E,E01021865,1012,818,194,79,25,90
2011,Harlow 010A,E01021838,1083,795,288,149,43,96
2011,Harlow 010B,E01021858,1108,776,332,148,32,152
2011,Harlow 010C,E01021859,1053,771,282,90,44,148
2011,Harlow 010D,E01021860,1091,779,312,133,44,135
2011,Harlow 010E,E01021861,906,662,244,96,35,113
2011,Harlow 011A,E01021862,1059,743,316,125,59,132
2011,Harlow 011B,E01021863,1175,859,316,132,53,131
2011,Harlow 011C,E01021864,1062,784,278,91,47,140
2011,Harlow 011D,E01021866,1013,819,194,80,24,90
2011,Harlow 011E,E01021867,1108,848,260,164,23,73
2011,Maldon 001A,E01021908,1515,1078,437,278,46,113
2011,Maldon 001B,E01021909,1011,708,303,180,30,93
2011,Maldon 001C,E01021910,1098,785,313,187,42,84
2011,Maldon 001D,E01021911,982,664,318,214,22,82
2011,Maldon 002A,E01021882,1508,981,527,368,39,120
2011,Maldon 002B,E01021883,1203,859,344,228,41,75
2011,Maldon 002C,E01021912,1443,916,527,353,49,125
2011,Maldon 002D,E01021913,1124,747,377,226,53,98
2011,Maldon 003A,E01021884,1094,879,215,113,20,82
2011,Maldon 003B,E01021885,862,617,245,157,28,60
2011,Maldon 003C,E01021886,1137,837,300,166,38,96
2011,Maldon 003D,E01021887,1566,1221,345,194,45,106
2011,Maldon 003E,E01021888,1341,914,427,204,30,193
2011,Maldon 004A,E01021889,1541,1051,490,205,58,227
2011,Maldon 004B,E01021890,1258,898,360,185,33,142
2011,Maldon 004C,E01021891,989,662,327,246,22,59
2011,Maldon 004D,E01021892,705,435,270,144,30,96
2011,Maldon 005A,E01021893,1111,811,300,191,27,82
2011,Maldon 005B,E01021894,864,613,251,133,23,95
2011,Maldon 005C,E01021895,912,672,240,146,24,70
2011,Maldon 005D,E01021896,1004,725,279,173,45,61
2011,Maldon 005E,E01021897,914,676,238,149,35,54
2011,Maldon 005F,E01021898,898,569,329,240,15,74
2011,Maldon 006A,E01021901,1383,953,430,271,31,128
2011,Maldon 006B,E01021904,1080,794,286,161,23,102
2011,Maldon 006C,E01021905,918,634,284,157,31,96
2011,Maldon 006D,E01021906,1097,800,297,143,40,114
2011,Maldon 006E,E01021907,1636,1154,482,303,51,128
2011,Maldon 007A,E01021873,1061,752,309,184,35,90
2011,Maldon 007B,E01021874,1025,755,270,125,36,109
2011,Maldon 007C,E01021875,1028,667,361,259,20,82
2011,Maldon 007D,E01021899,1037,774,263,139,28,96
2011,Maldon 007E,E01021900,799,568,231,125,29,77
2011,Maldon 007F,E01021902,1373,976,397,236,61,100
2011,Maldon 007G,E01021903,1209,842,367,232,27,108
2011,Maldon 008C,E01021878,1003,661,342,261,22,59
2011,Maldon 008D,E01021879,1010,715,295,167,23,105
2011,Maldon 008E,E01021880,1068,696,372,216,27,129
2011,Maldon 008F,E01021881,867,618,249,148,18,83
2011,Maldon 008G,E01033057,1732,1179,553,341,56,156
2011,Rochford 001A,E01021942,1196,675,521,401,17,103
2011,Rochford 001B,E01021943,1343,887,456,318,39,99
2011,Rochford 001C,E01021944,1255,863,392,275,30,87
2011,Rochford 001D,E01021945,1193,805,388,259,41,88
2011,Rochford 002A,E01021914,1546,1106,440,278,48,114
2011,Rochford 002B,E01021927,1040,736,304,189,40,75
2011,Rochford 002C,E01021928,1158,845,313,195,31,87
2011,Rochford 002D,E01021929,1200,932,268,152,43,73
2011,Rochford 002E,E01021931,940,617,323,217,25,81
2011,Rochford 003A,E01021933,1001,677,324,190,40,94
2011,Rochford 003B,E01021934,1024,702,322,214,26,82
2011,Rochford 003C,E01021935,1011,673,338,216,36,86
2011,Rochford 003D,E01021936,1161,773,388,258,38,92
2011,Rochford 003E,E01021937,1192,865,327,195,34,98
2011,Rochford 003F,E01021938,1048,722,326,240,16,70
2011,Rochford 003G,E01021939,1229,906,323,210,38,75
2011,Rochford 003H,E01021940,1541,1051,490,301,49,140
2011,Rochford 003I,E01021941,1557,1120,437,265,63,109
2011,Rochford 004A,E01021915,970,714,256,133,35,88
2011,Rochford 004B,E01021916,740,528,212,130,27,55
2011,Rochford 004C,E01021953,1014,673,341,91,51,199
2011,Rochford 004D,E01021955,1276,913,363,174,34,155
2011,Rochford 005A,E01021918,1109,812,297,176,36,85
2011,Rochford 005B,E01021919,947,665,282,190,30,62
2011,Rochford 005C,E01021925,1194,856,338,205,45,88
2011,Rochford 005D,E01021960,1590,962,628,346,55,227
2011,Rochford 005E,E01021961,1050,729,321,239,29,53
2011,Rochford 006A,E01021920,1516,1171,345,186,37,122
2011,Rochford 006B,E01021926,1450,1130,320,176,27,117
2011,Rochford 006C,E01021957,1094,752,342,162,35,145
2011,Rochford 006D,E01021958,940,760,180,97,22,61
2011,Rochford 006E,E01021959,1200,922,278,139,37,102
2011,Rochford 007A,E01021930,1039,802,237,120,26,91
2011,Rochford 007B,E01021932,1079,809,270,171,25,74
2011,Rochford 007C,E01021952,1017,721,296,180,28,88
2011,Rochford 007D,E01021954,1101,807,294,134,36,124
2011,Rochford 007E,E01021956,1069,774,295,156,26,113
2011,Rochford 008A,E01021950,1073,751,322,190,30,102
2011,Rochford 008B,E01021951,903,628,275,178,36,61
2011,Rochford 008C,E01021962,859,630,229,141,25,63
2011,Rochford 008D,E01021963,968,645,323,199,34,90
2011,Rochford 008E,E01021964,1115,816,299,200,30,69
2011,Rochford 008F,E01021966,1175,814,361,231,37,93
2011,Rochford 009A,E01021946,1210,844,366,245,30,91
2011,Rochford 009B,E01021947,862,602,260,184,20,56
2011,Rochford 009C,E01021948,964,700,264,148,40,76
2011,Rochford 009D,E01021949,1094,767,327,223,27,77
2011,Rochford 009E,E01021965,1613,1149,464,332,36,96
2011,Rochford 010A,E01021917,1366,997,369,194,52,123
2011,Rochford 010B,E01021921,1145,842,303,158,41,104
2011,Rochford 010C,E01021922,1060,710,350,189,42,119
2011,Rochford 010D,E01021923,1021,725,296,178,39,79
2011,Rochford 010E,E01021924,967,729,238,147,32,59
2011,Tendring 001A,E01021997,1004,676,328,154,37,137
2011,Tendring 001B,E01021998,999,676,323,149,36,138
2011,Tendring 001C,E01021999,1180,787,393,219,51,123
2011,Tendring 001D,E01022001,1205,825,380,170,31,179
2011,Tendring 002A,E01022000,1117,756,361,210,40,111
2011,Tendring 002C,E01022006,1119,707,412,202,56,154
2011,Tendring 002D,E01022007,1205,835,370,159,47,164
2011,Tendring 002F,E01033051,1651,1057,594,337,57,200
2011,Tendring 003A,E01021978,1652,1108,544,346,54,144
2011,Tendring 003B,E01022013,1149,851,298,207,43,48
2011,Tendring 003C,E01022014,993,649,344,211,31,102
2011,Tendring 003D,E01022015,1053,821,232,128,35,69
2011,Tendring 003E,E01022019,1131,743,388,169,46,173
2011,Tendring 003F,E01022020,1262,930,332,207,29,96
2011,Tendring 003G,E01022021,986,702,284,149,35,100
2011,Tendring 004A,E01021991,748,506,242,154,26,62
2011,Tendring 004B,E01021992,853,592,261,146,33,82
2011,Tendring 004C,E01022002,1336,868,468,285,47,136
2011,Tendring 004D,E01022004,1178,738,440,317,26,97
2011,Tendring 004E,E01022005,1193,819,374,264,35,75
2011,Tendring 004F,E01022028,969,630,339,199,33,107
2011,Tendring 005A,E01021971,800,540,260,151,37,72
2011,Tendring 005B,E01021972,946,680,266,135,31,100
2011,Tendring 005C,E01022051,1054,714,340,181,40,119
2011,Tendring 005D,E01022052,1037,731,306,187,35,84
2011,Tendring 006A,E01021985,873,470,403,294,32,77
2011,Tendring 006B,E01021986,935,556,379,265,24,90
2011,Tendring 006C,E01022054,969,541,428,268,32,128
2011,Tendring 006D,E01022055,821,385,436,307,22,107
2011,Tendring 006E,E01022056,1151,713,438,227,46,165
2011,Tendring 007A,E01021973,823,551,272,190,29,53
2011,Tendring 007B,E01021974,889,615,274,126,33,115
2011,Tendring 007C,E01022016,1243,697,546,396,30,120
2011,Tendring 007D,E01022017,1051,670,381,207,46,128
2011,Tendring 007E,E01022018,1006,631,375,227,20,128
2011,Tendring 008A,E01021987,812,428,384,283,32,69
2011,Tendring 008B,E01021994,748,362,386,304,12,70
2011,Tendring 008C,E01021995,865,487,378,274,35,69
2011,Tendring 008D,E01021996,824,478,346,228,23,95
2011,Tendring 008E,E01022009,1020,590,430,299,37,94
2011,Tendring 008F,E01022010,1056,631,425,288,38,99
2011,Tendring 008G,E01022011,1264,824,440,281,38,121
2011,Tendring 008H,E01022012,1153,524,629,474,26,129
2011,Tendring 009A,E01021967,1474,1014,460,306,50,104
2011,Tendring 009B,E01021983,1007,664,343,260,19,64
2011,Tendring 009C,E01021993,1599,1110,489,328,44,117
2011,Tendring 009D,E01022053,1316,908,408,269,33,106
2011,Tendring 010A,E01021984,1453,756,697,517,25,155
2011,Tendring 010B,E01022039,1035,675,360,194,47,119
2011,Tendring 010C,E01022040,1227,639,588,426,29,133
2011,Tendring 010D,E01022041,1025,575,450,336,22,92
2011,Tendring 011A,E01021979,1049,674,375,218,55,102
2011,Tendring 011B,E01021980,1246,814,432,300,38,94
2011,Tendring 011C,E01021981,1199,825,374,252,38,84
2011,Tendring 011D,E01021982,1321,962,359,182,42,135
2011,Tendring 011E,E01022046,1150,662,488,314,41,133
2011,Tendring 012A,E01022008,1362,678,684,532,30,122
2011,Tendring 012B,E01022033,963,481,482,369,26,87
2011,Tendring 012C,E01022034,1064,536,528,388,30,110
2011,Tendring 012D,E01022035,1010,536,474,359,35,80
2011,Tendring 013A,E01021975,1032,647,385,231,27,127
2011,Tendring 013B,E01021976,1004,658,346,208,34,104
2011,Tendring 013C,E01021977,1144,718,426,273,37,116
2011,Tendring 013D,E01022022,1052,706,346,179,37,130
2011,Tendring 013E,E01022044,1133,674,459,300,38,121
2011,Tendring 014A,E01022042,1001,568,433,236,46,151
2011,Tendring 014B,E01022043,1328,885,443,145,55,243
2011,Tendring 014C,E01022048,1035,571,464,313,37,114
2011,Tendring 014D,E01022049,1014,609,405,232,53,120
2011,Tendring 014E,E01022050,1113,641,472,319,34,119
2011,Tendring 015A,E01022023,1073,662,411,200,50,161
2011,Tendring 015B,E01022024,1020,692,328,165,32,131
2011,Tendring 015C,E01022030,1104,532,572,284,54,234
2011,Tendring 015D,E01022031,920,522,398,104,46,248
2011,Tendring 015E,E01022032,1184,675,509,255,50,204
2011,Tendring 016A,E01021970,1131,701,430,192,27,211
2011,Tendring 016B,E01022025,1122,593,529,197,34,298
2011,Tendring 016C,E01022026,1125,699,426,119,54,253
2011,Tendring 016D,E01022027,1158,726,432,185,36,211
2011,Tendring 017A,E01021968,1245,798,447,165,57,225
2011,Tendring 017B,E01021969,1008,638,370,164,40,166
2011,Tendring 017C,E01022036,898,536,362,244,23,95
2011,Tendring 017D,E01022037,920,520,400,270,40,90
2011,Tendring 017E,E01022038,1016,601,415,247,29,139
2011,Tendring 018A,E01021988,1370,618,752,329,22,401
2011,Tendring 018B,E01021989,1040,445,595,463,22,110
2011,Tendring 018C,E01021990,1136,551,585,379,23,183
2011,Tendring 018D,E01022045,993,527,466,281,34,151
2011,Tendring 018E,E01022047,908,592,316,199,22,95
2011,Uttlesford 001A,E01022057,1247,906,341,174,51,116
2011,Uttlesford 001B,E01022075,1226,893,333,169,69,95
2011,Uttlesford 001C,E01022077,1156,896,260,150,40,70
2011,Uttlesford 001D,E01022094,1197,891,306,165,46,95
2011,Uttlesford 002A,E01022074,1062,786,276,125,48,103
2011,Uttlesford 002B,E01022076,1100,823,277,150,36,91
2011,Uttlesford 002C,E01022078,1098,788,310,143,37,130
2011,Uttlesford 002D,E01022079,1209,899,310,169,51,90
2011,Uttlesford 002E,E01022080,1249,1058,191,59,50,82
2011,Uttlesford 002F,E01022081,1548,1135,413,223,58,132
2011,Uttlesford 002G,E01022082,1345,1017,328,149,75,104
2011,Uttlesford 003A,E01022061,1042,723,319,194,32,93
2011,Uttlesford 003B,E01022071,1224,859,365,197,60,108
2011,Uttlesford 003C,E01022072,1329,941,388,196,62,130
2011,Uttlesford 003D,E01022073,1158,856,302,159,62,81
2011,Uttlesford 003E,E01022098,1128,827,301,159,47,95
2011,Uttlesford 004A,E01022092,1281,935,346,207,48,91
2011,Uttlesford 004B,E01022093,1193,859,334,172,46,116
2011,Uttlesford 004C,E01022097,1344,975,369,200,71,98
2011,Uttlesford 004D,E01022099,1765,1413,352,169,61,122
2011,Uttlesford 005A,E01022062,1534,1128,406,220,60,126
2011,Uttlesford 005B,E01022063,1184,878,306,146,57,103
2011,Uttlesford 005C,E01022083,1243,888,355,222,42,91
2011,Uttlesford 005D,E01022084,1176,866,310,185,52,73
2011,Uttlesford 005E,E01022085,1221,996,225,110,30,85
2011,Uttlesford 005F,E01022087,1351,1077,274,139,42,93
2011,Uttlesford 005G,E01022089,1148,829,319,181,38,100
2011,Uttlesford 006A,E01022086,999,763,236,102,29,105
2011,Uttlesford 006B,E01022090,1735,1359,376,178,55,143
2011,Uttlesford 006C,E01022091,1732,1281,451,280,46,125
2011,Uttlesford 006D,E01022095,1150,850,300,159,38,103
2011,Uttlesford 007B,E01022067,1317,1018,299,156,32,111
2011,Uttlesford 007C,E01022068,1132,852,280,154,37,89
2011,Uttlesford 007D,E01033054,759,584,175,88,20,67
2011,Uttlesford 007E,E01033055,1019,794,225,106,46,73
2011,Uttlesford 007F,E01033056,940,654,286,149,42,95
2011,Uttlesford 008A,E01022058,1255,925,330,164,62,104
2011,Uttlesford 008B,E01022064,1257,884,373,246,43,84
2011,Uttlesford 008D,E01022069,1071,781,290,211,28,51
2011,Uttlesford 008E,E01022088,1168,863,305,187,48,70
2011,Uttlesford 008F,E01033052,1292,810,482,174,207,101
2011,Uttlesford 008G,E01033053,1228,1042,186,46,47,93
2011,Uttlesford 009A,E01022059,1158,875,283,166,46,71
2011,Uttlesford 009B,E01022060,1415,1029,386,194,63,129
2011,Uttlesford 009C,E01022070,1341,962,379,209,56,114
2011,Uttlesford 009D,E01022096,1360,1005,355,184,55,116
2011,Broxbourne 001A,E01023316,1106,808,298,189,48,61
2011,Broxbourne 001B,E01023317,1768,1342,426,218,72,136
2011,Broxbourne 001C,E01023318,1227,897,330,210,55,65
2011,Broxbourne 001D,E01023319,1143,818,325,226,42,57
2011,Broxbourne 002A,E01023327,988,734,254,132,20,102
2011,Broxbourne 002B,E01023328,996,763,233,92,56,85
2011,Broxbourne 002C,E01023329,924,679,245,149,24,72
2011,Broxbourne 002D,E01023330,1069,798,271,104,39,128
2011,Broxbourne 002E,E01023331,1106,806,300,143,39,118
2011,Broxbourne 003A,E01023320,1392,1077,315,179,29,107
2011,Broxbourne 003B,E01023321,1421,995,426,275,46,105
2011,Broxbourne 003C,E01023322,1300,1044,256,114,46,96
2011,Broxbourne 003D,E01023323,1172,837,335,136,51,148
2011,Broxbourne 004A,E01023289,1094,769,325,191,55,79
2011,Broxbourne 004B,E01023290,1157,758,399,241,54,104
2011,Broxbourne 004C,E01023291,1128,813,315,194,46,75
2011,Broxbourne 004D,E01023292,1120,851,269,175,41,53
2011,Broxbourne 005A,E01023340,1287,964,323,153,57,113
2011,Broxbourne 005B,E01023341,1352,991,361,206,59,96
2011,Broxbourne 005C,E01023342,1903,1420,483,148,73,262
2011,Broxbourne 005D,E01023343,1278,920,358,115,66,177
2011,Broxbourne 005E,E01023344,1296,966,330,183,53,94
2011,Broxbourne 006A,E01023307,1149,852,297,145,49,103
2011,Broxbourne 006B,E01023308,1285,989,296,170,64,62
2011,Broxbourne 006C,E01023309,1318,971,347,195,64,88
2011,Broxbourne 006D,E01023310,1474,1076,398,121,66,211
2011,Broxbourne 007A,E01023311,1246,877,369,213,62,94
2011,Broxbourne 007B,E01023312,1293,965,328,129,82,117
2011,Broxbourne 007C,E01023313,1157,790,367,227,67,73
2011,Broxbourne 007D,E01023315,1340,1073,267,85,62,120
2011,Broxbourne 008A,E01023302,1054,749,305,162,52,91
2011,Broxbourne 008B,E01023303,1161,860,301,124,62,115
2011,Broxbourne 008C,E01023304,1102,804,298,156,46,96
2011,Broxbourne 008D,E01023305,986,763,223,89,39,95
2011,Broxbourne 008E,E01023306,1128,825,303,172,44,87
2011,Broxbourne 009A,E01023314,1012,747,265,130,41,94
2011,Broxbourne 009B,E01023324,1019,720,299,143,42,114
2011,Broxbourne 009C,E01023325,1052,806,246,121,31,94
2011,Broxbourne 009D,E01023326,1174,793,381,177,55,149
2011,Broxbourne 010A,E01023297,987,727,260,145,38,77
2011,Broxbourne 010B,E01023298,1064,774,290,174,38,78
2011,Broxbourne 010C,E01023299,1211,884,327,184,50,93
2011,Broxbourne 010D,E01023300,952,683,269,116,37,116
2011,Broxbourne 010E,E01023301,1166,881,285,107,56,122
2011,Broxbourne 011A,E01023293,1229,871,358,196,38,124
2011,Broxbourne 011B,E01023294,1032,701,331,149,48,134
2011,Broxbourne 011C,E01023295,1068,771,297,154,51,92
2011,Broxbourne 011D,E01023296,1188,869,319,141,62,116
2011,Broxbourne 012A,E01023332,1378,1015,363,189,55,119
2011,Broxbourne 012B,E01023333,1343,973,370,138,68,164
2011,Broxbourne 012C,E01023334,1179,851,328,196,50,82
2011,Broxbourne 012D,E01023335,1228,883,345,176,65,104
2011,Broxbourne 013A,E01023336,1509,1126,383,109,85,189
2011,Broxbourne 013B,E01023337,1237,864,373,143,68,162
2011,Broxbourne 013C,E01023338,1555,1076,479,178,61,240
2011,Broxbourne 013D,E01023339,1096,767,329,103,58,168
2011,Dacorum 001A,E01023430,850,632,218,127,21,70
2011,Dacorum 001B,E01023431,980,694,286,122,34,130
2011,Dacorum 001C,E01023432,1039,818,221,124,25,72
2011,Dacorum 001D,E01023433,1099,876,223,110,39,74
2011,Dacorum 002A,E01023423,939,722,217,124,33,60
2011,Dacorum 002B,E01023424,1027,766,261,137,38,86
2011,Dacorum 002C,E01023425,970,722,248,137,45,66
2011,Dacorum 002D,E01023426,1128,841,287,90,117,80
2011,Dacorum 003A,E01023418,997,738,259,136,33,90
2011,Dacorum 003B,E01023419,1561,1251,310,141,60,109
2011,Dacorum 003C,E01023420,1085,795,290,171,49,70
2011,Dacorum 004A,E01023352,1777,1282,495,289,66,140
2011,Dacorum 004B,E01023421,1085,803,282,194,40,48
2011,Dacorum 004C,E01023422,907,607,300,193,38,69
2011,Dacorum 005A,E01023434,1192,915,277,106,45,126
2011,Dacorum 005B,E01023435,1209,1014,195,64,38,93
2011,Dacorum 005C,E01023436,945,711,234,131,44,59
2011,Dacorum 005D,E01023437,1137,864,273,59,39,175
2011,Dacorum 006A,E01023355,1107,757,350,210,51,89
2011,Dacorum 006B,E01023356,761,511,250,145,42,63
2011,Dacorum 006C,E01023416,1015,722,293,194,34,65
2011,Dacorum 006D,E01023417,888,657,231,146,21,64
2011,Dacorum 007A,E01023393,1267,943,324,149,32,143
2011,Dacorum 007B,E01023394,1040,799,241,107,30,104
2011,Dacorum 007C,E01023395,1202,895,307,114,54,139
2011,Dacorum 007D,E01023396,1207,885,322,139,59,124
2011,Dacorum 007E,E01023397,979,728,251,77,40,134
2011,Dacorum 008A,E01023401,1289,958,331,100,51,180
2011,Dacorum 008B,E01023402,1166,842,324,169,52,103
2011,Dacorum 008C,E01023403,1008,738,270,120,30,120
2011,Dacorum 008D,E01023404,918,672,246,67,32,147
2011,Dacorum 008E,E01023405,1023,708,315,110,55,150
2011,Dacorum 009A,E01023361,1319,1069,250,122,49,79
2011,Dacorum 009B,E01023362,1167,851,316,171,60,85
2011,Dacorum 009C,E01023363,1126,912,214,127,31,56
2011,Dacorum 009D,E01023364,925,645,280,201,29,50
2011,Dacorum 010A,E01023390,1450,1083,367,159,58,150
2011,Dacorum 010B,E01023391,1201,947,254,105,51,98
2011,Dacorum 010C,E01023399,1206,929,277,156,24,97
2011,Dacorum 011A,E01023392,1114,852,262,113,45,104
2011,Dacorum 011B,E01023427,1171,868,303,132,54,117
2011,Dacorum 011C,E01023428,1150,926,224,120,40,64
2011,Dacorum 011D,E01023429,1212,885,327,164,38,125
2011,Dacorum 012A,E01023369,960,681,279,146,33,100
2011,Dacorum 012B,E01023370,1183,967,216,90,35,91
2011,Dacorum 012C,E01023371,1051,742,309,140,46,123
2011,Dacorum 012D,E01023372,975,648,327,193,49,85
2011,Dacorum 013A,E01023345,1154,912,242,112,30,100
2011,Dacorum 013B,E01023346,891,641,250,112,25,113
2011,Dacorum 013C,E01023347,901,641,260,149,36,75
2011,Dacorum 013D,E01023348,1051,735,316,101,43,172
2011,Dacorum 014A,E01023365,965,764,201,101,30,70
2011,Dacorum 014B,E01023366,1115,886,229,108,36,85
2011,Dacorum 014C,E01023367,741,501,240,152,38,50
2011,Dacorum 014D,E01023368,1196,929,267,130,53,84
2011,Dacorum 015A,E01023349,1355,969,386,147,57,182
2011,Dacorum 015B,E01023350,1117,840,277,122,51,104
2011,Dacorum 015C,E01023351,1136,848,288,139,30,119
2011,Dacorum 015D,E01023398,1865,1522,343,155,53,135
2011,Dacorum 015E,E01023400,1269,962,307,152,32,123
2011,Dacorum 016A,E01023383,1069,805,264,127,34,103
2011,Dacorum 016B,E01023384,1355,1031,324,149,37,138
2011,Dacorum 016C,E01023385,1216,905,311,179,60,72
2011,Dacorum 017A,E01023409,1054,766,288,153,38,97
2011,Dacorum 017B,E01023410,984,679,305,223,33,49
2011,Dacorum 017C,E01023411,1022,760,262,118,46,98
2011,Dacorum 017D,E01023412,931,636,295,193,52,50
2011,Dacorum 017E,E01023413,987,761,226,97,34,95
2011,Dacorum 018B,E01023354,1255,997,258,143,39,76
2011,Dacorum 018C,E01023379,1179,915,264,172,36,56
2011,Dacorum 018D,E01023380,862,685,177,104,25,48
2011,Dacorum 018E,E01023381,965,684,281,183,48,50
2011,Dacorum 018F,E01023382,1049,777,272,152,36,84
2011,Dacorum 018G,E01033022,1097,970,127,46,28,53
2011,Dacorum 018H,E01033023,1192,957,235,108,24,103
2011,Dacorum 019A,E01023386,1122,834,288,121,44,123
2011,Dacorum 019B,E01023387,952,727,225,81,34,110
2011,Dacorum 019C,E01023388,1174,864,310,134,54,122
2011,Dacorum 019D,E01023389,1244,955,289,159,43,87
2011,Dacorum 020A,E01023357,1131,760,371,116,59,196
2011,Dacorum 020B,E01023358,1007,719,288,103,52,133
2011,Dacorum 020C,E01023359,1245,913,332,95,66,171
2011,Dacorum 020D,E01023360,1050,820,230,86,43,101
2011,Dacorum 020E,E01023414,1064,835,229,92,45,92
2011,Dacorum 020F,E01023415,977,704,273,150,41,82
2011,Dacorum 021A,E01023373,1572,849,723,116,59,548
2011,Dacorum 021B,E01023374,1028,802,226,124,44,58
2011,Dacorum 021C,E01023375,1089,754,335,181,45,109
2011,Dacorum 021D,E01023376,941,712,229,133,26,70
2011,Dacorum 021E,E01023377,852,587,265,182,25,58
2011,Dacorum 021F,E01023378,1242,855,387,208,56,123
2011,Dacorum 022A,E01023406,1363,1029,334,191,50,93
2011,Dacorum 022B,E01023407,1224,893,331,182,53,96
2011,Dacorum 022C,E01023408,1153,839,314,184,51,79
2011,East Hertfordshire 001A,E01023462,979,710,269,127,38,104
2011,East Hertfordshire 001B,E01023464,1581,1181,400,259,56,85
2011,East Hertfordshire 001C,E01023465,1068,790,278,154,48,76
2011,East Hertfordshire 001D,E01023466,1212,897,315,190,51,74
2011,East Hertfordshire 002A,E01023467,1760,1232,528,326,65,137
2011,East Hertfordshire 002B,E01023494,878,598,280,147,49,84
2011,East Hertfordshire 002C,E01023495,936,666,270,138,33,99
2011,East Hertfordshire 002D,E01023508,1095,801,294,144,63,87
2011,East Hertfordshire 002E,E01023509,976,739,237,130,43,64
2011,East Hertfordshire 003A,E01023452,992,805,187,74,52,61
2011,East Hertfordshire 003B,E01023453,1027,742,285,118,92,75
2011,East Hertfordshire 003C,E01023454,967,754,213,110,49,54
2011,East Hertfordshire 003D,E01023455,939,710,229,114,48,67
2011,East Hertfordshire 003E,E01023463,868,618,250,141,37,72
2011,East Hertfordshire 003F,E01023493,1777,1299,478,224,83,171
2011,East Hertfordshire 004A,E01023449,1142,849,293,167,49,77
2011,East Hertfordshire 004B,E01023450,1487,1184,303,143,49,111
2011,East Hertfordshire 004C,E01023451,1527,1172,355,205,57,93
2011,East Hertfordshire 005A,E01023438,1048,826,222,106,42,74
2011,East Hertfordshire 005B,E01023439,988,721,267,139,40,88
2011,East Hertfordshire 005C,E01023440,1181,812,369,236,63,70
2011,East Hertfordshire 005D,E01023441,1020,715,305,82,164,59
2011,East Hertfordshire 005E,E01023442,1527,1211,316,124,58,134
2011,East Hertfordshire 006A,E01023498,1924,1469,455,267,61,127
2011,East Hertfordshire 006B,E01023506,1019,721,298,175,26,97
2011,East Hertfordshire 006C,E01023507,1218,892,326,160,98,68
2011,East Hertfordshire 007A,E01023443,1122,896,226,103,50,73
2011,East Hertfordshire 007B,E01023444,1194,946,248,122,28,98
2011,East Hertfordshire 007C,E01023445,1217,931,286,121,58,107
2011,East Hertfordshire 007D,E01023446,1700,1410,290,137,49,104
2011,East Hertfordshire 007E,E01023447,859,609,250,75,45,130
2011,East Hertfordshire 007F,E01023448,1110,884,226,79,48,99
2011,East Hertfordshire 008A,E01023456,1056,849,207,93,44,70
2011,East Hertfordshire 008B,E01023457,1128,900,228,106,51,71
2011,East Hertfordshire 008C,E01023458,994,786,208,99,39,70
2011,East Hertfordshire 008D,E01023459,1038,804,234,129,38,67
2011,East Hertfordshire 008E,E01023460,1059,807,252,118,51,83
2011,East Hertfordshire 008F,E01023461,1086,840,246,82,75,89
2011,East Hertfordshire 009A,E01023491,931,678,253,143,37,73
2011,East Hertfordshire 009B,E01023492,1104,808,296,145,49,102
2011,East Hertfordshire 009C,E01023496,946,614,332,99,70,163
2011,East Hertfordshire 009D,E01023497,1081,737,344,180,61,103
2011,East Hertfordshire 010A,E01023485,1672,1187,485,281,67,137
2011,East Hertfordshire 010B,E01023486,1862,1327,535,283,80,172
2011,East Hertfordshire 010E,E01033609,1704,1273,431,251,56,124
2011,East Hertfordshire 011A,E01023499,1248,921,327,158,57,112
2011,East Hertfordshire 011B,E01023500,1268,831,437,200,50,187
2011,East Hertfordshire 011C,E01023501,1120,854,266,176,29,61
2011,East Hertfordshire 011D,E01023502,1283,1004,279,166,34,79
2011,East Hertfordshire 011E,E01023503,1286,948,338,222,37,79
2011,East Hertfordshire 012A,E01023512,1425,1153,272,142,48,82
2011,East Hertfordshire 012B,E01023513,1040,725,315,161,45,109
2011,East Hertfordshire 012C,E01023514,1285,1036,249,128,30,91
2011,East Hertfordshire 012D,E01023518,1376,986,390,182,60,148
2011,East Hertfordshire 012E,E01023519,1228,952,276,116,44,116
2011,East Hertfordshire 012F,E01023520,1144,848,296,193,40,63
2011,East Hertfordshire 013A,E01023510,1069,803,266,157,44,65
2011,East Hertfordshire 013B,E01023511,1185,947,238,114,25,99
2011,East Hertfordshire 013C,E01023515,1222,1012,210,114,30,66
2011,East Hertfordshire 013D,E01023516,1599,1256,343,213,45,85
2011,East Hertfordshire 013E,E01023517,1173,892,281,162,40,79
2011,East Hertfordshire 014A,E01023470,1336,1115,221,112,29,80
2011,East Hertfordshire 014B,E01023471,955,698,257,154,41,62
2011,East Hertfordshire 014C,E01023472,935,691,244,138,29,77
2011,East Hertfordshire 014D,E01023473,1004,697,307,210,50,47
2011,East Hertfordshire 014E,E01023474,1117,855,262,152,40,70
2011,East Hertfordshire 015A,E01023487,940,641,299,99,48,152
2011,East Hertfordshire 015B,E01023488,1074,738,336,104,43,189
2011,East Hertfordshire 015C,E01023489,968,771,197,127,27,43
2011,East Hertfordshire 015D,E01023490,909,685,224,132,35,57
2011,East Hertfordshire 016A,E01023482,1374,1148,226,74,61,91
2011,East Hertfordshire 016B,E01023483,1410,1140,270,132,60,78
2011,East Hertfordshire 016C,E01023484,1109,880,229,83,49,97
2011,East Hertfordshire 017A,E01023475,1063,764,299,121,53,125
2011,East Hertfordshire 017B,E01023476,1036,713,323,201,47,75
2011,East Hertfordshire 017C,E01023477,1611,1327,284,112,71,101
2011,East Hertfordshire 017D,E01023478,1335,1115,220,112,28,80
2011,East Hertfordshire 017E,E01023479,1218,948,270,127,56,87
2011,East Hertfordshire 018A,E01023468,1039,796,243,131,45,67
2011,East Hertfordshire 018B,E01023469,1098,782,316,151,33,132
2011,East Hertfordshire 018C,E01023480,1152,818,334,209,38,87
2011,East Hertfordshire 018D,E01023481,1192,769,423,94,275,54
2011,East Hertfordshire 018E,E01023504,980,724,256,137,32,87
2011,East Hertfordshire 018F,E01023505,1288,1051,237,123,43,71
2011,Hertsmere 001A,E01023576,1019,664,355,212,82,61
2011,Hertsmere 001B,E01023577,1223,783,440,250,123,67
2011,Hertsmere 001C,E01023578,1140,771,369,221,82,66
2011,Hertsmere 001D,E01023579,1019,716,303,62,160,81
2011,Hertsmere 001E,E01023580,1167,845,322,132,108,82
2011,Hertsmere 002A,E01023567,1486,1095,391,169,122,100
2011,Hertsmere 002B,E01023568,1065,733,332,216,54,62
2011,Hertsmere 002C,E01023569,1133,815,318,147,74,97
2011,Hertsmere 002D,E01023570,1090,759,331,104,134,93
2011,Hertsmere 003A,E01023571,1005,674,331,174,59,98
2011,Hertsmere 003B,E01023572,1091,817,274,126,62,86
2011,Hertsmere 003C,E01023573,903,617,286,90,103,93
2011,Hertsmere 003D,E01023574,1140,792,348,108,87,153
2011,Hertsmere 003E,E01023575,1222,821,401,164,95,142
2011,Hertsmere 004A,E01023581,943,750,193,82,37,74
2011,Hertsmere 004B,E01023582,1170,901,269,121,42,106
2011,Hertsmere 004C,E01023583,994,762,232,105,35,92
2011,Hertsmere 004D,E01023584,762,546,216,114,41,61
2011,Hertsmere 005A,E01023523,1209,859,350,152,102,96
2011,Hertsmere 005B,E01023524,1011,703,308,126,106,76
2011,Hertsmere 005C,E01023525,1204,923,281,126,46,109
2011,Hertsmere 005D,E01023526,1256,899,357,161,92,104
2011,Hertsmere 005E,E01023527,998,719,279,132,41,106
2011,Hertsmere 006A,E01023534,1227,906,321,111,64,146
2011,Hertsmere 006B,E01023535,1185,894,291,107,63,121
2011,Hertsmere 006C,E01023536,1124,717,407,133,50,224
2011,Hertsmere 006D,E01023537,1297,953,344,144,70,130
2011,Hertsmere 006E,E01023538,1163,831,332,137,48,147
2011,Hertsmere 007A,E01023529,1085,799,286,93,69,124
2011,Hertsmere 007B,E01023530,873,655,218,75,26,117
2011,Hertsmere 007C,E01023531,1379,1081,298,114,62,122
2011,Hertsmere 007D,E01023532,1184,919,265,111,43,111
2011,Hertsmere 007E,E01023533,1101,805,296,114,63,119
2011,Hertsmere 008A,E01023552,1224,909,315,161,68,86
2011,Hertsmere 008B,E01023553,1251,911,340,104,143,93
2011,Hertsmere 008C,E01023554,1269,979,290,103,55,132
2011,Hertsmere 008D,E01023555,1223,882,341,123,55,163
2011,Hertsmere 009A,E01023544,874,659,215,89,31,95
2011,Hertsmere 009B,E01023545,976,791,185,69,35,81
2011,Hertsmere 009C,E01023546,1297,1020,277,95,49,133
2011,Hertsmere 009D,E01023547,1237,901,336,101,65,170
2011,Hertsmere 010A,E01023528,1245,930,315,97,109,109
2011,Hertsmere 010B,E01023564,1215,921,294,99,70,125
2011,Hertsmere 010C,E01023565,1206,875,331,125,99,107
2011,Hertsmere 010D,E01023566,1142,804,338,128,92,118
2011,Hertsmere 011A,E01023539,2184,1726,458,130,102,226
2011,Hertsmere 011B,E01023540,1175,883,292,135,43,114
2011,Hertsmere 011C,E01023541,1376,1093,283,106,75,102
2011,Hertsmere 011D,E01023542,1302,990,312,83,86,143
2011,Hertsmere 011E,E01023543,1055,769,286,106,54,126
2011,Hertsmere 012A,E01023558,1210,957,253,126,68,59
2011,Hertsmere 012B,E01023559,1129,879,250,115,62,73
2011,Hertsmere 012C,E01023560,1007,723,284,123,45,116
2011,Hertsmere 012D,E01023561,1142,853,289,132,53,104
2011,Hertsmere 012E,E01023562,1075,761,314,173,57,84
2011,Hertsmere 012F,E01023563,1055,791,264,122,69,73
2011,Hertsmere 013A,E01023548,1244,874,370,202,53,115
2011,Hertsmere 013B,E01023549,1108,790,318,185,54,79
2011,Hertsmere 013C,E01023550,1182,839,343,137,77,129
2011,Hertsmere 013D,E01023551,1061,771,290,152,59,79
2011,Hertsmere 013E,E01023556,1117,821,296,155,49,92
2011,Hertsmere 013F,E01023557,1062,809,253,120,56,77
2011,North Hertfordshire 001A,E01023660,1590,1235,355,195,31,129
2011,North Hertfordshire 001B,E01023661,979,714,265,125,44,96
2011,North Hertfordshire 001C,E01023662,1170,965,205,79,39,87
2011,North Hertfordshire 002A,E01023654,1213,936,277,192,22,63
2011,North Hertfordshire 002B,E01023655,1105,793,312,194,42,76
2011,North Hertfordshire 002C,E01023656,1647,1346,301,159,59,83
2011,North Hertfordshire 002D,E01023657,1811,1369,442,296,42,104
2011,North Hertfordshire 002E,E01023658,1127,841,286,170,32,84
2011,North Hertfordshire 002F,E01023659,1032,775,257,162,40,55
2011,North Hertfordshire 003A,E01023635,978,700,278,161,29,88
2011,North Hertfordshire 003B,E01023636,1244,931,313,158,41,114
2011,North Hertfordshire 003C,E01023637,1141,787,354,186,18,150
2011,North Hertfordshire 003D,E01023638,1116,811,305,131,35,139
2011,North Hertfordshire 004A,E01023587,857,718,139,72,35,32
2011,North Hertfordshire 004B,E01023588,984,790,194,104,50,40
2011,North Hertfordshire 004C,E01023589,1178,896,282,139,48,95
2011,North Hertfordshire 004D,E01023590,1230,943,287,139,53,95
2011,North Hertfordshire 004E,E01023591,1056,793,263,174,41,48
2011,North Hertfordshire 004F,E01023592,974,742,232,98,38,96
2011,North Hertfordshire 004G,E01023593,969,725,244,112,33,99
2011,North Hertfordshire 005A,E01023585,832,601,231,129,27,75
2011,North Hertfordshire 005B,E01023586,1096,801,295,180,28,87
2011,North Hertfordshire 005C,E01023597,880,655,225,136,17,72
2011,North Hertfordshire 005D,E01023598,990,729,261,144,40,77
2011,North Hertfordshire 005F,E01023600,975,723,252,129,32,91
2011,North Hertfordshire 005G,E01023663,1541,1132,409,227,79,103
2011,North Hertfordshire 005H,E01033024,1140,970,170,63,40,67
2011,North Hertfordshire 005I,E01033025,927,801,126,50,17,59
2011,North Hertfordshire 005J,E01033026,1095,930,165,64,26,75
2011,North Hertfordshire 005K,E01033027,1105,982,123,30,16,77
2011,North Hertfordshire 006A,E01023630,1123,824,299,130,50,119
2011,North Hertfordshire 006B,E01023631,1189,889,300,108,37,155
2011,North Hertfordshire 006C,E01023632,1013,773,240,103,36,101
2011,North Hertfordshire 006D,E01023633,979,730,249,114,34,101
2011,North Hertfordshire 006E,E01023634,969,681,288,205,23,60
2011,North Hertfordshire 007A,E01023649,967,748,219,121,27,71
2011,North Hertfordshire 007B,E01023650,1054,774,280,88,47,145
2011,North Hertfordshire 007C,E01023651,876,641,235,141,30,64
2011,North Hertfordshire 007D,E01023652,979,670,309,148,36,125
2011,North Hertfordshire 008A,E01023644,1154,802,352,202,72,78
2011,North Hertfordshire 008B,E01023645,1096,771,325,171,53,101
2011,North Hertfordshire 008C,E01023646,954,671,283,113,53,117
2011,North Hertfordshire 008D,E01023647,1091,753,338,215,52,71
2011,North Hertfordshire 008E,E01023648,889,573,316,192,67,57
2011,North Hertfordshire 009A,E01023639,973,673,300,194,27,79
2011,North Hertfordshire 009B,E01023640,863,558,305,169,34,102
2011,North Hertfordshire 009C,E01023641,940,641,299,147,29,123
2011,North Hertfordshire 009D,E01023642,984,672,312,211,43,58
2011,North Hertfordshire 009E,E01023643,960,677,283,132,54,97
2011,North Hertfordshire 010A,E01023601,1702,1403,299,108,59,132
2011,North Hertfordshire 010B,E01023602,1174,953,221,81,38,102
2011,North Hertfordshire 010C,E01023603,1118,899,219,104,49,66
2011,North Hertfordshire 010D,E01023604,995,756,239,124,45,70
2011,North Hertfordshire 010E,E01023605,1152,952,200,71,52,77
2011,North Hertfordshire 011A,E01023617,1044,764,280,185,45,50
2011,North Hertfordshire 011B,E01023618,1087,797,290,141,48,101
2011,North Hertfordshire 011C,E01023619,1312,1082,230,111,40,79
2011,North Hertfordshire 011D,E01023620,924,686,238,96,47,95
2011,North Hertfordshire 011E,E01023621,1038,774,264,127,41,96
2011,North Hertfordshire 012A,E01023611,1119,796,323,146,46,131
2011,North Hertfordshire 012B,E01023612,1300,1007,293,169,41,83
2011,North Hertfordshire 012C,E01023613,1173,863,310,101,46,163
2011,North Hertfordshire 012D,E01023614,1439,1051,388,251,70,67
2011,North Hertfordshire 012E,E01023615,1109,745,364,215,51,98
2011,North Hertfordshire 012F,E01023616,1434,1114,320,186,46,88
2011,North Hertfordshire 013A,E01023606,1201,878,323,150,46,127
2011,North Hertfordshire 013B,E01023607,1020,738,282,172,37,73
2011,North Hertfordshire 013C,E01023608,1050,723,327,232,40,55
2011,North Hertfordshire 013D,E01023609,1112,864,248,112,50,86
2011,North Hertfordshire 013E,E01023610,967,779,188,92,39,57
2011,North Hertfordshire 014A,E01023594,1610,1151,459,274,64,121
2011,North Hertfordshire 014B,E01023622,798,594,204,98,40,66
2011,North Hertfordshire 014C,E01023623,1057,753,304,162,29,113
2011,North Hertfordshire 014D,E01023624,955,733,222,110,28,84
2011,North Hertfordshire 014E,E01023625,834,597,237,132,62,43
2011,North Hertfordshire 014F,E01023653,1529,1096,433,236,59,138
2011,North Hertfordshire 015A,E01023595,1074,835,239,144,36,59
2011,North Hertfordshire 015B,E01023596,774,544,230,152,26,52
2011,North Hertfordshire 015C,E01023626,1582,1097,485,292,55,138
2011,North Hertfordshire 015D,E01023627,1244,919,325,164,64,97
2011,North Hertfordshire 015E,E01023628,1248,1007,241,119,45,77
2011,North Hertfordshire 015F,E01023629,1300,959,341,190,47,104
2011,St Albans 001A,E01023690,1028,770,258,138,45,75
2011,St Albans 001B,E01023691,993,668,325,161,75,89
2011,St Albans 001C,E01023692,975,746,229,83,64,82
2011,St Albans 001D,E01023693,940,687,253,142,46,65
2011,St Albans 001E,E01023694,1002,727,275,158,43,74
2011,St Albans 002A,E01023685,1167,917,250,111,50,89
2011,St Albans 002B,E01023686,1039,727,312,165,66,81
2011,St Albans 002C,E01023687,1031,775,256,87,60,109
2011,St Albans 002D,E01023688,1020,782,238,116,42,80
2011,St Albans 002E,E01023689,921,629,292,107,102,83
2011,St Albans 003A,E01023699,996,657,339,185,49,105
2011,St Albans 003B,E01023700,887,575,312,137,46,129
2011,St Albans 003C,E01023701,1218,906,312,168,56,88
2011,St Albans 003D,E01023702,1094,849,245,103,41,101
2011,St Albans 003E,E01023703,948,740,208,97,41,70
2011,St Albans 004A,E01023746,1079,807,272,117,40,115
2011,St Albans 004B,E01023747,1201,926,275,163,39,73
2011,St Albans 004C,E01023748,981,626,355,241,47,67
2011,St Albans 004D,E01023749,1177,823,354,205,68,81
2011,St Albans 005A,E01023695,1097,766,331,192,48,91
2011,St Albans 005B,E01023696,1157,689,468,223,85,160
2011,St Albans 005C,E01023697,1291,1022,269,137,44,88
2011,St Albans 005D,E01023698,1184,833,351,208,67,76
2011,St Albans 006A,E01023722,1007,738,269,142,40,87
2011,St Albans 006B,E01023723,1217,858,359,174,48,137
2011,St Albans 006C,E01023724,1069,760,309,205,27,77
2011,St Albans 006D,E01023725,1075,775,300,179,51,70
2011,St Albans 007A,E01023713,1296,983,313,140,61,112
2011,St Albans 007B,E01023734,1231,944,287,167,53,67
2011,St Albans 007C,E01023735,1318,1059,259,135,51,73
2011,St Albans 007D,E01023736,1107,837,270,148,38,84
2011,St Albans 008A,E01023709,1187,905,282,161,46,75
2011,St Albans 008B,E01023710,1098,815,283,170,55,58
2011,St Albans 008C,E01023711,1056,793,263,135,56,72
2011,St Albans 008D,E01023712,1247,947,300,122,60,118
2011,St Albans 009A,E01023669,1186,873,313,72,67,174
2011,St Albans 009B,E01023670,1475,1194,281,106,66,109
2011,St Albans 009C,E01023671,1279,931,348,138,65,145
2011,St Albans 009D,E01023672,1325,1008,317,134,66,117
2011,St Albans 010A,E01023673,1044,766,278,141,66,71
2011,St Albans 010B,E01023714,1252,865,387,197,86,104
2011,St Albans 010C,E01023715,1069,784,285,123,69,93
2011,St Albans 010D,E01023716,1473,1208,265,139,35,91
2011,St Albans 011A,E01023666,1365,1068,297,99,59,139
2011,St Albans 011B,E01023674,1371,1100,271,94,67,110
2011,St Albans 011C,E01023675,965,658,307,149,67,91
2011,St Albans 011D,E01023676,1630,1296,334,120,71,143
2011,St Albans 012A,E01023726,1373,1209,164,55,32,77
2011,St Albans 012B,E01023727,1536,1240,296,114,34,148
2011,St Albans 012C,E01023728,1652,1314,338,138,77,123
2011,St Albans 012D,E01023729,1394,1149,245,64,59,122
2011,St Albans 013A,E01023664,1256,976,280,122,64,94
2011,St Albans 013B,E01023665,1136,883,253,111,54,88
2011,St Albans 013C,E01023667,1061,862,199,83,38,78
2011,St Albans 013D,E01023668,962,745,217,93,56,68
2011,St Albans 014A,E01023742,1036,677,359,271,35,53
2011,St Albans 014B,E01023743,1242,950,292,154,43,95
2011,St Albans 014C,E01023744,1036,656,380,264,55,61
2011,St Albans 014D,E01023745,1265,951,314,164,54,96
2011,St Albans 015A,E01023677,854,645,209,34,46,129
2011,St Albans 015B,E01023678,1370,1046,324,135,55,134
2011,St Albans 015C,E01023679,1076,821,255,134,35,86
2011,St Albans 015D,E01023680,950,685,265,121,67,77
2011,St Albans 016A,E01023681,1208,913,295,105,45,145
2011,St Albans 016B,E01023682,1232,908,324,139,68,117
2011,St Albans 016C,E01023683,1103,776,327,143,49,135
2011,St Albans 016D,E01023684,1211,850,361,222,63,76
2011,St Albans 017A,E01023737,966,677,289,88,60,141
2011,St Albans 017B,E01023738,1136,821,315,111,51,153
2011,St Albans 017C,E01023739,963,705,258,117,41,100
2011,St Albans 017D,E01023740,1016,854,162,64,32,66
2011,St Albans 017E,E01023741,1175,931,244,117,38,89
2011,St Albans 018A,E01023704,1283,993,290,116,82,92
2011,St Albans 018B,E01023705,1219,857,362,139,56,167
2011,St Albans 018C,E01023706,1196,889,307,161,59,87
2011,St Albans 018E,E01023708,1095,826,269,145,45,79
2011,St Albans 018F,E01033028,1084,851,233,106,49,78
2011,St Albans 018G,E01033029,1129,877,252,89,48,115
2011,St Albans 019A,E01023718,1212,842,370,247,48,75
2011,St Albans 019B,E01023719,803,596,207,117,21,69
2011,St Albans 019C,E01023720,1371,1054,317,123,44,150
2011,St Albans 019D,E01023721,996,725,271,170,42,59
2011,St Albans 020A,E01023717,884,701,183,105,34,44
2011,St Albans 020B,E01023730,1184,842,342,215,51,76
2011,St Albans 020C,E01023731,1030,756,274,155,42,77
2011,St Albans 020D,E01023732,1225,874,351,195,52,104
2011,St Albans 020E,E01023733,1175,814,361,241,56,64
2011,Stevenage 001A,E01023787,1062,788,274,127,50,97
2011,Stevenage 001B,E01023788,1128,832,296,134,51,111
2011,Stevenage 001C,E01023789,1422,1091,331,120,52,159
2011,Stevenage 001D,E01023790,1253,947,306,105,64,137
2011,Stevenage 002A,E01023776,1885,1444,441,222,63,156
2011,Stevenage 002B,E01023777,1334,1014,320,179,42,99
2011,Stevenage 002C,E01023778,1182,880,302,122,41,139
2011,Stevenage 002D,E01023799,1058,787,271,136,48,87
2011,Stevenage 002E,E01023800,1483,1105,378,181,51,146
2011,Stevenage 002F,E01023801,1732,1407,325,100,66,159
2011,Stevenage 003A,E01023771,1229,946,283,150,51,82
2011,Stevenage 003B,E01023772,1328,1016,312,151,54,107
2011,Stevenage 003C,E01023773,985,743,242,85,51,106
2011,Stevenage 003D,E01023774,1141,834,307,125,54,128
2011,Stevenage 004A,E01023767,1166,974,192,94,39,59
2011,Stevenage 004B,E01023768,1300,1051,249,113,58,78
2011,Stevenage 004C,E01023769,1216,897,319,171,38,110
2011,Stevenage 004D,E01023770,1170,933,237,142,40,55
2011,Stevenage 005A,E01023795,1147,877,270,152,34,84
2011,Stevenage 005B,E01023796,1085,807,278,138,29,111
2011,Stevenage 005C,E01023797,965,727,238,113,28,97
2011,Stevenage 005D,E01023798,1115,880,235,112,33,90
2011,Stevenage 006A,E01023775,1388,1055,333,161,43,129
2011,Stevenage 006B,E01023779,1185,877,308,130,37,141
2011,Stevenage 006C,E01023780,1085,773,312,171,43,98
2011,Stevenage 006D,E01023781,1241,920,321,146,46,129
2011,Stevenage 006E,E01023782,1043,763,280,175,26,79
2011,Stevenage 007A,E01023759,1038,768,270,117,45,108
2011,Stevenage 007B,E01023760,1142,844,298,176,47,75
2011,Stevenage 007C,E01023761,1557,1163,394,154,68,172
2011,Stevenage 007D,E01023762,1098,805,293,150,38,105
2011,Stevenage 008A,E01023755,1143,879,264,106,59,99
2011,Stevenage 008B,E01023756,1113,825,288,94,44,150
2011,Stevenage 008C,E01023757,1327,972,355,132,54,169
2011,Stevenage 008D,E01023758,1294,884,410,153,48,209
2011,Stevenage 009A,E01023750,876,621,255,97,29,129
2011,Stevenage 009B,E01023751,836,634,202,88,24,90
2011,Stevenage 009C,E01023752,924,712,212,97,29,86
2011,Stevenage 009D,E01023753,1150,968,182,92,31,59
2011,Stevenage 009E,E01023754,952,735,217,82,48,87
2011,Stevenage 010A,E01023791,1126,861,265,124,44,97
2011,Stevenage 010B,E01023792,1096,819,277,101,46,130
2011,Stevenage 010C,E01023793,999,714,285,109,38,138
2011,Stevenage 010D,E01023794,1112,841,271,107,44,120
2011,Stevenage 011A,E01023783,1213,935,278,102,50,126
2011,Stevenage 011B,E01023784,1172,858,314,171,42,101
2011,Stevenage 011C,E01023785,1143,876,267,101,30,136
2011,Stevenage 011D,E01023786,1055,825,230,93,42,95
2011,Stevenage 012A,E01023763,1131,894,237,134,29,74
2011,Stevenage 012B,E01023764,1107,819,288,160,31,97
2011,Stevenage 012C,E01023765,988,729,259,129,39,91
2011,Stevenage 012D,E01023766,1068,791,277,125,38,114
2011,Three Rivers 001A,E01023802,1242,962,280,146,42,92
2011,Three Rivers 001B,E01023803,1052,783,269,167,46,56
2011,Three Rivers 001C,E01023804,1061,733,328,172,41,115
2011,Three Rivers 001D,E01023807,1090,759,331,175,50,106
2011,Three Rivers 001E,E01023808,1925,1533,392,223,35,134
2011,Three Rivers 002A,E01023829,1171,836,335,114,83,138
2011,Three Rivers 002B,E01023830,1071,787,284,132,36,116
2011,Three Rivers 002C,E01023832,1266,988,278,101,70,107
2011,Three Rivers 002D,E01023833,1723,1373,350,131,75,144
2011,Three Rivers 002E,E01023834,1154,878,276,158,45,73
2011,Three Rivers 003A,E01023823,971,715,256,138,37,81
2011,Three Rivers 003B,E01023824,1359,1004,355,228,63,64
2011,Three Rivers 003C,E01023831,1436,1143,293,128,66,99
2011,Three Rivers 003D,E01023854,1347,948,399,245,47,107
2011,Three Rivers 004A,E01023812,1068,701,367,173,78,116
2011,Three Rivers 004B,E01023813,1047,770,277,120,64,93
2011,Three Rivers 004C,E01023814,689,492,197,97,50,50
2011,Three Rivers 004D,E01023851,1210,916,294,113,91,90
2011,Three Rivers 005A,E01023815,1075,764,311,172,44,95
2011,Three Rivers 005B,E01023816,841,600,241,139,40,62
2011,Three Rivers 005C,E01023817,963,733,230,113,53,64
2011,Three Rivers 005D,E01023818,933,644,289,156,60,73
2011,Three Rivers 006A,E01023819,1135,912,223,119,45,59
2011,Three Rivers 006B,E01023820,890,653,237,144,48,45
2011,Three Rivers 006C,E01023821,923,697,226,135,40,51
2011,Three Rivers 006D,E01023822,940,703,237,140,41,56
2011,Three Rivers 006E,E01023825,1678,1309,369,199,63,107
2011,Three Rivers 006F,E01023826,1007,758,249,133,41,75
2011,Three Rivers 007A,E01023847,1362,1081,281,107,49,125
2011,Three Rivers 007B,E01023848,1148,880,268,109,54,105
2011,Three Rivers 007C,E01023850,1062,837,225,116,26,83
2011,Three Rivers 007D,E01023852,1005,723,282,166,46,70
2011,Three Rivers 007E,E01023853,1477,1021,456,273,80,103
2011,Three Rivers 008A,E01023827,1527,1141,386,136,65,185
2011,Three Rivers 008B,E01023828,1053,753,300,114,55,131
2011,Three Rivers 008C,E01023845,1306,990,316,164,46,106
2011,Three Rivers 008D,E01023846,1151,867,284,172,49,63
2011,Three Rivers 009A,E01023835,993,734,259,131,41,87
2011,Three Rivers 009B,E01023836,1028,787,241,108,31,102
2011,Three Rivers 009C,E01023837,1156,901,255,129,36,90
2011,Three Rivers 009D,E01023838,874,654,220,90,35,95
2011,Three Rivers 010A,E01023805,1146,876,270,88,50,132
2011,Three Rivers 010B,E01023809,1170,801,369,234,46,89
2011,Three Rivers 010C,E01023810,1323,897,426,284,69,73
2011,Three Rivers 010D,E01023811,1097,780,317,216,37,64
2011,Three Rivers 011A,E01023839,1648,1149,499,238,130,131
2011,Three Rivers 011B,E01023840,1189,888,301,115,45,141
2011,Three Rivers 011C,E01023841,1227,882,345,143,91,111
2011,Three Rivers 011D,E01023849,1014,729,285,180,37,68
2011,Three Rivers 012A,E01023806,1571,1194,377,135,70,172
2011,Three Rivers 012B,E01023842,1107,798,309,104,46,159
2011,Three Rivers 012C,E01023843,1386,1035,351,129,62,160
2011,Three Rivers 012D,E01023844,1153,788,365,79,40,246
2011,Watford 001A,E01023904,1438,1094,344,151,51,142
2011,Watford 001B,E01023905,1377,1065,312,119,56,137
2011,Watford 001C,E01023906,1074,795,279,129,33,117
2011,Watford 001D,E01023907,1247,959,288,162,43,83
2011,Watford 002A,E01023890,946,750,196,77,46,73
2011,Watford 002B,E01023891,989,723,266,86,65,115
2011,Watford 002C,E01023892,962,755,207,101,40,66
2011,Watford 002D,E01023893,1245,915,330,187,53,90
2011,Watford 002E,E01023894,1073,847,226,132,34,60
2011,Watford 003A,E01023873,884,663,221,74,43,104
2011,Watford 003B,E01023874,904,662,242,137,26,79
2011,Watford 003C,E01023875,1368,1058,310,192,39,79
2011,Watford 003D,E01023876,1187,889,298,80,41,177
2011,Watford 003E,E01023877,1155,856,299,136,46,117
2011,Watford 004A,E01023868,1161,811,350,165,73,112
2011,Watford 004B,E01023869,1024,742,282,82,66,134
2011,Watford 004C,E01023870,1012,722,290,65,76,149
2011,Watford 004D,E01023871,874,720,154,71,26,57
2011,Watford 004E,E01023872,1268,989,279,114,54,111
2011,Watford 005A,E01023895,1304,1118,186,86,27,73
2011,Watford 005B,E01023896,991,769,222,122,40,60
2011,Watford 005C,E01023897,1135,789,346,205,36,105
2011,Watford 005D,E01023898,1170,914,256,138,34,84
2011,Watford 006A,E01023855,1445,1191,254,81,50,123
2011,Watford 006B,E01023856,1743,1434,309,114,67,128
2011,Watford 006C,E01023857,1207,830,377,102,97,178
2011,Watford 006D,E01023858,1346,1127,219,76,56,87
2011,Watford 007A,E01023878,1396,1002,394,235,91,68
2011,Watford 007B,E01023879,1579,1248,331,137,63,131
2011,Watford 007C,E01023880,1371,1076,295,127,52,116
2011,Watford 007D,E01023881,1154,868,286,149,61,76
2011,Watford 008A,E01023886,2038,1607,431,164,107,160
2011,Watford 008B,E01023887,1148,797,351,193,64,94
2011,Watford 008C,E01023888,1146,812,334,134,77,123
2011,Watford 008D,E01023889,1235,848,387,216,79,92
2011,Watford 009A,E01023859,1695,1396,299,67,62,170
2011,Watford 009B,E01023860,1500,1136,364,77,73,214
2011,Watford 009C,E01023861,1821,1467,354,90,84,180
2011,Watford 009D,E01023862,1478,1217,261,106,46,109
2011,Watford 010A,E01023899,1106,861,245,63,58,124
2011,Watford 010B,E01023900,1278,968,310,82,92,136
2011,Watford 010C,E01023901,1380,1105,275,70,62,143
2011,Watford 010D,E01023902,1184,958,226,69,57,100
2011,Watford 010E,E01023903,1130,857,273,76,73,124
2011,Watford 011A,E01023863,1311,1051,260,81,56,123
2011,Watford 011B,E01023864,1078,802,276,89,56,131
2011,Watford 011C,E01023865,1115,776,339,72,78,189
2011,Watford 011D,E01023866,1026,709,317,115,43,159
2011,Watford 011E,E01023867,1624,1272,352,101,63,188
2011,Watford 012A,E01023882,1187,902,285,149,52,84
2011,Watford 012B,E01023883,1148,775,373,160,68,145
2011,Watford 012C,E01023884,1302,1062,240,105,58,77
2011,Watford 012D,E01023885,1326,1011,315,149,65,101
2011,Welwyn Hatfield 001A,E01023965,1022,710,312,185,55,72
2011,Welwyn Hatfield 001B,E01023966,1178,772,406,264,55,87
2011,Welwyn Hatfield 001C,E01023967,972,755,217,111,41,65
2011,Welwyn Hatfield 001D,E01023971,1144,801,343,203,56,84
2011,Welwyn Hatfield 002B,E01023968,929,645,284,182,42,60
2011,Welwyn Hatfield 002C,E01023969,969,693,276,164,33,79
2011,Welwyn Hatfield 002D,E01023970,932,674,258,117,40,101
2011,Welwyn Hatfield 002E,E01033310,1216,994,222,71,62,89
2011,Welwyn Hatfield 002F,E01033313,1086,863,223,94,55,74
2011,Welwyn Hatfield 003A,E01023959,985,695,290,178,44,68
2011,Welwyn Hatfield 003B,E01023960,1093,804,289,154,38,97
2011,Welwyn Hatfield 003C,E01023961,1004,730,274,118,51,105
2011,Welwyn Hatfield 003D,E01023962,1007,722,285,154,41,90
2011,Welwyn Hatfield 004A,E01023912,1059,813,246,136,37,73
2011,Welwyn Hatfield 004B,E01023913,1015,780,235,119,32,84
2011,Welwyn Hatfield 004C,E01023914,1147,793,354,187,46,121
2011,Welwyn Hatfield 004D,E01023915,1085,863,222,92,28,102
2011,Welwyn Hatfield 005A,E01023950,1233,980,253,94,47,112
2011,Welwyn Hatfield 005B,E01023951,1203,852,351,150,52,149
2011,Welwyn Hatfield 005C,E01023952,1290,1023,267,124,31,112
2011,Welwyn Hatfield 005D,E01023953,1080,861,219,119,25,75
2011,Welwyn Hatfield 006A,E01023916,1193,904,289,135,66,88
2011,Welwyn Hatfield 006B,E01023917,1218,873,345,198,43,104
2011,Welwyn Hatfield 006C,E01023918,1121,754,367,221,46,100
2011,Welwyn Hatfield 006D,E01023919,1101,749,352,212,62,78
2011,Welwyn Hatfield 007A,E01023954,1264,918,346,103,54,189
2011,Welwyn Hatfield 007B,E01023955,931,672,259,111,44,104
2011,Welwyn Hatfield 007C,E01023956,990,769,221,72,52,97
2011,Welwyn Hatfield 007D,E01023957,1094,839,255,72,58,125
2011,Welwyn Hatfield 007E,E01023958,943,686,257,52,59,146
2011,Welwyn Hatfield 008A,E01023943,1041,798,243,83,48,112
2011,Welwyn Hatfield 008B,E01023944,1450,1085,365,153,62,150
2011,Welwyn Hatfield 008C,E01023945,1110,850,260,138,38,84
2011,Welwyn Hatfield 008D,E01023946,1095,885,210,97,47,66
2011,Welwyn Hatfield 009A,E01023939,808,584,224,117,20,87
2011,Welwyn Hatfield 009B,E01023940,1216,876,340,151,54,135
2011,Welwyn Hatfield 009C,E01023941,2051,1664,387,129,86,172
2011,Welwyn Hatfield 009D,E01023942,1142,881,261,90,61,110
2011,Welwyn Hatfield 010A,E01023929,1177,850,327,150,68,109
2011,Welwyn Hatfield 010B,E01023930,1211,890,321,132,86,103
2011,Welwyn Hatfield 010D,E01023938,2458,1262,1196,151,977,68
2011,Welwyn Hatfield 010E,E01033308,2635,1196,1439,23,1325,91
2011,Welwyn Hatfield 010F,E01033311,1152,890,262,116,68,78
2011,Welwyn Hatfield 010G,E01033314,1690,1061,629,21,510,98
2011,Welwyn Hatfield 011A,E01023924,1357,938,419,79,201,139
2011,Welwyn Hatfield 011B,E01023925,934,681,253,137,46,70
2011,Welwyn Hatfield 011C,E01023926,1323,979,344,189,84,71
2011,Welwyn Hatfield 011D,E01023927,1213,916,297,82,97,118
2011,Welwyn Hatfield 012A,E01023920,1240,841,399,108,119,172
2011,Welwyn Hatfield 012B,E01023921,1687,1111,576,108,341,127
2011,Welwyn Hatfield 012C,E01023922,1317,857,460,73,264,123
2011,Welwyn Hatfield 012D,E01023923,1462,933,529,130,308,91
2011,Welwyn Hatfield 013A,E01023932,1387,899,488,59,335,94
2011,Welwyn Hatfield 013B,E01023934,1209,727,482,36,375,71
2011,Welwyn Hatfield 013C,E01023935,1071,642,429,75,300,54
2011,Welwyn Hatfield 013D,E01023936,1697,1097,600,137,343,120
2011,Welwyn Hatfield 013E,E01023937,1084,632,452,80,294,78
2011,Welwyn Hatfield 014A,E01023933,1166,793,373,103,170,100
2011,Welwyn Hatfield 014B,E01023963,1611,1175,436,198,113,125
2011,Welwyn Hatfield 014C,E01023964,1133,744,389,186,151,52
2011,Welwyn Hatfield 015A,E01023908,1091,778,313,164,76,73
2011,Welwyn Hatfield 015B,E01023909,964,590,374,138,156,80
2011,Welwyn Hatfield 015C,E01023910,1045,696,349,181,64,104
2011,Welwyn Hatfield 015D,E01023911,1106,758,348,210,72,66
2011,Welwyn Hatfield 016A,E01023947,1150,825,325,164,61,100
2011,Welwyn Hatfield 016B,E01023948,1171,766,405,269,49,87
2011,Welwyn Hatfield 016C,E01023949,1356,899,457,271,77,109
2011,Breckland 001A,E01026436,1662,1162,500,329,35,136
2011,Breckland 001C,E01026461,971,654,317,223,28,66
2011,Breckland 001E,E01026483,818,546,272,149,26,97
2011,Breckland 001F,E01033042,1790,1341,449,256,39,154
2011,Breckland 002A,E01026442,1575,993,582,400,37,145
2011,Breckland 002B,E01026443,1518,1032,486,273,63,150
2011,Breckland 002C,E01026445,1658,1024,634,404,42,188
2011,Breckland 002D,E01026462,1605,1086,519,353,37,129
2011,Breckland 003A,E01026428,1962,1383,579,313,55,211
2011,Breckland 003B,E01026429,1075,756,319,181,35,103
2011,Breckland 003C,E01026430,1178,798,380,242,37,101
2011,Breckland 003D,E01026431,730,460,270,181,29,60
2011,Breckland 004A,E01026446,1365,798,567,410,32,125
2011,Breckland 004B,E01026452,1195,799,396,262,32,102
2011,Breckland 004C,E01026453,1184,817,367,228,24,115
2011,Breckland 004D,E01026454,1234,998,236,125,27,84
2011,Breckland 005A,E01026425,1300,828,472,275,45,152
2011,Breckland 005B,E01026426,1766,1299,467,240,59,168
2011,Breckland 005C,E01026427,1524,1046,478,337,30,111
2011,Breckland 005D,E01026432,1048,707,341,233,22,86
2011,Breckland 005E,E01026433,1069,842,227,86,37,104
2011,Breckland 005F,E01026434,1467,1037,430,302,44,84
2011,Breckland 006A,E01026479,1105,756,349,222,43,84
2011,Breckland 006B,E01026480,1099,722,377,261,28,88
2011,Breckland 006C,E01026481,865,628,237,127,27,83
2011,Breckland 006D,E01026484,1003,698,305,210,21,74
2011,Breckland 006E,E01026485,825,568,257,176,24,57
2011,Breckland 007A,E01026455,1248,809,439,242,41,156
2011,Breckland 007B,E01026456,824,532,292,183,17,92
2011,Breckland 007C,E01026457,876,486,390,305,14,71
2011,Breckland 007D,E01026458,1031,661,370,190,30,150
2011,Breckland 007E,E01026459,942,559,383,232,25,126
2011,Breckland 008A,E01026437,860,516,344,257,24,63
2011,Breckland 008B,E01026438,750,505,245,151,23,71
2011,Breckland 008C,E01026451,1475,975,500,323,50,127
2011,Breckland 008D,E01026495,935,583,352,233,21,98
2011,Breckland 008E,E01026496,742,455,287,207,14,66
2011,Breckland 009A,E01026486,1069,646,423,299,23,101
2011,Breckland 009B,E01026487,1132,877,255,127,30,98
2011,Breckland 009C,E01026488,789,548,241,128,15,98
2011,Breckland 009D,E01026489,920,557,363,276,20,67
2011,Breckland 009E,E01026490,1069,675,394,290,23,81
2011,Breckland 010A,E01026419,922,630,292,162,38,92
2011,Breckland 010B,E01026420,845,568,277,180,26,71
2011,Breckland 010D,E01026464,938,630,308,187,40,81
2011,Breckland 010E,E01026491,1640,1202,438,284,44,110
2011,Breckland 010F,E01033040,1592,806,786,42,43,701
2011,Breckland 010G,E01033041,774,580,194,64,29,101
2011,Breckland 011A,E01026422,1363,896,467,349,37,81
2011,Breckland 011B,E01026423,1300,972,328,158,44,126
2011,Breckland 011C,E01026447,1068,726,342,148,42,152
2011,Breckland 011D,E01026449,1399,1078,321,176,46,99
2011,Breckland 011E,E01026450,1263,902,361,227,39,95
2011,Breckland 012A,E01026424,1489,1039,450,297,42,111
2011,Breckland 012B,E01026444,1545,1024,521,302,38,181
2011,Breckland 012C,E01026492,924,618,306,166,25,115
2011,Breckland 012D,E01026493,882,607,275,184,25,66
2011,Breckland 013A,E01026421,1239,838,401,258,48,95
2011,Breckland 013B,E01026435,1631,1196,435,231,75,129
2011,Breckland 013C,E01026448,1627,1232,395,222,61,112
2011,Breckland 014A,E01026439,1169,795,374,281,35,58
2011,Breckland 014B,E01026440,880,653,227,112,33,82
2011,Breckland 014C,E01026441,1104,712,392,235,32,125
2011,Breckland 014D,E01026494,1642,1153,489,299,64,126
2011,Breckland 015A,E01026465,1285,901,384,184,34,166
2011,Breckland 015B,E01026466,1424,1086,338,138,59,141
2011,Breckland 015C,E01026467,1420,938,482,110,66,306
2011,Breckland 016A,E01026468,1760,1275,485,271,43,171
2011,Breckland 016B,E01026469,1175,862,313,182,34,97
2011,Breckland 016C,E01026470,2110,1726,384,167,68,149
2011,Breckland 016D,E01026471,960,746,214,117,25,72
2011,Breckland 016E,E01026472,934,736,198,143,16,39
2011,Breckland 016F,E01026473,1103,850,253,142,33,78
2011,Breckland 017A,E01026474,1212,862,350,161,41,148
2011,Breckland 017B,E01026475,1093,778,315,158,46,111
2011,Breckland 017C,E01026476,1078,800,278,117,38,123
2011,Breckland 017D,E01026477,992,680,312,104,48,160
2011,Breckland 017E,E01026478,1141,770,371,140,50,181
2011,Broadland 001A,E01026499,1021,677,344,202,27,115
2011,Broadland 001B,E01026500,1200,813,387,282,31,74
2011,Broadland 001C,E01026501,1205,761,444,264,38,142
2011,Broadland 001D,E01026502,855,578,277,195,19,63
2011,Broadland 001E,E01026503,1017,681,336,258,26,52
2011,Broadland 002A,E01026522,1033,719,314,182,34,98
2011,Broadland 002B,E01026523,1368,987,381,206,46,129
2011,Broadland 002C,E01026524,1073,773,300,189,25,86
2011,Broadland 002D,E01026525,846,593,253,165,22,66
2011,Broadland 002E,E01026547,1016,725,291,168,44,79
2011,Broadland 002F,E01026548,919,656,263,168,32,63
2011,Broadland 003A,E01026514,1116,804,312,187,35,90
2011,Broadland 003B,E01026515,787,567,220,127,26,67
2011,Broadland 003C,E01026516,899,637,262,137,34,91
2011,Broadland 003D,E01026517,1008,717,291,202,21,68
2011,Broadland 004A,E01026533,939,603,336,240,22,74
2011,Broadland 004B,E01026534,1192,877,315,173,24,118
2011,Broadland 004C,E01026535,1262,915,347,175,39,133
2011,Broadland 004D,E01026536,1260,893,367,192,53,122
2011,Broadland 004E,E01026537,1096,922,174,88,26,60
2011,Broadland 005A,E01026549,1287,864,423,261,43,119
2011,Broadland 005B,E01026550,845,675,170,105,22,43
2011,Broadland 005C,E01026551,891,632,259,169,14,76
2011,Broadland 005D,E01026552,1057,720,337,265,19,53
2011,Broadland 006A,E01026562,853,644,209,125,30,54
2011,Broadland 006B,E01026563,1054,869,185,68,33,84
2011,Broadland 006C,E01026564,1103,824,279,128,50,101
2011,Broadland 006D,E01026565,875,739,136,35,27,74
2011,Broadland 006E,E01026566,1097,800,297,191,29,77
2011,Broadland 006F,E01026567,1189,708,481,389,19,73
2011,Broadland 006G,E01026568,1189,872,317,198,43,76
2011,Broadland 007A,E01026518,972,779,193,87,39,67
2011,Broadland 007B,E01026519,1260,1027,233,125,35,73
2011,Broadland 007C,E01026520,816,496,320,224,16,80
2011,Broadland 007D,E01026521,839,542,297,224,30,43
2011,Broadland 008A,E01026545,1168,842,326,176,32,118
2011,Broadland 008B,E01026546,1111,799,312,206,40,66
2011,Broadland 008C,E01026578,1357,1020,337,176,41,120
2011,Broadland 008D,E01026579,1147,769,378,262,36,80
2011,Broadland 008E,E01026580,1079,648,431,303,32,96
2011,Broadland 009A,E01026540,1042,733,309,236,18,55
2011,Broadland 009B,E01026541,1699,1231,468,245,55,168
2011,Broadland 009C,E01026542,1057,760,297,208,30,59
2011,Broadland 009D,E01026543,1053,751,302,226,23,53
2011,Broadland 009E,E01026544,1299,1025,274,165,31,78
2011,Broadland 010A,E01026526,1030,682,348,234,26,88
2011,Broadland 010B,E01026527,1016,676,340,256,23,61
2011,Broadland 010C,E01026528,936,642,294,203,23,68
2011,Broadland 010D,E01026529,1161,802,359,237,21,101
2011,Broadland 011A,E01026530,1275,859,416,295,43,78
2011,Broadland 011B,E01026531,1219,883,336,233,28,75
2011,Broadland 011C,E01026532,1278,934,344,235,31,78
2011,Broadland 012A,E01026553,979,718,261,148,24,89
2011,Broadland 012B,E01026554,887,675,212,132,34,46
2011,Broadland 012C,E01026555,1091,778,313,192,32,89
2011,Broadland 012D,E01026556,1063,797,266,154,26,86
2011,Broadland 013A,E01026557,999,712,287,208,27,52
2011,Broadland 013B,E01026558,931,630,301,240,14,47
2011,Broadland 013C,E01026559,1075,791,284,193,31,60
2011,Broadland 013D,E01026560,932,617,315,251,15,49
2011,Broadland 013E,E01026561,1075,673,402,316,20,66
2011,Broadland 014A,E01026504,1140,761,379,251,34,94
2011,Broadland 014B,E01026505,940,633,307,199,26,82
2011,Broadland 014C,E01026506,1017,650,367,271,27,69
2011,Broadland 014D,E01026507,975,684,291,199,36,56
2011,Broadland 014E,E01026512,967,673,294,183,22,89
2011,Broadland 014F,E01026513,965,698,267,194,22,51
2011,Broadland 015A,E01026569,995,684,311,218,19,74
2011,Broadland 015B,E01026570,1069,744,325,235,27,63
2011,Broadland 015C,E01026571,1027,760,267,182,25,60
2011,Broadland 015D,E01026572,1062,778,284,196,22,66
2011,Broadland 015E,E01026573,945,656,289,174,25,90
2011,Broadland 016A,E01026574,1260,1001,259,142,47,70
2011,Broadland 016B,E01026575,1167,825,342,196,35,111
2011,Broadland 016C,E01026576,1542,1246,296,111,57,128
2011,Broadland 016D,E01026577,1270,942,328,186,51,91
2011,Broadland 017A,E01026508,1030,724,306,203,29,74
2011,Broadland 017B,E01026509,1200,859,341,240,28,73
2011,Broadland 017C,E01026510,1137,788,349,253,35,61
2011,Broadland 017D,E01026511,869,629,240,151,21,68
2011,Broadland 018A,E01026497,1048,748,300,205,30,65
2011,Broadland 018B,E01026498,896,620,276,184,23,69
2011,Broadland 018C,E01026538,1149,725,424,246,40,138
2011,Broadland 018D,E01026539,1237,868,369,233,42,94
2011,Great Yarmouth 001A,E01026605,1183,735,448,307,31,110
2011,Great Yarmouth 001B,E01026606,1176,695,481,319,36,126
2011,Great Yarmouth 001C,E01026607,1176,741,435,278,41,116
2011,Great Yarmouth 001D,E01026627,1020,623,397,289,24,84
2011,Great Yarmouth 001E,E01026628,1056,680,376,239,40,97
2011,Great Yarmouth 001F,E01026629,1087,731,356,203,38,115
2011,Great Yarmouth 002A,E01026608,967,649,318,220,20,78
2011,Great Yarmouth 002B,E01026609,892,663,229,131,22,76
2011,Great Yarmouth 002C,E01026636,1147,746,401,269,36,96
2011,Great Yarmouth 002D,E01026637,1494,964,530,378,41,111
2011,Great Yarmouth 002E,E01026638,1100,752,348,192,42,114
2011,Great Yarmouth 003A,E01026589,1055,694,361,207,33,121
2011,Great Yarmouth 003B,E01026590,1057,648,409,286,21,102
2011,Great Yarmouth 003C,E01026591,1298,798,500,344,30,126
2011,Great Yarmouth 003D,E01026592,1035,571,464,310,29,125
2011,Great Yarmouth 003E,E01026593,957,598,359,256,29,74
2011,Great Yarmouth 003F,E01026594,1203,815,388,245,43,100
2011,Great Yarmouth 004A,E01026599,1063,727,336,129,51,156
2011,Great Yarmouth 004B,E01026639,1167,788,379,191,48,140
2011,Great Yarmouth 004C,E01026640,1035,619,416,290,26,100
2011,Great Yarmouth 004D,E01026641,1028,592,436,197,56,183
2011,Great Yarmouth 005A,E01026595,1206,784,422,188,30,204
2011,Great Yarmouth 005B,E01026596,1189,786,403,185,53,165
2011,Great Yarmouth 005C,E01026597,1366,854,512,145,66,301
2011,Great Yarmouth 005D,E01026598,1242,857,385,139,57,189
2011,Great Yarmouth 006A,E01026622,1061,584,477,138,55,284
2011,Great Yarmouth 006B,E01026623,1191,823,368,116,43,209
2011,Great Yarmouth 006C,E01026624,1325,843,482,164,66,252
2011,Great Yarmouth 006D,E01026625,1228,666,562,154,78,330
2011,Great Yarmouth 006E,E01026626,1412,917,495,180,54,261
2011,Great Yarmouth 007A,E01026600,1040,696,344,150,44,150
2011,Great Yarmouth 007B,E01026633,1364,964,400,153,79,168
2011,Great Yarmouth 007C,E01026634,1083,725,358,127,41,190
2011,Great Yarmouth 007D,E01026635,1644,1139,505,164,63,278
2011,Great Yarmouth 008A,E01026581,1246,938,308,179,34,95
2011,Great Yarmouth 008B,E01026582,1410,1014,396,277,35,84
2011,Great Yarmouth 008C,E01026583,967,669,298,191,28,79
2011,Great Yarmouth 008D,E01026584,1038,645,393,297,19,77
2011,Great Yarmouth 009A,E01026601,1115,806,309,154,48,107
2011,Great Yarmouth 009B,E01026602,1052,674,378,240,28,110
2011,Great Yarmouth 009C,E01026603,1157,721,436,119,57,260
2011,Great Yarmouth 009D,E01026604,1128,655,473,179,46,248
2011,Great Yarmouth 009E,E01026632,1201,817,384,208,36,140
2011,Great Yarmouth 010A,E01026610,1158,853,305,156,46,103
2011,Great Yarmouth 010B,E01026611,1053,655,398,239,40,119
2011,Great Yarmouth 010C,E01026612,1728,1155,573,366,69,138
2011,Great Yarmouth 010D,E01026630,1214,819,395,160,53,182
2011,Great Yarmouth 010E,E01026631,1237,875,362,180,37,145
2011,Great Yarmouth 011A,E01026617,890,547,343,190,38,115
2011,Great Yarmouth 011B,E01026618,1181,768,413,225,49,139
2011,Great Yarmouth 011C,E01026619,985,611,374,127,37,210
2011,Great Yarmouth 011D,E01026620,881,499,382,147,37,198
2011,Great Yarmouth 011E,E01026621,1005,676,329,149,64,116
2011,Great Yarmouth 012A,E01026613,996,682,314,214,29,71
2011,Great Yarmouth 012B,E01026614,1280,813,467,276,39,152
2011,Great Yarmouth 012C,E01026615,1038,704,334,221,30,83
2011,Great Yarmouth 012D,E01026616,929,702,227,109,35,83
2011,Great Yarmouth 013A,E01026585,922,587,335,220,21,94
2011,Great Yarmouth 013B,E01026586,718,459,259,161,22,76
2011,Great Yarmouth 013C,E01026587,1287,915,372,233,49,90
2011,Great Yarmouth 013D,E01026588,1871,1292,579,381,34,164
2011,King's Lynn and West Norfolk 001A,E01026680,866,385,481,341,30,110
2011,King's Lynn and West Norfolk 001B,E01026681,1000,534,466,357,19,90
2011,King's Lynn and West Norfolk 001C,E01026682,814,481,333,244,21,68
2011,King's Lynn and West Norfolk 001D,E01026683,966,622,344,218,27,99
2011,King's Lynn and West Norfolk 002A,E01026645,958,606,352,269,11,72
2011,King's Lynn and West Norfolk 002B,E01026646,1179,710,469,298,31,140
2011,King's Lynn and West Norfolk 002C,E01026656,1422,889,533,335,29,169
2011,King's Lynn and West Norfolk 002D,E01026695,1603,1039,564,402,26,136
2011,King's Lynn and West Norfolk 003A,E01026676,1200,637,563,443,29,91
2011,King's Lynn and West Norfolk 003B,E01026677,1035,635,400,273,31,96
2011,King's Lynn and West Norfolk 003C,E01026678,1046,583,463,354,26,83
2011,King's Lynn and West Norfolk 003D,E01026701,1148,602,546,437,22,87
2011,King's Lynn and West Norfolk 003E,E01026702,900,549,351,231,21,99
2011,King's Lynn and West Norfolk 003F,E01026703,859,543,316,216,16,84
2011,King's Lynn and West Norfolk 004A,E01026653,1214,692,522,433,24,65
2011,King's Lynn and West Norfolk 004B,E01026654,1063,636,427,284,35,108
2011,King's Lynn and West Norfolk 004C,E01026655,957,572,385,295,24,66
2011,King's Lynn and West Norfolk 004D,E01026718,1671,1128,543,375,35,133
2011,King's Lynn and West Norfolk 005A,E01026691,850,584,266,192,26,48
2011,King's Lynn and West Norfolk 005B,E01026692,938,723,215,121,34,60
2011,King's Lynn and West Norfolk 005C,E01026708,957,659,298,219,31,48
2011,King's Lynn and West Norfolk 005D,E01026709,1320,917,403,288,50,65
2011,King's Lynn and West Norfolk 005E,E01026710,880,594,286,210,20,56
2011,King's Lynn and West Norfolk 006A,E01026669,1210,839,371,277,30,64
2011,King's Lynn and West Norfolk 006B,E01026670,1140,817,323,137,29,157
2011,King's Lynn and West Norfolk 006C,E01026671,1066,788,278,194,31,53
2011,King's Lynn and West Norfolk 006D,E01026672,1112,806,306,176,49,81
2011,King's Lynn and West Norfolk 006E,E01026673,1132,902,230,131,21,78
2011,King's Lynn and West Norfolk 007A,E01026687,1076,638,438,138,51,249
2011,King's Lynn and West Norfolk 007B,E01026688,1002,636,366,96,51,219
2011,King's Lynn and West Norfolk 007C,E01026689,1179,919,260,103,38,119
2011,King's Lynn and West Norfolk 007D,E01026690,1051,641,410,149,56,205
2011,King's Lynn and West Norfolk 008A,E01026647,1636,1026,610,408,47,155
2011,King's Lynn and West Norfolk 008B,E01026711,1106,734,372,175,41,156
2011,King's Lynn and West Norfolk 008C,E01026712,1192,863,329,221,29,79
2011,King's Lynn and West Norfolk 008D,E01026713,1152,778,374,236,33,105
2011,King's Lynn and West Norfolk 009A,E01026666,1309,868,441,149,63,229
2011,King's Lynn and West Norfolk 009B,E01026667,1253,908,345,185,64,96
2011,King's Lynn and West Norfolk 009C,E01026668,1176,862,314,157,47,110
2011,King's Lynn and West Norfolk 009D,E01026693,1370,1002,368,195,54,119
2011,King's Lynn and West Norfolk 010A,E01026662,1724,1232,492,131,53,308
2011,King's Lynn and West Norfolk 010B,E01026663,1219,851,368,155,56,157
2011,King's Lynn and West Norfolk 010C,E01026664,1683,1351,332,159,47,126
2011,King's Lynn and West Norfolk 010D,E01026714,1531,1183,348,225,46,77
2011,King's Lynn and West Norfolk 011A,E01026698,1433,992,441,192,52,197
2011,King's Lynn and West Norfolk 011B,E01026699,1161,827,334,130,17,187
2011,King's Lynn and West Norfolk 011C,E01026700,1154,846,308,129,37,142
2011,King's Lynn and West Norfolk 011D,E01026704,1296,857,439,136,58,245
2011,King's Lynn and West Norfolk 011E,E01026705,1112,788,324,176,23,125
2011,King's Lynn and West Norfolk 011F,E01026706,1183,870,313,155,49,109
2011,King's Lynn and West Norfolk 012A,E01026665,1666,1090,576,360,47,169
2011,King's Lynn and West Norfolk 012B,E01026674,849,553,296,204,30,62
2011,King's Lynn and West Norfolk 012C,E01026675,907,655,252,168,27,57
2011,King's Lynn and West Norfolk 012D,E01026694,1793,1180,613,379,59,175
2011,King's Lynn and West Norfolk 013A,E01026684,877,586,291,159,42,90
2011,King's Lynn and West Norfolk 013B,E01026685,931,601,330,225,25,80
2011,King's Lynn and West Norfolk 013C,E01026719,1717,1177,540,319,48,173
2011,King's Lynn and West Norfolk 013D,E01026720,999,686,313,208,32,73
2011,King's Lynn and West Norfolk 013E,E01026721,950,613,337,185,35,117
2011,King's Lynn and West Norfolk 014A,E01026642,975,568,407,298,37,72
2011,King's Lynn and West Norfolk 014B,E01026643,1084,704,380,236,42,102
2011,King's Lynn and West Norfolk 014C,E01026644,2119,1885,234,26,37,171
2011,King's Lynn and West Norfolk 014D,E01026723,1182,813,369,260,26,83
2011,King's Lynn and West Norfolk 014E,E01026724,1114,742,372,257,24,91
2011,King's Lynn and West Norfolk 014F,E01026725,1085,709,376,234,32,110
2011,King's Lynn and West Norfolk 015A,E01026696,866,582,284,137,32,115
2011,King's Lynn and West Norfolk 015B,E01026697,966,659,307,186,23,98
2011,King's Lynn and West Norfolk 015C,E01026722,1795,1306,489,290,53,146
2011,King's Lynn and West Norfolk 015D,E01026726,1551,1032,519,299,54,166
2011,King's Lynn and West Norfolk 016A,E01026659,1139,779,360,188,39,133
2011,King's Lynn and West Norfolk 016B,E01026660,1196,754,442,293,39,110
2011,King's Lynn and West Norfolk 016C,E01026661,1087,717,370,202,39,129
2011,King's Lynn and West Norfolk 016D,E01026715,1069,739,330,191,32,107
2011,King's Lynn and West Norfolk 016E,E01026716,1357,828,529,283,55,191
2011,King's Lynn and West Norfolk 016F,E01026717,1143,763,380,204,44,132
2011,King's Lynn and West Norfolk 017C,E01026686,1308,840,468,343,21,104
2011,King's Lynn and West Norfolk 017D,E01026707,1270,591,679,581,16,82
2011,King's Lynn and West Norfolk 017E,E01033036,1105,786,319,175,38,106
2011,King's Lynn and West Norfolk 017F,E01033037,1076,804,272,106,47,119
2011,King's Lynn and West Norfolk 017G,E01033038,1171,815,356,156,43,157
2011,King's Lynn and West Norfolk 017H,E01033039,678,451,227,148,23,56
2011,King's Lynn and West Norfolk 018A,E01026679,1782,1228,554,329,67,158
2011,King's Lynn and West Norfolk 018B,E01026727,1858,1265,593,394,43,156
2011,King's Lynn and West Norfolk 018C,E01026728,1679,1093,586,359,53,174
2011,King's Lynn and West Norfolk 019A,E01026648,1122,751,371,222,34,115
2011,King's Lynn and West Norfolk 019B,E01026649,1121,807,314,177,31,106
2011,King's Lynn and West Norfolk 019C,E01026650,868,620,248,75,51,122
2011,King's Lynn and West Norfolk 019D,E01026651,1666,1129,537,311,61,165
2011,King's Lynn and West Norfolk 019E,E01026652,966,659,307,171,24,112
2011,North Norfolk 001A,E01026770,1314,817,497,308,29,160
2011,North Norfolk 001B,E01026771,1107,678,429,299,22,108
2011,North Norfolk 001C,E01026772,1166,601,565,439,34,92
2011,North Norfolk 001D,E01026773,1388,799,589,429,32,128
2011,North Norfolk 002A,E01026739,1430,883,547,381,44,122
2011,North Norfolk 002B,E01026763,949,600,349,228,23,98
2011,North Norfolk 002C,E01026764,879,544,335,259,16,60
2011,North Norfolk 002D,E01026765,971,565,406,275,28,103
2011,North Norfolk 003A,E01026734,952,639,313,156,10,147
2011,North Norfolk 003B,E01026735,827,506,321,199,7,115
2011,North Norfolk 003C,E01026736,889,503,386,260,21,105
2011,North Norfolk 003D,E01026777,828,491,337,249,12,76
2011,North Norfolk 003E,E01026778,874,471,403,300,11,92
2011,North Norfolk 003F,E01026779,1039,677,362,156,37,169
2011,North Norfolk 004A,E01026741,1269,745,524,408,26,90
2011,North Norfolk 004B,E01026742,938,386,552,321,176,55
2011,North Norfolk 004C,E01026743,1473,906,567,371,23,173
2011,North Norfolk 005A,E01026762,1741,1048,693,498,41,154
2011,North Norfolk 005B,E01026766,1718,1119,599,401,46,152
2011,North Norfolk 005C,E01026781,1555,961,594,421,50,123
2011,North Norfolk 006A,E01026731,679,355,324,250,19,55
2011,North Norfolk 006B,E01026732,947,606,341,231,31,79
2011,North Norfolk 006C,E01026733,1674,1095,579,356,51,172
2011,North Norfolk 006D,E01026737,1771,1232,539,336,59,144
2011,North Norfolk 007A,E01026738,1820,1124,696,493,61,142
2011,North Norfolk 007B,E01026750,942,539,403,257,24,122
2011,North Norfolk 007C,E01026751,916,520,396,295,24,77
2011,North Norfolk 007D,E01026752,1063,650,413,267,25,121
2011,North Norfolk 008A,E01026729,1675,1152,523,311,42,170
2011,North Norfolk 008B,E01026730,1785,1213,572,353,56,163
2011,North Norfolk 008C,E01026788,919,601,318,205,29,84
2011,North Norfolk 009A,E01026780,1864,1345,519,319,46,154
2011,North Norfolk 009B,E01026782,1601,1071,530,340,29,161
2011,North Norfolk 009C,E01026787,746,514,232,121,22,89
2011,North Norfolk 010A,E01026753,1061,653,408,211,42,155
2011,North Norfolk 010B,E01026754,1023,706,317,193,31,93
2011,North Norfolk 010C,E01026755,811,430,381,287,22,72
2011,North Norfolk 010D,E01026756,846,551,295,145,33,117
2011,North Norfolk 010E,E01026757,1143,819,324,209,17,98
2011,North Norfolk 010F,E01026758,1019,716,303,195,23,85
2011,North Norfolk 010G,E01026759,855,543,312,192,34,86
2011,North Norfolk 010H,E01026760,907,640,267,167,29,71
2011,North Norfolk 010I,E01026761,1105,694,411,274,22,115
2011,North Norfolk 011A,E01026745,1191,808,383,241,35,107
2011,North Norfolk 011B,E01026746,1246,917,329,236,29,64
2011,North Norfolk 011C,E01026747,941,641,300,180,23,97
2011,North Norfolk 011D,E01026748,1013,651,362,274,20,68
2011,North Norfolk 011E,E01026749,975,650,325,148,34,143
2011,North Norfolk 012A,E01026740,1804,1103,701,441,49,211
2011,North Norfolk 012B,E01026767,960,661,299,212,20,67
2011,North Norfolk 012C,E01026768,1387,766,621,90,31,500
2011,North Norfolk 012D,E01026789,926,682,244,153,20,71
2011,North Norfolk 012E,E01026790,870,585,285,162,28,95
2011,North Norfolk 013A,E01026774,1077,747,330,215,22,93
2011,North Norfolk 013B,E01026775,854,526,328,171,31,126
2011,North Norfolk 013C,E01026776,1169,783,386,257,30,99
2011,North Norfolk 013D,E01026786,1634,1041,593,377,50,166
2011,North Norfolk 014A,E01026744,1336,783,553,399,25,129
2011,North Norfolk 014B,E01026769,1531,923,608,441,39,128
2011,North Norfolk 014C,E01026783,1329,777,552,415,25,112
2011,North Norfolk 014D,E01026784,723,473,250,159,19,72
2011,North Norfolk 014E,E01026785,1008,594,414,304,13,97
2011,Norwich 001A,E01026797,1846,1509,337,117,46,174
2011,Norwich 001B,E01026798,1120,783,337,134,34,169
2011,Norwich 001C,E01026799,1084,800,284,104,27,153
2011,Norwich 001D,E01026800,1464,1021,443,128,59,256
2011,Norwich 001E,E01026801,1189,858,331,204,26,101
2011,Norwich 001F,E01026802,1247,896,351,162,60,129
2011,Norwich 002A,E01026828,1182,807,375,134,43,198
2011,Norwich 002B,E01026829,1522,1111,411,121,72,218
2011,Norwich 002C,E01026830,975,639,336,159,32,145
2011,Norwich 002D,E01026831,1044,860,184,53,52,79
2011,Norwich 002E,E01026832,936,623,313,120,46,147
2011,Norwich 002F,E01026833,990,637,353,123,23,207
2011,Norwich 002G,E01026834,1049,695,354,145,32,177
2011,Norwich 003A,E01026841,1211,979,232,73,48,111
2011,Norwich 003B,E01026842,1353,1093,260,111,55,94
2011,Norwich 003C,E01026843,1426,1045,381,162,56,163
2011,Norwich 003D,E01026844,1289,906,383,132,57,194
2011,Norwich 003E,E01026845,1297,1102,195,64,49,82
2011,Norwich 003F,E01026846,1333,1066,267,83,66,118
2011,Norwich 004A,E01026803,930,595,335,156,26,153
2011,Norwich 004B,E01026804,984,660,324,195,35,94
2011,Norwich 004C,E01026805,907,641,266,125,31,110
2011,Norwich 004D,E01026806,1246,683,563,205,24,334
2011,Norwich 004E,E01026807,893,662,231,95,28,108
2011,Norwich 004F,E01026808,887,585,302,85,47,170
2011,Norwich 004G,E01026809,1054,661,393,182,24,187
2011,Norwich 005A,E01026791,1118,704,414,114,122,178
2011,Norwich 005B,E01026792,1052,722,330,154,53,123
2011,Norwich 005C,E01026793,1203,733,470,124,96,250
2011,Norwich 005D,E01026794,1565,1150,415,148,77,190
2011,Norwich 005F,E01026796,1208,692,516,109,242,165
2011,Norwich 005G,E01033435,1394,946,448,47,282,119
2011,Norwich 005H,E01033436,999,601,398,122,104,172
2011,Norwich 006A,E01026863,1471,994,477,144,215,118
2011,Norwich 006B,E01026864,1121,830,291,134,38,119
2011,Norwich 006C,E01026865,1395,937,458,110,123,225
2011,Norwich 006D,E01026866,1265,913,352,119,130,103
2011,Norwich 006E,E01026867,1077,663,414,84,108,222
2011,Norwich 006F,E01026868,1140,682,458,94,161,203
2011,Norwich 006G,E01026869,1006,610,396,141,46,209
2011,Norwich 007A,E01026822,1674,1152,522,187,95,240
2011,Norwich 007B,E01026823,1687,1241,446,137,137,172
2011,Norwich 007C,E01026824,1183,771,412,158,69,185
2011,Norwich 007D,E01026825,1065,783,282,72,72,138
2011,Norwich 007E,E01026826,1100,761,339,104,37,198
2011,Norwich 007F,E01026827,1110,645,465,208,47,210
2011,Norwich 009A,E01026835,1217,873,344,81,211,52
2011,Norwich 009B,E01026836,1244,886,358,102,202,54
2011,Norwich 009C,E01026837,1203,910,293,113,113,67
2011,Norwich 009D,E01026838,1184,828,356,90,201,65
2011,Norwich 009E,E01026839,1374,937,437,45,326,66
2011,Norwich 009F,E01026840,1386,1074,312,89,156,67
2011,Norwich 010A,E01026858,1069,568,501,162,189,150
2011,Norwich 010B,E01026859,1104,701,403,97,145,161
2011,Norwich 010C,E01026860,4026,1292,2734,102,2542,90
2011,Norwich 010D,E01026861,1143,642,501,107,240,154
2011,Norwich 010E,E01026862,952,620,332,119,129,84
2011,Norwich 011A,E01026852,924,696,228,148,32,48
2011,Norwich 011B,E01026853,1342,921,421,175,37,209
2011,Norwich 011D,E01026855,1286,947,339,130,148,61
2011,Norwich 011E,E01026856,1566,1093,473,87,309,77
2011,Norwich 011F,E01026857,1122,731,391,181,146,64
2011,Norwich 011G,E01033434,926,744,182,71,72,39
2011,Norwich 011H,E01033437,1060,648,412,137,78,197
2011,Norwich 012A,E01026810,963,600,363,227,71,65
2011,Norwich 012B,E01026811,1051,699,352,254,40,58
2011,Norwich 012C,E01026812,1044,766,278,197,33,48
2011,Norwich 012D,E01026813,990,628,362,266,49,47
2011,Norwich 012E,E01026814,1051,686,365,140,124,101
2011,Norwich 012F,E01026815,1084,750,334,161,113,60
2011,Norwich 013A,E01026816,1324,1061,263,104,39,120
2011,Norwich 013B,E01026817,1009,643,366,201,26,139
2011,Norwich 013C,E01026818,1021,706,315,101,40,174
2011,Norwich 013D,E01026819,1022,696,326,102,31,193
2011,Norwich 013E,E01026820,1134,760,374,158,45,171
2011,Norwich 013F,E01026821,1020,680,340,156,40,144
2011,Norwich 014A,E01033438,1006,682,324,163,65,96
2011,Norwich 014B,E01033439,1209,1007,202,71,36,95
2011,Norwich 014C,E01033440,950,735,215,42,49,124
2011,Norwich 014D,E01033441,1106,897,209,66,63,80
2011,Norwich 015A,E01026848,1366,881,485,158,50,277
2011,Norwich 015B,E01026849,1463,1155,308,161,32,115
2011,Norwich 015C,E01026850,1470,1182,288,120,39,129
2011,South Norfolk 001A,E01026916,1484,1025,459,332,31,96
2011,South Norfolk 001B,E01026917,1025,711,314,213,27,74
2011,South Norfolk 001C,E01026918,1260,860,400,267,24,109
2011,South Norfolk 001E,E01026924,1096,718,378,232,36,110
2011,South Norfolk 001F,E01026925,1539,1123,416,166,45,205
2011,South Norfolk 001G,E01033538,1592,1408,184,49,28,107
2011,South Norfolk 001H,E01033540,1124,759,365,231,22,112
2011,South Norfolk 002A,E01026881,975,753,222,121,39,62
2011,South Norfolk 002B,E01026882,1399,928,471,301,65,105
2011,South Norfolk 002C,E01026883,1189,817,372,240,48,84
2011,South Norfolk 002D,E01026895,1153,854,299,180,53,66
2011,South Norfolk 002E,E01026896,900,640,260,177,23,60
2011,South Norfolk 003A,E01026905,691,409,282,200,18,64
2011,South Norfolk 003B,E01026906,1041,651,390,283,44,63
2011,South Norfolk 003C,E01026907,1294,940,354,234,46,74
2011,South Norfolk 003D,E01026908,1046,860,186,76,45,65
2011,South Norfolk 004A,E01026909,1016,651,365,227,22,116
2011,South Norfolk 004B,E01026910,1081,748,333,228,26,79
2011,South Norfolk 004C,E01026947,925,698,227,125,28,74
2011,South Norfolk 004D,E01026948,1227,805,422,156,192,74
2011,South Norfolk 005A,E01026870,1100,749,351,214,27,110
2011,South Norfolk 005B,E01026871,975,666,309,214,32,63
2011,South Norfolk 005C,E01026921,1014,720,294,202,21,71
2011,South Norfolk 005D,E01026922,982,674,308,188,26,94
2011,South Norfolk 006A,E01026875,836,591,245,172,30,43
2011,South Norfolk 006B,E01026876,1054,699,355,264,26,65
2011,South Norfolk 006C,E01026926,1122,753,369,254,32,83
2011,South Norfolk 006D,E01026927,1344,957,387,254,52,81
2011,South Norfolk 006E,E01026928,986,687,299,206,23,70
2011,South Norfolk 006F,E01026936,995,679,316,221,32,63
2011,South Norfolk 006G,E01026937,1039,774,265,162,30,73
2011,South Norfolk 007A,E01026884,838,590,248,142,24,82
2011,South Norfolk 007B,E01026885,1061,788,273,155,40,78
2011,South Norfolk 007C,E01026933,1953,1506,447,244,53,150
2011,South Norfolk 007D,E01026945,1567,1250,317,168,40,109
2011,South Norfolk 007E,E01026946,743,488,255,189,17,49
2011,South Norfolk 008A,E01026879,885,568,317,163,88,66
2011,South Norfolk 008B,E01026880,1051,672,379,255,36,88
2011,South Norfolk 008C,E01026911,751,514,237,142,21,74
2011,South Norfolk 008D,E01026912,1110,794,316,193,45,78
2011,South Norfolk 008E,E01026929,942,662,280,195,21,64
2011,South Norfolk 008F,E01026930,1098,751,347,215,41,91
2011,South Norfolk 009A,E01026913,1217,942,275,163,26,86
2011,South Norfolk 009B,E01026914,1111,765,346,230,40,76
2011,South Norfolk 009C,E01026915,1442,1086,356,245,29,82
2011,South Norfolk 009D,E01026919,1068,751,317,191,26,100
2011,South Norfolk 009E,E01026920,843,613,230,160,16,54
2011,South Norfolk 009F,E01026941,905,621,284,188,37,59
2011,South Norfolk 009G,E01026942,860,639,221,142,30,49
2011,South Norfolk 010A,E01026898,1017,666,351,221,32,98
2011,South Norfolk 010B,E01026899,1063,778,285,188,29,68
2011,South Norfolk 010C,E01026943,1194,806,388,254,37,97
2011,South Norfolk 010D,E01026944,847,600,247,144,27,76
2011,South Norfolk 011A,E01026877,1120,771,349,233,27,89
2011,South Norfolk 011B,E01026878,878,626,252,138,30,84
2011,South Norfolk 011C,E01026897,2023,1409,614,401,66,147
2011,South Norfolk 011D,E01026938,1467,1100,367,219,45,103
2011,South Norfolk 011E,E01026939,1295,950,345,196,45,104
2011,South Norfolk 011F,E01026940,1246,933,313,141,38,134
2011,South Norfolk 012A,E01026892,922,645,277,151,34,92
2011,South Norfolk 012B,E01026893,763,482,281,189,31,61
2011,South Norfolk 012C,E01026894,1773,1185,588,371,52,165
2011,South Norfolk 012D,E01026903,897,641,256,146,37,73
2011,South Norfolk 012E,E01026904,992,712,280,187,28,65
2011,South Norfolk 013A,E01026872,1601,1096,505,321,43,141
2011,South Norfolk 013B,E01026900,980,640,340,223,24,93
2011,South Norfolk 013C,E01026901,955,683,272,186,19,67
2011,South Norfolk 013D,E01026902,1328,941,387,229,24,134
2011,South Norfolk 014A,E01026873,942,647,295,173,32,90
2011,South Norfolk 014B,E01026874,1158,779,379,204,50,125
2011,South Norfolk 014C,E01026886,1061,754,307,201,29,77
2011,South Norfolk 014D,E01026887,1052,774,278,171,27,80
2011,South Norfolk 014E,E01026934,746,523,223,150,17,56
2011,South Norfolk 014F,E01026935,967,659,308,221,22,65
2011,South Norfolk 015A,E01026888,1031,690,341,205,27,109
2011,South Norfolk 015B,E01026889,1098,768,330,236,20,74
2011,South Norfolk 015D,E01026891,1160,777,383,214,29,140
2011,South Norfolk 015E,E01026931,875,611,264,167,23,74
2011,South Norfolk 015F,E01026932,897,657,240,138,24,78
2011,South Norfolk 015G,E01033539,1017,790,227,129,25,73
2011,South Norfolk 015H,E01033541,1023,758,265,133,28,104
2011,Babergh 001A,E01029876,1505,1005,500,288,53,159
2011,Babergh 001B,E01029898,1205,771,434,312,25,97
2011,Babergh 001C,E01029907,1585,1093,492,321,52,119
2011,Babergh 002A,E01029881,1425,1025,400,241,48,111
2011,Babergh 002B,E01029884,1151,862,289,165,23,101
2011,Babergh 002C,E01029885,1624,1154,470,319,34,117
2011,Babergh 003A,E01029900,1144,732,412,259,29,124
2011,Babergh 003B,E01029901,1605,1157,448,311,28,109
2011,Babergh 003C,E01029917,1330,975,355,244,37,74
2011,Babergh 004A,E01029892,1265,882,383,192,33,158
2011,Babergh 004B,E01029893,1837,1303,534,315,60,159
2011,Babergh 004C,E01029894,852,626,226,145,26,55
2011,Babergh 004D,E01029895,873,646,227,152,26,49
2011,Babergh 004E,E01029896,907,607,300,183,40,77
2011,Babergh 004F,E01029911,1608,1082,526,326,54,146
2011,Babergh 005A,E01029877,939,677,262,163,29,70
2011,Babergh 005B,E01029878,867,583,284,191,26,67
2011,Babergh 005C,E01029879,1125,808,317,205,35,77
2011,Babergh 005D,E01029908,1239,1056,183,96,26,61
2011,Babergh 005E,E01029909,1232,1018,214,110,34,70
2011,Babergh 005F,E01029910,855,652,203,84,34,85
2011,Babergh 006A,E01029880,1230,872,358,237,39,82
2011,Babergh 006B,E01029921,921,648,273,191,18,64
2011,Babergh 006C,E01029922,956,650,306,204,27,75
2011,Babergh 006D,E01029923,1052,779,273,161,25,87
2011,Babergh 007A,E01029912,1133,818,315,146,38,131
2011,Babergh 007B,E01029913,727,403,324,259,15,50
2011,Babergh 007C,E01029914,1169,880,289,122,31,136
2011,Babergh 007D,E01029915,879,635,244,135,28,81
2011,Babergh 007E,E01029916,936,694,242,94,28,120
2011,Babergh 007F,E01029918,802,587,215,124,15,76
2011,Babergh 007G,E01029919,1088,747,341,236,30,75
2011,Babergh 007H,E01029920,1170,834,336,196,20,120
2011,Babergh 008A,E01029886,866,548,318,182,13,123
2011,Babergh 008B,E01029887,1366,987,379,277,40,62
2011,Babergh 008C,E01029888,888,606,282,149,37,96
2011,Babergh 008D,E01029889,937,632,305,127,55,123
2011,Babergh 008E,E01029890,1006,801,205,96,37,72
2011,Babergh 008F,E01029891,1427,1088,339,194,35,110
2011,Babergh 009A,E01029875,1553,1052,501,313,50,138
2011,Babergh 009B,E01029899,1298,886,412,283,29,100
2011,Babergh 009C,E01029902,1589,1109,480,291,52,137
2011,Babergh 009D,E01029906,1244,847,397,233,36,128
2011,Babergh 010A,E01029870,831,598,233,132,18,83
2011,Babergh 010B,E01029872,998,712,286,199,33,54
2011,Babergh 010C,E01029882,1069,705,364,223,52,89
2011,Babergh 010D,E01029883,1440,925,515,363,64,88
2011,Babergh 010E,E01029903,1057,723,334,256,37,41
2011,Babergh 010F,E01029904,1065,690,375,263,45,67
2011,Babergh 010G,E01029905,793,535,258,171,28,59
2011,Babergh 011A,E01029871,962,648,314,219,24,71
2011,Babergh 011B,E01029873,1529,1019,510,332,52,126
2011,Babergh 011C,E01029874,1301,982,319,193,44,82
2011,Babergh 011D,E01029897,1620,993,627,245,282,100
2011,Forest Heath 001A,E01029926,1206,722,484,355,21,108
2011,Forest Heath 001B,E01029927,1666,1233,433,208,44,181
2011,Forest Heath 001C,E01029928,1327,995,332,177,29,126
2011,Forest Heath 001D,E01029929,1640,1098,542,308,43,191
2011,Forest Heath 001E,E01029930,1117,811,306,198,21,87
2011,Forest Heath 002C,E01029942,1093,770,323,192,26,105
2011,Forest Heath 002E,E01029944,1209,814,395,267,25,103
2011,Forest Heath 002F,E01033453,2642,2056,586,132,64,390
2011,Forest Heath 003E,E01029945,1417,1056,361,191,36,134
2011,Forest Heath 003F,E01032523,963,726,237,32,43,162
2011,Forest Heath 003G,E01032524,728,512,216,106,23,87
2011,Forest Heath 003H,E01032525,1942,1365,577,168,102,307
2011,Forest Heath 003I,E01032526,1262,949,313,177,28,108
2011,Forest Heath 004A,E01029938,1003,746,257,65,46,146
2011,Forest Heath 004B,E01029939,1137,851,286,118,47,121
2011,Forest Heath 004C,E01029940,1034,727,307,177,27,103
2011,Forest Heath 004D,E01029946,1483,1072,411,161,60,190
2011,Forest Heath 004E,E01029947,1613,1162,451,295,33,123
2011,Forest Heath 005A,E01029941,1322,969,353,211,32,110
2011,Forest Heath 005C,E01029957,1233,911,322,211,37,74
2011,Forest Heath 005D,E01033451,1086,926,160,16,25,119
2011,Forest Heath 005E,E01033452,1006,804,202,86,36,80
2011,Forest Heath 005F,E01033454,949,794,155,51,17,87
2011,Forest Heath 006A,E01029937,1476,1105,371,207,41,123
2011,Forest Heath 006B,E01029953,1056,838,218,93,34,91
2011,Forest Heath 006C,E01029954,1765,1355,410,175,48,187
2011,Forest Heath 006D,E01029955,1415,1139,276,139,43,94
2011,Forest Heath 006E,E01029956,1044,879,165,54,30,81
2011,Forest Heath 008A,E01029925,1326,1066,260,181,8,71
2011,Forest Heath 008B,E01029949,1037,791,246,125,35,86
2011,Forest Heath 008C,E01029950,1339,1045,294,113,39,142
2011,Forest Heath 008D,E01029951,1046,791,255,176,20,59
2011,Forest Heath 008E,E01029952,855,663,192,117,20,55
2011,Forest Heath 008F,E01032612,1616,1374,242,121,27,94
2011,Ipswich 001A,E01030032,999,689,310,87,49,174
2011,Ipswich 001B,E01030033,1156,799,357,263,27,67
2011,Ipswich 001C,E01030034,1047,713,334,248,22,64
2011,Ipswich 001D,E01030035,1248,843,405,140,59,206
2011,Ipswich 001E,E01030036,1196,734,462,212,63,187
2011,Ipswich 002A,E01029973,1073,758,315,222,27,66
2011,Ipswich 002B,E01029974,1147,897,250,135,43,72
2011,Ipswich 002C,E01029975,882,658,224,124,30,70
2011,Ipswich 002D,E01029976,1113,806,307,174,28,105
2011,Ipswich 002E,E01029977,1116,831,285,190,30,65
2011,Ipswich 003A,E01030027,1611,1303,308,116,48,144
2011,Ipswich 003B,E01030028,1206,877,329,139,38,152
2011,Ipswich 003C,E01030029,1161,786,375,168,47,160
2011,Ipswich 003D,E01030030,1498,1190,308,125,38,145
2011,Ipswich 003E,E01030031,1024,682,342,113,54,175
2011,Ipswich 004A,E01029997,1072,813,259,137,30,92
2011,Ipswich 004B,E01029998,1227,811,416,160,71,185
2011,Ipswich 004C,E01029999,1177,890,287,137,63,87
2011,Ipswich 004D,E01030000,1151,908,243,129,45,69
2011,Ipswich 004E,E01030001,1093,726,367,202,45,120
2011,Ipswich 005A,E01030007,1153,889,264,105,58,101
2011,Ipswich 005B,E01030008,898,645,253,145,51,57
2011,Ipswich 005C,E01030009,944,695,249,132,60,57
2011,Ipswich 005D,E01030010,1371,1031,340,150,39,151
2011,Ipswich 005E,E01030011,1092,758,334,220,46,68
2011,Ipswich 006A,E01030022,1670,1345,325,96,46,183
2011,Ipswich 006B,E01030023,1429,1132,297,73,43,181
2011,Ipswich 006C,E01030024,1940,1466,474,123,107,244
2011,Ipswich 006D,E01030025,1396,1020,376,125,65,186
2011,Ipswich 006E,E01030026,1241,942,299,89,45,165
2011,Ipswich 007A,E01029958,1067,816,251,123,22,106
2011,Ipswich 007C,E01029960,1385,1101,284,113,70,101
2011,Ipswich 007D,E01029961,1077,862,215,74,44,97
2011,Ipswich 007E,E01029962,1239,992,247,77,43,127
2011,Ipswich 007F,E01033124,1039,743,296,37,209,50
2011,Ipswich 007G,E01033125,870,681,189,64,19,106
2011,Ipswich 007H,E01033129,1030,753,277,46,75,156
2011,Ipswich 008A,E01030002,1349,1035,314,183,34,97
2011,Ipswich 008B,E01030003,1237,959,278,136,43,99
2011,Ipswich 008C,E01030004,978,735,243,125,52,66
2011,Ipswich 008D,E01030005,1647,1285,362,116,60,186
2011,Ipswich 008E,E01030006,1255,966,289,144,48,97
2011,Ipswich 009A,E01029963,1063,738,325,221,44,60
2011,Ipswich 009B,E01029964,962,749,213,102,26,85
2011,Ipswich 009C,E01029965,1005,730,275,182,22,71
2011,Ipswich 009D,E01029966,1003,697,306,198,38,70
2011,Ipswich 009E,E01029967,834,534,300,227,32,41
2011,Ipswich 010A,E01029984,1114,793,321,97,49,175
2011,Ipswich 010B,E01029985,1863,1440,423,155,60,208
2011,Ipswich 010C,E01029986,1032,723,309,89,46,174
2011,Ipswich 010D,E01029987,1048,705,343,134,42,167
2011,Ipswich 010E,E01029988,1459,1088,371,119,45,207
2011,Ipswich 011B,E01029990,1211,966,245,84,47,114
2011,Ipswich 011C,E01029991,1253,916,337,225,32,80
2011,Ipswich 011D,E01029992,969,762,207,101,34,72
2011,Ipswich 011E,E01033123,1411,1103,308,112,45,151
2011,Ipswich 011F,E01033126,1219,1069,150,27,26,97
2011,Ipswich 012A,E01029968,1135,888,247,79,50,118
2011,Ipswich 012B,E01029969,1016,742,274,111,40,123
2011,Ipswich 012C,E01029970,1342,1003,339,169,34,136
2011,Ipswich 012D,E01029971,1020,708,312,135,23,154
2011,Ipswich 012F,E01033122,1053,797,256,39,49,168
2011,Ipswich 012G,E01033130,868,661,207,70,22,115
2011,Ipswich 013A,E01030012,813,477,336,165,20,151
2011,Ipswich 013B,E01030013,918,615,303,122,24,157
2011,Ipswich 013C,E01030014,916,622,294,145,33,116
2011,Ipswich 013D,E01030015,1006,743,263,190,20,53
2011,Ipswich 013E,E01030016,1127,818,309,179,30,100
2011,Ipswich 014B,E01029994,1067,641,426,117,58,251
2011,Ipswich 014C,E01029995,1235,954,281,161,29,91
2011,Ipswich 014D,E01029996,1206,841,365,134,56,175
2011,Ipswich 014E,E01033127,1099,858,241,52,39,150
2011,Ipswich 014F,E01033128,849,668,181,58,32,91
2011,Ipswich 014G,E01033131,1006,705,301,70,57,174
2011,Ipswich 015A,E01030017,1016,687,329,164,33,132
2011,Ipswich 015B,E01030018,1077,738,339,111,36,192
2011,Ipswich 015C,E01030019,1119,810,309,167,53,89
2011,Ipswich 015D,E01030020,1135,798,337,202,42,93
2011,Ipswich 015E,E01030021,1021,705,316,117,19,180
2011,Ipswich 016A,E01029978,972,709,263,123,36,104
2011,Ipswich 016B,E01029979,1067,686,381,136,47,198
2011,Ipswich 016C,E01029980,1114,745,369,106,38,225
2011,Ipswich 016D,E01029981,870,659,211,110,24,77
2011,Ipswich 016E,E01029982,990,684,306,109,38,159
2011,Ipswich 016F,E01029983,1160,883,277,148,30,99
2011,Mid Suffolk 001A,E01030052,1542,1001,541,337,61,143
2011,Mid Suffolk 001B,E01030058,1501,1028,473,309,46,118
2011,Mid Suffolk 001C,E01030064,1693,1147,546,332,44,170
2011,Mid Suffolk 001D,E01030088,880,607,273,176,39,58
2011,Mid Suffolk 002A,E01030039,1070,757,313,211,32,70
2011,Mid Suffolk 002B,E01030054,939,623,316,213,31,72
2011,Mid Suffolk 002C,E01030055,1043,759,284,183,30,71
2011,Mid Suffolk 002D,E01030066,1116,751,365,246,39,80
2011,Mid Suffolk 002E,E01030067,911,640,271,172,33,66
2011,Mid Suffolk 002F,E01030068,1254,916,338,193,47,98
2011,Mid Suffolk 003A,E01030053,1696,1142,554,380,37,137
2011,Mid Suffolk 003B,E01030082,1789,1251,538,355,65,118
2011,Mid Suffolk 003C,E01030090,1815,1253,562,337,75,150
2011,Mid Suffolk 004A,E01030040,896,630,266,167,29,70
2011,Mid Suffolk 004B,E01030049,1207,844,363,217,43,103
2011,Mid Suffolk 004C,E01030050,1495,1212,283,176,40,67
2011,Mid Suffolk 004D,E01030084,1159,838,321,236,26,59
2011,Mid Suffolk 004E,E01030085,1143,906,237,153,26,58
2011,Mid Suffolk 005A,E01030037,884,629,255,172,22,61
2011,Mid Suffolk 005B,E01030038,895,634,261,166,28,67
2011,Mid Suffolk 005C,E01030059,1690,1166,524,330,60,134
2011,Mid Suffolk 005D,E01030081,1650,1122,528,363,33,132
2011,Mid Suffolk 006A,E01030051,1216,841,375,255,34,86
2011,Mid Suffolk 006B,E01030056,1554,1083,471,308,40,123
2011,Mid Suffolk 006C,E01030065,1514,1059,455,308,30,117
2011,Mid Suffolk 006D,E01030086,846,614,232,138,31,63
2011,Mid Suffolk 006E,E01030089,1448,1006,442,287,49,106
2011,Mid Suffolk 007A,E01030048,1619,1120,499,313,56,130
2011,Mid Suffolk 007B,E01030057,1684,1242,442,248,58,136
2011,Mid Suffolk 007C,E01030083,1718,1235,483,291,71,121
2011,Mid Suffolk 007D,E01030087,967,694,273,153,48,72
2011,Mid Suffolk 008A,E01030073,961,627,334,234,12,88
2011,Mid Suffolk 008B,E01030077,934,623,311,165,26,120
2011,Mid Suffolk 008C,E01030079,1105,709,396,128,48,220
2011,Mid Suffolk 008D,E01030080,1161,819,342,207,31,104
2011,Mid Suffolk 009A,E01030063,1591,1156,435,266,45,124
2011,Mid Suffolk 009B,E01030069,1015,725,290,188,36,66
2011,Mid Suffolk 009C,E01030072,1138,843,295,212,22,61
2011,Mid Suffolk 009D,E01030075,1213,988,225,117,35,73
2011,Mid Suffolk 010A,E01030060,1183,915,268,160,26,82
2011,Mid Suffolk 010B,E01030071,1069,853,216,148,22,46
2011,Mid Suffolk 010D,E01030076,1108,829,279,147,29,103
2011,Mid Suffolk 010E,E01030078,1309,1033,276,177,35,64
2011,Mid Suffolk 010F,E01033316,1150,971,179,66,27,86
2011,Mid Suffolk 010G,E01033317,1137,935,202,92,34,76
2011,Mid Suffolk 010H,E01033319,1380,1131,249,119,41,89
2011,Mid Suffolk 011A,E01030041,1630,1138,492,333,39,120
2011,Mid Suffolk 011B,E01030043,953,736,217,142,20,55
2011,Mid Suffolk 011C,E01030061,1047,729,318,210,17,91
2011,Mid Suffolk 011D,E01030062,1003,709,294,206,28,60
2011,Mid Suffolk 011E,E01030070,1782,1517,265,123,23,119
2011,Mid Suffolk 012A,E01030042,1174,816,358,266,26,66
2011,Mid Suffolk 012B,E01030044,833,554,279,191,18,70
2011,Mid Suffolk 012C,E01030045,1251,931,320,218,33,69
2011,Mid Suffolk 012D,E01030046,1170,827,343,236,34,73
2011,Mid Suffolk 012E,E01030047,942,743,199,117,25,57
2011,St Edmundsbury 001A,E01030095,874,630,244,161,28,55
2011,St Edmundsbury 001B,E01030096,1084,752,332,208,36,88
2011,St Edmundsbury 001C,E01030097,864,588,276,187,21,68
2011,St Edmundsbury 001D,E01030145,1006,768,238,150,34,54
2011,St Edmundsbury 001E,E01030146,748,418,330,252,13,65
2011,St Edmundsbury 002A,E01030094,1018,740,278,162,49,67
2011,St Edmundsbury 002B,E01030121,1619,1211,408,239,51,118
2011,St Edmundsbury 002C,E01030132,1560,1392,168,64,23,81
2011,St Edmundsbury 002D,E01030133,1087,796,291,169,28,94
2011,St Edmundsbury 003A,E01030130,894,646,248,138,31,79
2011,St Edmundsbury 003B,E01030131,838,615,223,76,28,119
2011,St Edmundsbury 003C,E01030139,1217,839,378,161,56,161
2011,St Edmundsbury 003D,E01030140,953,715,238,134,22,82
2011,St Edmundsbury 003E,E01030141,1156,862,294,155,38,101
2011,St Edmundsbury 004A,E01030103,1435,986,449,331,30,88
2011,St Edmundsbury 004B,E01030104,1557,1067,490,353,41,96
2011,St Edmundsbury 004C,E01030138,1712,1214,498,314,55,129
2011,St Edmundsbury 005B,E01030127,964,800,164,94,32,38
2011,St Edmundsbury 005C,E01030128,1139,993,146,75,24,47
2011,St Edmundsbury 005D,E01030129,1095,848,247,172,36,39
2011,St Edmundsbury 005E,E01033044,1000,858,142,30,40,72
2011,St Edmundsbury 005F,E01033045,762,639,123,46,22,55
2011,St Edmundsbury 005G,E01033050,967,775,192,84,36,72
2011,St Edmundsbury 006A,E01030091,1358,1000,358,216,35,107
2011,St Edmundsbury 006B,E01030093,1171,877,294,175,41,78
2011,St Edmundsbury 006D,E01030137,1242,1021,221,124,31,66
2011,St Edmundsbury 006E,E01033043,887,703,184,101,23,60
2011,St Edmundsbury 006F,E01033046,890,698,192,80,14,98
2011,St Edmundsbury 006G,E01033047,863,680,183,90,30,63
2011,St Edmundsbury 007A,E01030092,1246,884,362,182,45,135
2011,St Edmundsbury 007B,E01030123,1130,818,312,157,46,109
2011,St Edmundsbury 007C,E01030124,1106,759,347,263,28,56
2011,St Edmundsbury 007D,E01030125,1099,788,311,201,34,76
2011,St Edmundsbury 007E,E01030148,920,683,237,180,21,36
2011,St Edmundsbury 007F,E01030149,1066,775,291,215,22,54
2011,St Edmundsbury 008A,E01030098,1612,1145,467,319,48,100
2011,St Edmundsbury 008B,E01030100,1522,1051,471,327,45,99
2011,St Edmundsbury 008C,E01030119,1626,1187,439,314,38,87
2011,St Edmundsbury 008D,E01030134,820,632,188,127,24,37
2011,St Edmundsbury 008E,E01030135,1030,707,323,174,101,48
2011,St Edmundsbury 009B,E01030142,1270,864,406,307,37,62
2011,St Edmundsbury 009C,E01030143,1172,933,239,141,21,77
2011,St Edmundsbury 009D,E01030144,894,646,248,190,16,42
2011,St Edmundsbury 009E,E01030147,1030,656,374,284,19,71
2011,St Edmundsbury 009F,E01033048,898,661,237,114,27,96
2011,St Edmundsbury 009G,E01033049,815,615,200,137,22,41
2011,St Edmundsbury 010A,E01030099,1450,971,479,338,44,97
2011,St Edmundsbury 010B,E01030101,1420,947,473,332,37,104
2011,St Edmundsbury 010C,E01030150,1622,1162,460,313,43,104
2011,St Edmundsbury 011A,E01030120,2451,1349,1102,360,73,669
2011,St Edmundsbury 011B,E01030122,1436,995,441,314,33,94
2011,St Edmundsbury 011C,E01030151,1749,1128,621,245,56,320
2011,St Edmundsbury 012A,E01030109,1228,861,367,186,44,137
2011,St Edmundsbury 012B,E01030110,1980,1451,529,261,72,196
2011,St Edmundsbury 012C,E01030111,1040,770,270,163,42,65
2011,St Edmundsbury 012D,E01030112,1341,994,347,204,40,103
2011,St Edmundsbury 013A,E01030115,1673,1259,414,176,60,178
2011,St Edmundsbury 013B,E01030116,1613,1296,317,169,58,90
2011,St Edmundsbury 013C,E01030117,1226,1000,226,124,29,73
2011,St Edmundsbury 013D,E01030118,1205,920,285,121,50,114
2011,St Edmundsbury 014A,E01030105,1385,1099,286,135,39,112
2011,St Edmundsbury 014B,E01030106,1801,1391,410,161,72,177
2011,St Edmundsbury 014C,E01030107,1243,939,304,205,26,73
2011,St Edmundsbury 014D,E01030108,1389,1013,376,165,55,156
2011,St Edmundsbury 014E,E01030113,1372,1018,354,206,50,98
2011,St Edmundsbury 014F,E01030114,1128,826,302,100,57,145
2011,Suffolk Coastal 001A,E01030201,1573,1103,470,294,44,132
2011,Suffolk Coastal 001B,E01030219,1411,922,489,352,44,93
2011,Suffolk Coastal 001C,E01030222,1352,794,558,403,31,124
2011,Suffolk Coastal 002A,E01030154,1542,1057,485,315,62,108
2011,Suffolk Coastal 002B,E01030172,1128,799,329,195,35,99
2011,Suffolk Coastal 002C,E01030173,1100,659,441,225,150,66
2011,Suffolk Coastal 002D,E01030174,1000,717,283,160,46,77
2011,Suffolk Coastal 002E,E01030176,1464,1023,441,270,53,118
2011,Suffolk Coastal 003A,E01030186,1027,661,366,234,29,103
2011,Suffolk Coastal 003B,E01030208,929,558,371,250,30,91
2011,Suffolk Coastal 003C,E01030209,1037,688,349,241,16,92
2011,Suffolk Coastal 003D,E01030210,1475,967,508,282,45,181
2011,Suffolk Coastal 003E,E01030212,1423,955,468,323,26,119
2011,Suffolk Coastal 004A,E01030152,1263,689,574,467,16,91
2011,Suffolk Coastal 004B,E01030153,868,599,269,189,10,70
2011,Suffolk Coastal 004C,E01030187,1094,742,352,200,36,116
2011,Suffolk Coastal 004D,E01030188,1216,883,333,186,30,117
2011,Suffolk Coastal 004E,E01030189,1197,855,342,196,44,102
2011,Suffolk Coastal 005A,E01030193,1198,807,391,248,54,89
2011,Suffolk Coastal 005B,E01030194,1131,805,326,193,39,94
2011,Suffolk Coastal 005C,E01030195,1200,825,375,254,46,75
2011,Suffolk Coastal 005D,E01030220,1475,969,506,320,50,136
2011,Suffolk Coastal 006A,E01030175,1609,1085,524,349,58,117
2011,Suffolk Coastal 006B,E01030200,1667,1133,534,334,76,124
2011,Suffolk Coastal 006C,E01030221,1477,1021,456,307,40,109
2011,Suffolk Coastal 007C,E01030199,1347,918,429,284,45,100
2011,Suffolk Coastal 007F,E01033443,1338,1104,234,122,22,90
2011,Suffolk Coastal 007G,E01033445,1220,959,261,137,40,84
2011,Suffolk Coastal 007H,E01033446,1997,1181,816,347,49,420
2011,Suffolk Coastal 007I,E01033448,907,627,280,173,31,76
2011,Suffolk Coastal 007J,E01033449,1212,926,286,150,41,95
2011,Suffolk Coastal 008A,E01030155,1478,1016,462,265,78,119
2011,Suffolk Coastal 008B,E01030185,1365,908,457,245,55,157
2011,Suffolk Coastal 008C,E01030203,1168,716,452,323,40,89
2011,Suffolk Coastal 008D,E01030211,1319,882,437,301,37,99
2011,Suffolk Coastal 009A,E01030179,1820,1486,334,164,48,122
2011,Suffolk Coastal 009B,E01030180,997,755,242,146,35,61
2011,Suffolk Coastal 009C,E01030183,1383,896,487,380,27,80
2011,Suffolk Coastal 009D,E01030184,1179,767,412,271,37,104
2011,Suffolk Coastal 009E,E01030207,1050,685,365,268,28,69
2011,Suffolk Coastal 010A,E01030181,1409,1139,270,124,55,91
2011,Suffolk Coastal 010C,E01030190,1295,755,540,415,37,88
2011,Suffolk Coastal 010D,E01030191,1181,846,335,205,30,100
2011,Suffolk Coastal 010E,E01030192,1135,826,309,209,35,65
2011,Suffolk Coastal 010F,E01030198,953,650,303,203,27,73
2011,Suffolk Coastal 010G,E01033442,1080,947,133,45,31,57
2011,Suffolk Coastal 010H,E01033444,1007,893,114,33,32,49
2011,Suffolk Coastal 010I,E01033447,988,710,278,194,22,62
2011,Suffolk Coastal 011A,E01030196,1263,991,272,140,43,89
2011,Suffolk Coastal 011B,E01030197,1149,760,389,279,43,67
2011,Suffolk Coastal 011C,E01030204,1285,931,354,265,36,53
2011,Suffolk Coastal 011D,E01030205,946,781,165,79,40,46
2011,Suffolk Coastal 011E,E01030206,1060,703,357,262,36,59
2011,Suffolk Coastal 012A,E01030171,1432,1067,365,221,38,106
2011,Suffolk Coastal 012B,E01030214,1020,803,217,112,35,70
2011,Suffolk Coastal 012C,E01030215,979,679,300,160,26,114
2011,Suffolk Coastal 012D,E01030216,1098,766,332,239,22,71
2011,Suffolk Coastal 012E,E01030217,996,676,320,220,28,72
2011,Suffolk Coastal 012F,E01030218,1096,815,281,176,18,87
2011,Suffolk Coastal 013C,E01030158,1028,569,459,388,24,47
2011,Suffolk Coastal 013D,E01030159,1056,737,319,226,32,61
2011,Suffolk Coastal 013E,E01030164,1061,697,364,262,46,56
2011,Suffolk Coastal 013F,E01030166,1019,618,401,317,25,59
2011,Suffolk Coastal 013G,E01033450,1647,1002,645,497,45,103
2011,Suffolk Coastal 014A,E01030160,987,674,313,191,17,105
2011,Suffolk Coastal 014B,E01030161,987,701,286,143,26,117
2011,Suffolk Coastal 014C,E01030168,1026,669,357,163,47,147
2011,Suffolk Coastal 014D,E01030169,1163,876,287,111,31,145
2011,Suffolk Coastal 014E,E01030170,1153,712,441,216,41,184
2011,Suffolk Coastal 015A,E01030162,948,659,289,163,23,103
2011,Suffolk Coastal 015B,E01030163,1143,792,351,181,25,145
2011,Suffolk Coastal 015C,E01030165,1120,794,326,183,41,102
2011,Suffolk Coastal 015D,E01030167,904,626,278,176,37,65
2011,Waveney 001A,E01030240,1138,669,469,342,28,99
2011,Waveney 001B,E01030241,1080,641,439,326,19,94
2011,Waveney 001C,E01030242,1034,640,394,281,35,78
2011,Waveney 001D,E01030259,843,599,244,147,25,72
2011,Waveney 001E,E01030260,1201,619,582,116,30,436
2011,Waveney 002A,E01030261,984,567,417,135,58,224
2011,Waveney 002B,E01030262,845,561,284,148,24,112
2011,Waveney 002C,E01030277,822,487,335,134,46,155
2011,Waveney 002D,E01030279,972,562,410,158,39,213
2011,Waveney 002E,E01030281,1720,1214,506,265,46,195
2011,Waveney 003A,E01030266,1158,742,416,238,44,134
2011,Waveney 003B,E01030267,981,651,330,202,33,95
2011,Waveney 003C,E01030271,1039,598,441,356,19,66
2011,Waveney 003D,E01030278,1091,573,518,343,34,141
2011,Waveney 003E,E01030280,999,658,341,270,19,52
2011,Waveney 004A,E01030246,1017,711,306,132,43,131
2011,Waveney 004B,E01030248,1083,754,329,141,47,141
2011,Waveney 004C,E01030249,1216,832,384,136,56,192
2011,Waveney 004D,E01030250,1326,879,447,135,52,260
2011,Waveney 004E,E01030264,994,681,313,134,30,149
2011,Waveney 004F,E01030265,1057,727,330,132,48,150
2011,Waveney 005A,E01030255,984,666,318,138,35,145
2011,Waveney 005B,E01030263,970,584,386,255,16,115
2011,Waveney 005C,E01030270,1055,697,358,209,35,114
2011,Waveney 005D,E01030289,1042,666,376,204,27,145
2011,Waveney 005E,E01030290,1038,601,437,293,29,115
2011,Waveney 006A,E01030233,1126,764,362,276,19,67
2011,Waveney 006B,E01030235,1028,660,368,260,25,83
2011,Waveney 006C,E01030268,983,666,317,202,33,82
2011,Waveney 006D,E01030269,1136,757,379,276,32,71
2011,Waveney 006E,E01030288,1028,602,426,334,26,66
2011,Waveney 007A,E01030247,1053,635,418,152,31,235
2011,Waveney 007B,E01030254,1063,753,310,112,41,157
2011,Waveney 007C,E01030256,1090,715,375,140,43,192
2011,Waveney 007D,E01030258,1150,720,430,151,42,237
2011,Waveney 007E,E01030276,894,631,263,148,18,97
2011,Waveney 008A,E01030257,1055,721,334,169,34,131
2011,Waveney 008B,E01030274,798,427,371,237,28,106
2011,Waveney 008C,E01030275,859,576,283,176,34,73
2011,Waveney 008D,E01030287,963,527,436,275,29,132
2011,Waveney 008E,E01030291,992,584,408,174,42,192
2011,Waveney 009A,E01030234,1128,827,301,93,37,171
2011,Waveney 009B,E01030236,1235,800,435,266,30,139
2011,Waveney 009C,E01030237,2064,1529,535,334,62,139
2011,Waveney 009D,E01030238,1365,1009,356,213,41,102
2011,Waveney 010A,E01030223,1190,753,437,264,39,134
2011,Waveney 010B,E01030224,1077,665,412,280,37,95
2011,Waveney 010C,E01030225,1153,806,347,189,35,123
2011,Waveney 010D,E01030227,971,576,395,194,29,172
2011,Waveney 010E,E01030228,1227,796,431,303,31,97
2011,Waveney 011A,E01030226,1346,964,382,200,40,142
2011,Waveney 011B,E01030286,1658,1167,491,320,34,137
2011,Waveney 011C,E01030292,1050,704,346,254,27,65
2011,Waveney 011D,E01030293,1206,814,392,278,42,72
2011,Waveney 011E,E01030294,1036,732,304,196,34,74
2011,Waveney 012A,E01030239,1444,1153,291,129,48,114
2011,Waveney 012B,E01030251,1154,732,422,280,22,120
2011,Waveney 012C,E01030252,1235,723,512,367,24,121
2011,Waveney 012D,E01030253,1252,815,437,233,44,160
2011,Waveney 012E,E01030272,1066,629,437,321,23,93
2011,Waveney 012F,E01030273,1104,598,506,393,22,91
2011,Waveney 013A,E01030230,1267,891,376,230,38,108
2011,Waveney 013B,E01030231,1085,755,330,169,36,125
2011,Waveney 013C,E01030232,1161,812,349,215,35,99
2011,Waveney 013D,E01030285,1650,1163,487,301,77,109
2011,Waveney 014A,E01030282,711,407,304,234,13,57
2011,Waveney 014B,E01030283,911,611,300,154,65,81
2011,Waveney 014C,E01030284,801,459,342,284,21,37
2011,Waveney 014D,E01030295,1664,1126,538,333,52,153
2011,Waveney 015A,E01030229,1531,1005,526,344,41,141
2011,Waveney 015B,E01030243,1030,704,326,206,31,89
2011,Waveney 015C,E01030244,1137,724,413,284,27,102
2011,Waveney 015D,E01030245,1061,694,367,277,26,64
2011,Camden 001A,E01000907,1062,719,343,80,89,174
2011,Camden 001B,E01000908,1184,833,351,125,58,168
2011,Camden 001C,E01000909,1253,886,367,142,89,136
2011,Camden 001D,E01000912,1235,848,387,113,111,163
2011,Camden 001E,E01000913,1286,963,323,135,80,108
2011,Camden 002A,E01000893,1194,936,258,89,75,94
2011,Camden 002B,E01000894,1034,799,235,90,51,94
2011,Camden 002C,E01000895,1201,925,276,95,59,122
2011,Camden 002D,E01000896,1255,951,304,101,70,133
2011,Camden 002E,E01000899,1201,848,353,131,66,156
2011,Camden 003A,E01000910,1133,853,280,111,78,91
2011,Camden 003B,E01000911,1133,814,319,97,81,141
2011,Camden 003C,E01000921,1662,1326,336,81,114,141
2011,Camden 003D,E01000923,1179,863,316,84,93,139
2011,Camden 003E,E01000928,1264,900,364,109,93,162
2011,Camden 004A,E01000878,1289,739,550,91,319,140
2011,Camden 004B,E01000879,1119,795,324,83,116,125
2011,Camden 004C,E01000880,1104,819,285,70,80,135
2011,Camden 004D,E01000884,1056,743,313,75,95,143
2011,Camden 004E,E01000885,1018,688,330,131,62,137
2011,Camden 005A,E01000871,1267,933,334,99,92,143
2011,Camden 005B,E01000872,1623,1270,353,74,109,170
2011,Camden 005C,E01000873,1317,1053,264,99,68,97
2011,Camden 005D,E01000874,1245,984,261,95,90,76
2011,Camden 005E,E01000877,1296,1033,263,76,68,119
2011,Camden 006A,E01000886,1112,841,271,101,78,92
2011,Camden 006B,E01000887,1190,944,246,75,72,99
2011,Camden 006C,E01000888,1204,877,327,83,115,129
2011,Camden 006D,E01000892,1372,998,374,118,99,157
2011,Camden 006E,E01000903,1148,832,316,91,97,128
2011,Camden 007A,E01000889,1216,764,452,98,110,244
2011,Camden 007B,E01000890,1186,679,507,135,103,269
2011,Camden 007C,E01000891,1138,638,500,103,142,255
2011,Camden 007D,E01000901,1418,806,612,79,264,269
2011,Camden 007E,E01000922,1260,820,440,74,229,137
2011,Camden 007F,E01000927,1419,1055,364,89,109,166
2011,Camden 008A,E01000881,1162,842,320,61,142,117
2011,Camden 008B,E01000882,1198,980,218,68,52,98
2011,Camden 008C,E01000883,1065,761,304,66,118,120
2011,Camden 008D,E01000897,1161,901,260,87,64,109
2011,Camden 008E,E01000898,1377,1039,338,111,82,145
2011,Camden 009A,E01000866,1606,1140,466,120,147,199
2011,Camden 009B,E01000870,1357,955,402,93,121,188
2011,Camden 009C,E01000924,1382,1050,332,103,103,126
2011,Camden 009D,E01000925,1084,679,405,84,131,190
2011,Camden 009E,E01000926,1490,1152,338,56,144,138
2011,Camden 010A,E01000969,1720,1430,290,85,96,109
2011,Camden 010B,E01000970,1331,1140,191,53,56,82
2011,Camden 010C,E01000971,1177,945,232,82,60,90
2011,Camden 010D,E01000972,1611,1096,515,109,140,266
2011,Camden 010E,E01000973,1613,1247,366,82,126,158
2011,Camden 011A,E01000842,1175,887,288,100,74,114
2011,Camden 011B,E01000844,1408,1125,283,74,63,146
2011,Camden 011C,E01000848,1273,1050,223,81,44,98
2011,Camden 011D,E01000849,1274,1020,254,86,75,93
2011,Camden 012A,E01000900,1400,985,415,110,117,188
2011,Camden 012B,E01000902,1026,630,396,74,111,211
2011,Camden 012C,E01000904,1640,1139,501,137,142,222
2011,Camden 012D,E01000905,1392,804,588,141,145,302
2011,Camden 012E,E01000906,1246,989,257,81,83,93
2011,Camden 013A,E01000875,1394,1047,347,72,135,140
2011,Camden 013B,E01000876,1359,942,417,108,114,195
2011,Camden 013C,E01000931,1494,1022,472,123,124,225
2011,Camden 013D,E01000932,1605,1282,323,87,68,168
2011,Camden 013E,E01000974,1414,1033,381,78,129,174
2011,Camden 014A,E01000843,1299,983,316,81,82,153
2011,Camden 014B,E01000845,1166,887,279,82,85,112
2011,Camden 014C,E01000846,1027,655,372,100,94,178
2011,Camden 014D,E01000847,1171,785,386,79,104,203
2011,Camden 015A,E01000864,1276,946,330,60,147,123
2011,Camden 015B,E01000865,1330,713,617,63,490,64
2011,Camden 015C,E01000867,1225,772,453,80,171,202
2011,Camden 015D,E01000868,1014,700,314,52,74,188
2011,Camden 015E,E01000869,1733,1254,479,112,199,168
2011,Camden 016A,E01000962,1330,1131,199,56,70,73
2011,Camden 016B,E01000964,1220,896,324,78,101,145
2011,Camden 016C,E01000965,1243,964,279,78,88,113
2011,Camden 016D,E01000966,1237,1019,218,64,63,91
2011,Camden 016E,E01000968,1275,1013,262,85,55,122
2011,Camden 017A,E01000960,1380,1007,373,102,110,161
2011,Camden 017B,E01000961,1123,707,416,81,122,213
2011,Camden 017C,E01000963,1416,896,520,99,173,248
2011,Camden 017D,E01000967,1031,716,315,90,70,155
2011,Camden 018A,E01000857,1122,801,321,113,66,142
2011,Camden 018B,E01000858,1457,904,553,100,172,281
2011,Camden 018C,E01000859,1289,1034,255,107,47,101
2011,Camden 018D,E01000860,1039,687,352,164,66,122
2011,Camden 018E,E01000862,1360,1055,305,93,106,106
2011,Camden 019A,E01000856,1246,839,407,70,140,197
2011,Camden 019B,E01000861,1339,914,425,59,231,135
2011,Camden 019C,E01000957,1379,927,452,83,168,201
2011,Camden 019D,E01000958,1820,1105,715,58,398,259
2011,Camden 019E,E01000959,1252,685,567,104,228,235
2011,Camden 020A,E01000929,1188,738,450,121,91,238
2011,Camden 020B,E01000930,1415,912,503,167,122,214
2011,Camden 020C,E01000933,1414,1119,295,93,77,125
2011,Camden 020D,E01000934,1178,755,423,109,121,193
2011,Camden 020E,E01000935,1000,676,324,69,85,170
2011,Camden 021A,E01000863,1290,984,306,43,133,130
2011,Camden 021B,E01000946,1199,798,401,87,174,140
2011,Camden 021C,E01000947,1715,1131,584,56,292,236
2011,Camden 021D,E01000948,1380,955,425,116,140,169
2011,Camden 022A,E01000952,1318,750,568,98,268,202
2011,Camden 022B,E01000953,1256,672,584,135,194,255
2011,Camden 022C,E01000954,1097,626,471,67,157,247
2011,Camden 022D,E01000955,1141,607,534,85,242,207
2011,Camden 022E,E01000956,1150,680,470,47,232,191
2011,Camden 023A,E01000944,1552,662,890,60,632,198
2011,Camden 023B,E01000945,1509,763,746,73,554,119
2011,Camden 023C,E01000949,1201,827,374,87,146,141
2011,Camden 023D,E01000950,1041,583,458,52,169,237
2011,Camden 023E,E01000951,1106,593,513,76,251,186
2011,Camden 024A,E01000936,1469,715,754,71,546,137
2011,Camden 024B,E01000938,1354,904,450,64,254,132
2011,Camden 024C,E01000939,897,475,422,76,192,154
2011,Camden 024D,E01000940,875,467,408,78,219,111
2011,Camden 025A,E01000853,1231,733,498,161,180,157
2011,Camden 025B,E01000937,1322,600,722,32,603,87
2011,Camden 025C,E01000941,933,553,380,66,104,210
2011,Camden 025D,E01000942,1957,793,1164,62,1017,85
2011,Camden 025E,E01000943,923,554,369,47,246,76
2011,Camden 026A,E01000850,1548,989,559,64,404,91
2011,Camden 026B,E01000851,2206,1119,1087,59,928,100
2011,Camden 026C,E01000852,1475,574,901,77,744,80
2011,Camden 026D,E01000854,1559,750,809,70,604,135
2011,Camden 027A,E01000915,1158,770,388,94,114,180
2011,Camden 027B,E01000916,1492,1041,451,85,224,142
2011,Camden 027C,E01000917,1415,864,551,111,161,279
2011,Camden 027D,E01000920,1619,1169,450,98,194,158
2011,Camden 028A,E01000855,1623,1180,443,132,222,89
2011,Camden 028B,E01000914,1524,1015,509,75,308,126
2011,Camden 028C,E01000918,1800,1139,661,120,296,245
2011,Camden 028D,E01000919,1797,1080,717,98,444,175
2011,City of London 001A,E01000001,1221,964,257,152,45,60
2011,City of London 001B,E01000002,1196,926,270,171,48,51
2011,City of London 001C,E01000003,1102,822,280,117,89,74
2011,City of London 001E,E01000005,773,530,243,74,53,116
2011,City of London 001F,E01032739,971,843,128,24,58,46
2011,City of London 001G,E01032740,1044,887,157,42,70,45
2011,Hackney 001A,E01001808,1129,719,410,54,166,190
2011,Hackney 001B,E01001809,1205,761,444,79,159,206
2011,Hackney 001C,E01001814,1113,775,338,51,124,163
2011,Hackney 001D,E01001823,1087,686,401,52,124,225
2011,Hackney 001E,E01001825,895,521,374,44,144,186
2011,Hackney 002A,E01001714,1149,744,405,83,121,201
2011,Hackney 002D,E01001811,1080,666,414,71,101,242
2011,Hackney 002E,E01001813,943,579,364,60,129,175
2011,Hackney 002F,E01033701,1428,808,620,107,181,332
2011,Hackney 003A,E01001799,962,641,321,48,123,150
2011,Hackney 003B,E01001802,855,544,311,50,98,163
2011,Hackney 003C,E01001804,953,585,368,60,110,198
2011,Hackney 003D,E01001807,1275,898,377,72,119,186
2011,Hackney 003E,E01001812,1138,704,434,76,143,215
2011,Hackney 004A,E01001725,1174,735,439,84,133,222
2011,Hackney 004B,E01001726,926,620,306,36,93,177
2011,Hackney 004C,E01001800,1033,626,407,58,115,234
2011,Hackney 004D,E01001824,932,566,366,52,125,189
2011,Hackney 004E,E01001826,1082,676,406,53,119,234
2011,Hackney 006A,E01001723,1473,1094,379,71,123,185
2011,Hackney 006B,E01001724,1817,1468,349,61,99,189
2011,Hackney 006C,E01001727,1242,848,394,69,131,194
2011,Hackney 006D,E01001768,1493,1132,361,84,95,182
2011,Hackney 006E,E01001769,1310,1015,295,70,83,142
2011,Hackney 007A,E01001715,1192,1019,173,34,59,80
2011,Hackney 007B,E01001716,1090,809,281,47,88,146
2011,Hackney 007C,E01001717,932,639,293,45,111,137
2011,Hackney 007D,E01001718,1597,1341,256,43,131,82
2011,Hackney 007E,E01001719,873,598,275,76,76,123
2011,Hackney 007F,E01001720,1526,1296,230,59,90,81
2011,Hackney 008A,E01001742,1416,1039,377,78,112,187
2011,Hackney 008B,E01001801,1006,655,351,56,130,165
2011,Hackney 008C,E01001803,1340,1017,323,74,100,149
2011,Hackney 008D,E01001806,1209,873,336,89,77,170
2011,Hackney 009A,E01001741,1149,909,240,58,63,119
2011,Hackney 009B,E01001805,995,792,203,41,75,87
2011,Hackney 009C,E01001829,1369,1117,252,65,78,109
2011,Hackney 009D,E01001831,1388,1079,309,92,92,125
2011,Hackney 009E,E01001832,1339,1018,321,66,90,165
2011,Hackney 010A,E01001764,1331,953,378,82,118,178
2011,Hackney 010B,E01001765,1211,744,467,105,110,252
2011,Hackney 010D,E01001767,1242,892,350,63,100,187
2011,Hackney 010E,E01001770,1333,868,465,93,111,261
2011,Hackney 010F,E01033703,1114,790,324,59,89,176
2011,Hackney 010G,E01033713,1074,799,275,48,65,162
2011,Hackney 011A,E01001792,1354,922,432,101,108,223
2011,Hackney 011B,E01001793,1345,1031,314,85,88,141
2011,Hackney 011C,E01001794,1470,1071,399,116,108,175
2011,Hackney 011D,E01001795,1166,905,261,49,71,141
2011,Hackney 011E,E01001796,1356,1025,331,55,95,181
2011,Hackney 012A,E01001736,1310,1004,306,61,104,141
2011,Hackney 012B,E01001737,1462,1197,265,72,78,115
2011,Hackney 012C,E01001738,1414,1120,294,62,85,147
2011,Hackney 012D,E01001739,1675,1331,344,88,85,171
2011,Hackney 013A,E01001786,1264,801,463,89,148,226
2011,Hackney 013B,E01001787,1043,587,456,148,96,212
2011,Hackney 013C,E01001788,1067,621,446,113,106,227
2011,Hackney 013D,E01001790,914,580,334,61,90,183
2011,Hackney 014A,E01001740,1138,737,401,84,86,231
2011,Hackney 014B,E01001747,1792,1361,431,92,148,191
2011,Hackney 014C,E01001830,1556,1127,429,107,96,226
2011,Hackney 014D,E01001833,1696,1261,435,55,140,240
2011,Hackney 014E,E01001834,1680,1339,341,64,93,184
2011,Hackney 014F,E01001835,1031,821,210,57,76,77
2011,Hackney 015A,E01001733,1411,1068,343,78,80,185
2011,Hackney 015B,E01001785,1135,776,359,111,87,161
2011,Hackney 015C,E01001789,1343,971,372,97,101,174
2011,Hackney 015D,E01001791,1109,720,389,101,110,178
2011,Hackney 016A,E01001745,1715,1234,481,60,123,298
2011,Hackney 016B,E01001746,1119,733,386,68,110,208
2011,Hackney 016C,E01001757,1262,859,403,77,119,207
2011,Hackney 016D,E01001758,1548,1071,477,88,136,253
2011,Hackney 016E,E01001759,1427,1057,370,93,107,170
2011,Hackney 016F,E01001761,1450,1019,431,106,109,216
2011,Hackney 017A,E01001731,1768,1319,449,50,158,241
2011,Hackney 017B,E01001734,1500,1133,367,88,105,174
2011,Hackney 017C,E01001760,1408,1081,327,72,89,166
2011,Hackney 017D,E01001762,1508,1182,326,63,103,160
2011,Hackney 018A,E01001846,897,583,314,100,71,143
2011,Hackney 018B,E01001847,858,582,276,48,61,167
2011,Hackney 018C,E01001848,1212,793,419,99,99,221
2011,Hackney 018D,E01001849,1799,1304,495,54,150,291
2011,Hackney 019A,E01001729,1474,992,482,56,129,297
2011,Hackney 019B,E01001730,1338,845,493,88,118,287
2011,Hackney 019C,E01001732,1214,818,396,74,110,212
2011,Hackney 019D,E01001735,1229,862,367,118,90,159
2011,Hackney 019E,E01001838,1179,731,448,83,99,266
2011,Hackney 019F,E01001850,1194,770,424,71,108,245
2011,Hackney 020A,E01001748,1968,1555,413,75,149,189
2011,Hackney 020B,E01001749,1411,1145,266,67,79,120
2011,Hackney 020C,E01001763,1312,978,334,97,103,134
2011,Hackney 020D,E01001816,1250,897,353,101,119,133
2011,Hackney 020E,E01001819,1260,923,337,110,81,146
2011,Hackney 021B,E01001744,1467,1060,407,95,106,206
2011,Hackney 021C,E01001750,1504,1092,412,83,152,177
2011,Hackney 021D,E01001751,1318,1109,209,92,57,60
2011,Hackney 021E,E01001756,1856,1510,346,80,119,147
2011,Hackney 021F,E01033698,947,598,349,116,74,159
2011,Hackney 021G,E01033699,1069,885,184,23,66,95
2011,Hackney 021H,E01033700,1361,1102,259,55,75,129
2011,Hackney 021I,E01033707,1136,858,278,70,84,124
2011,Hackney 022A,E01001836,1391,1059,332,87,72,173
2011,Hackney 022B,E01001840,1211,768,443,103,90,250
2011,Hackney 022C,E01001841,1073,755,318,80,78,160
2011,Hackney 022D,E01001844,1595,1116,479,77,252,150
2011,Hackney 022E,E01001845,1137,725,412,106,80,226
2011,Hackney 023B,E01001837,1200,985,215,73,38,104
2011,Hackney 023C,E01001839,1861,1437,424,45,189,190
2011,Hackney 023D,E01001842,1185,821,364,68,108,188
2011,Hackney 023E,E01001843,944,649,295,70,80,145
2011,Hackney 023F,E01033704,1376,1208,168,17,74,77
2011,Hackney 023G,E01033712,1267,991,276,44,95,137
2011,Hackney 024A,E01001772,789,511,278,53,74,151
2011,Hackney 024B,E01001774,1647,1230,417,57,137,223
2011,Hackney 024C,E01001775,1331,884,447,97,129,221
2011,Hackney 024D,E01001815,1329,866,463,104,131,228
2011,Hackney 024E,E01001820,1126,741,385,92,93,200
2011,Hackney 024F,E01001821,1108,733,375,93,93,189
2011,Hackney 025A,E01001752,1936,1550,386,72,140,174
2011,Hackney 025B,E01001753,1185,775,410,60,113,237
2011,Hackney 025C,E01001754,1903,1415,488,87,149,252
2011,Hackney 025D,E01001755,1320,885,435,61,171,203
2011,Hackney 025E,E01001773,1621,1110,511,105,153,253
2011,Hackney 025F,E01001776,1155,732,423,97,94,232
2011,Hackney 026A,E01001779,1884,1346,538,69,195,274
2011,Hackney 026B,E01001781,1285,815,470,62,166,242
2011,Hackney 026C,E01001782,1934,1483,451,97,153,201
2011,Hackney 026D,E01001783,1451,926,525,74,186,265
2011,Hackney 027B,E01001777,1874,1364,510,51,197,262
2011,Hackney 027D,E01001780,1456,1019,437,82,147,208
2011,Hackney 027E,E01001784,1884,1158,726,75,419,232
2011,Hackney 027F,E01033706,1402,1176,226,15,139,72
2011,Hackney 027G,E01033708,1528,1287,241,9,173,59
2011,Hackney 027H,E01033709,1397,1078,319,46,154,119
2011,Hackney 027I,E01033711,1016,726,290,18,223,49
2011,Hackney 028A,E01001798,1261,801,460,111,109,240
2011,Hackney 028B,E01001828,1427,921,506,100,110,296
2011,Hackney 028C,E01033702,839,589,250,21,66,163
2011,Hackney 028D,E01033705,1012,703,309,43,99,167
2011,Hackney 028E,E01033710,853,648,205,16,65,124
2011,Hackney 029A,E01001722,1472,1016,456,98,99,259
2011,Hackney 029B,E01001728,1193,716,477,52,196,229
2011,Hackney 029C,E01001822,1232,741,491,82,130,279
2011,Hackney 029D,E01001827,1224,710,514,88,136,290
2011,Hammersmith and Fulham 001A,E01001874,1722,1298,424,134,116,174
2011,Hammersmith and Fulham 001B,E01001875,1325,819,506,131,119,256
2011,Hammersmith and Fulham 001C,E01001876,1683,993,690,61,203,426
2011,Hammersmith and Fulham 001D,E01001877,1041,793,248,64,53,131
2011,Hammersmith and Fulham 001E,E01001878,1174,788,386,94,99,193
2011,Hammersmith and Fulham 002A,E01001955,1289,819,470,111,104,255
2011,Hammersmith and Fulham 002B,E01001957,1171,748,423,85,121,217
2011,Hammersmith and Fulham 002C,E01001958,1168,763,405,55,124,226
2011,Hammersmith and Fulham 002D,E01001961,1056,651,405,73,120,212
2011,Hammersmith and Fulham 003A,E01001954,1153,811,342,106,87,149
2011,Hammersmith and Fulham 003B,E01001956,1206,810,396,126,127,143
2011,Hammersmith and Fulham 003C,E01001959,1242,777,465,98,132,235
2011,Hammersmith and Fulham 003D,E01001960,1557,1234,323,71,111,141
2011,Hammersmith and Fulham 004A,E01001943,1653,1244,409,63,134,212
2011,Hammersmith and Fulham 004B,E01001944,1278,839,439,108,84,247
2011,Hammersmith and Fulham 004C,E01001945,1381,1088,293,87,59,147
2011,Hammersmith and Fulham 004D,E01001946,1316,1038,278,75,69,134
2011,Hammersmith and Fulham 005A,E01001862,1434,1064,370,99,84,187
2011,Hammersmith and Fulham 005B,E01001940,1291,932,359,86,105,168
2011,Hammersmith and Fulham 005C,E01001941,1491,1233,258,44,79,135
2011,Hammersmith and Fulham 005D,E01001942,1553,1224,329,77,88,164
2011,Hammersmith and Fulham 006A,E01001858,1441,1023,418,70,181,167
2011,Hammersmith and Fulham 006B,E01001860,1416,1040,376,73,90,213
2011,Hammersmith and Fulham 006C,E01001861,1179,869,310,73,75,162
2011,Hammersmith and Fulham 006D,E01001863,1216,971,245,64,76,105
2011,Hammersmith and Fulham 006E,E01001864,1264,972,292,91,49,152
2011,Hammersmith and Fulham 007A,E01001852,1595,1318,277,65,120,92
2011,Hammersmith and Fulham 007B,E01001853,1245,1029,216,55,61,100
2011,Hammersmith and Fulham 007C,E01001854,1458,1171,287,60,90,137
2011,Hammersmith and Fulham 007D,E01001857,1185,809,376,112,71,193
2011,Hammersmith and Fulham 008A,E01001859,1945,1501,444,92,117,235
2011,Hammersmith and Fulham 008B,E01001865,1356,1094,262,78,59,125
2011,Hammersmith and Fulham 008C,E01001927,1105,803,302,112,63,127
2011,Hammersmith and Fulham 008D,E01001930,1392,953,439,132,82,225
2011,Hammersmith and Fulham 009A,E01001895,1258,975,283,65,98,120
2011,Hammersmith and Fulham 009B,E01001896,1295,916,379,82,176,121
2011,Hammersmith and Fulham 009C,E01001897,1088,854,234,80,54,100
2011,Hammersmith and Fulham 009D,E01001929,979,769,210,77,46,87
2011,Hammersmith and Fulham 010A,E01001851,1267,1017,250,71,53,126
2011,Hammersmith and Fulham 010B,E01001855,1452,1170,282,73,89,120
2011,Hammersmith and Fulham 010C,E01001856,1316,951,365,63,104,198
2011,Hammersmith and Fulham 010D,E01001869,992,736,256,87,62,107
2011,Hammersmith and Fulham 010E,E01001873,1175,878,297,85,81,131
2011,Hammersmith and Fulham 011A,E01001928,1289,948,341,96,75,170
2011,Hammersmith and Fulham 011B,E01001931,1153,869,284,52,86,146
2011,Hammersmith and Fulham 011C,E01001932,1355,1034,321,66,97,158
2011,Hammersmith and Fulham 011D,E01001933,1037,763,274,96,64,114
2011,Hammersmith and Fulham 012A,E01001866,1307,962,345,64,160,121
2011,Hammersmith and Fulham 012B,E01001867,1079,689,390,93,193,104
2011,Hammersmith and Fulham 012C,E01001868,1050,706,344,70,103,171
2011,Hammersmith and Fulham 012D,E01001870,1732,1310,422,69,217,136
2011,Hammersmith and Fulham 012E,E01001871,1361,965,396,82,173,141
2011,Hammersmith and Fulham 012F,E01001872,1426,1065,361,72,191,98
2011,Hammersmith and Fulham 013A,E01001893,961,668,293,65,108,120
2011,Hammersmith and Fulham 013B,E01001894,1074,754,320,66,76,178
2011,Hammersmith and Fulham 013C,E01001898,1322,1041,281,66,114,101
2011,Hammersmith and Fulham 013D,E01001899,1068,678,390,114,85,191
2011,Hammersmith and Fulham 013E,E01001900,1360,983,377,96,121,160
2011,Hammersmith and Fulham 014A,E01001889,1193,894,299,66,144,89
2011,Hammersmith and Fulham 014B,E01001910,1351,1090,261,59,91,111
2011,Hammersmith and Fulham 014C,E01001913,1406,1225,181,47,80,54
2011,Hammersmith and Fulham 014D,E01001914,1555,1230,325,51,161,113
2011,Hammersmith and Fulham 015A,E01001885,954,589,365,95,80,190
2011,Hammersmith and Fulham 015B,E01001908,1484,1172,312,47,133,132
2011,Hammersmith and Fulham 015C,E01001909,1507,1129,378,103,121,154
2011,Hammersmith and Fulham 015D,E01001911,1312,891,421,92,115,214
2011,Hammersmith and Fulham 015E,E01001912,1203,732,471,66,214,191
2011,Hammersmith and Fulham 016A,E01001886,1258,836,422,91,178,153
2011,Hammersmith and Fulham 016B,E01001887,1248,868,380,108,139,133
2011,Hammersmith and Fulham 016C,E01001890,1590,1204,386,36,259,91
2011,Hammersmith and Fulham 016D,E01001892,1068,770,298,61,113,124
2011,Hammersmith and Fulham 017A,E01001880,1223,950,273,95,62,116
2011,Hammersmith and Fulham 017B,E01001881,1338,1061,277,76,96,105
2011,Hammersmith and Fulham 017C,E01001882,1517,1227,290,51,119,120
2011,Hammersmith and Fulham 017D,E01001883,1241,877,364,85,155,124
2011,Hammersmith and Fulham 017E,E01001884,1485,1082,403,130,130,143
2011,Hammersmith and Fulham 018A,E01001888,1316,944,372,117,159,96
2011,Hammersmith and Fulham 018B,E01001891,1797,1357,440,83,267,90
2011,Hammersmith and Fulham 018C,E01001917,1150,810,340,134,101,105
2011,Hammersmith and Fulham 018D,E01001918,1184,894,290,95,84,111
2011,Hammersmith and Fulham 018E,E01001919,1149,823,326,100,81,145
2011,Hammersmith and Fulham 019A,E01001879,1225,872,353,87,131,135
2011,Hammersmith and Fulham 019B,E01001901,1268,966,302,64,87,151
2011,Hammersmith and Fulham 019C,E01001902,1466,1119,347,102,122,123
2011,Hammersmith and Fulham 019D,E01001903,1313,925,388,83,132,173
2011,Hammersmith and Fulham 020A,E01001920,1207,823,384,118,101,165
2011,Hammersmith and Fulham 020B,E01001921,1241,930,311,78,89,144
2011,Hammersmith and Fulham 020C,E01001922,1227,931,296,109,55,132
2011,Hammersmith and Fulham 020D,E01001923,1181,865,316,94,76,146
2011,Hammersmith and Fulham 020E,E01001924,1197,922,275,62,58,155
2011,Hammersmith and Fulham 021A,E01001947,1061,703,358,64,100,194
2011,Hammersmith and Fulham 021B,E01001948,1610,1306,304,76,71,157
2011,Hammersmith and Fulham 021C,E01001949,1256,1000,256,57,80,119
2011,Hammersmith and Fulham 021D,E01001950,1226,996,230,47,55,128
2011,Hammersmith and Fulham 021E,E01001951,1313,1033,280,70,65,145
2011,Hammersmith and Fulham 021F,E01001953,1104,858,246,52,79,115
2011,Hammersmith and Fulham 022A,E01001904,1308,1053,255,76,79,100
2011,Hammersmith and Fulham 022B,E01001905,1360,1063,297,81,89,127
2011,Hammersmith and Fulham 022C,E01001906,1235,1024,211,57,67,87
2011,Hammersmith and Fulham 022D,E01001907,1010,782,228,63,51,114
2011,Hammersmith and Fulham 023A,E01001935,1707,1309,398,125,86,187
2011,Hammersmith and Fulham 023C,E01001939,1838,1127,711,121,364,226
2011,Hammersmith and Fulham 023D,E01032788,876,670,206,43,52,111
2011,Hammersmith and Fulham 023E,E01032789,928,726,202,18,91,93
2011,Hammersmith and Fulham 023F,E01032790,826,546,280,47,86,147
2011,Hammersmith and Fulham 024A,E01001915,1053,770,283,82,73,128
2011,Hammersmith and Fulham 024B,E01001916,1019,744,275,131,51,93
2011,Hammersmith and Fulham 024C,E01001926,1136,912,224,62,60,102
2011,Hammersmith and Fulham 024D,E01001952,1419,1197,222,58,73,91
2011,Hammersmith and Fulham 025A,E01001925,1183,877,306,81,71,154
2011,Hammersmith and Fulham 025B,E01001934,1231,850,381,78,122,181
2011,Hammersmith and Fulham 025C,E01001937,1475,1148,327,112,76,139
2011,Hammersmith and Fulham 025D,E01001938,1147,832,315,74,67,174
2011,Haringey 001A,E01001969,1489,1092,397,131,78,188
2011,Haringey 001B,E01001971,1476,933,543,122,134,287
2011,Haringey 001C,E01001974,1777,1405,372,132,105,135
2011,Haringey 001D,E01001975,1410,1104,306,74,91,141
2011,Haringey 002A,E01002036,1136,708,428,88,108,232
2011,Haringey 002B,E01002037,1340,824,516,88,122,306
2011,Haringey 002C,E01002039,1071,595,476,63,123,290
2011,Haringey 002D,E01002040,1447,949,498,119,134,245
2011,Haringey 004A,E01001962,1247,910,337,134,90,113
2011,Haringey 004B,E01001970,1489,1048,441,71,133,237
2011,Haringey 004C,E01001972,1270,919,351,94,89,168
2011,Haringey 004D,E01001973,1682,1245,437,161,110,166
2011,Haringey 005A,E01002090,1161,718,443,101,104,238
2011,Haringey 005B,E01002093,1239,723,516,119,119,278
2011,Haringey 005C,E01002096,1106,677,429,92,135,202
2011,Haringey 005D,E01002097,1105,732,373,59,99,215
2011,Haringey 006A,E01002091,1212,650,562,129,136,297
2011,Haringey 006B,E01002092,1219,765,454,72,123,259
2011,Haringey 006C,E01002094,1070,670,400,84,122,194
2011,Haringey 006D,E01002095,1132,726,406,70,114,222
2011,Haringey 007A,E01002098,1083,861,222,51,73,98
2011,Haringey 007B,E01002101,1507,1071,436,100,127,209
2011,Haringey 007C,E01002102,1502,1087,415,102,117,196
2011,Haringey 007D,E01002105,1654,1248,406,92,125,189
2011,Haringey 008A,E01002099,1496,923,573,84,168,321
2011,Haringey 008B,E01002100,1421,948,473,103,148,222
2011,Haringey 008C,E01002103,1429,998,431,103,128,200
2011,Haringey 008D,E01002104,1086,771,315,94,82,139
2011,Haringey 009A,E01001963,1298,1015,283,102,68,113
2011,Haringey 009B,E01001964,1272,999,273,76,78,119
2011,Haringey 009C,E01001965,1205,972,233,64,56,113
2011,Haringey 009D,E01001966,1131,833,298,125,89,84
2011,Haringey 010A,E01002027,1192,822,370,102,109,159
2011,Haringey 010B,E01002028,1398,1010,388,110,130,148
2011,Haringey 010C,E01002032,1363,910,453,76,123,254
2011,Haringey 010D,E01002033,1384,935,449,97,132,220
2011,Haringey 011A,E01001976,1180,790,390,85,104,201
2011,Haringey 011B,E01001977,1126,730,396,88,92,216
2011,Haringey 011C,E01001978,1385,872,513,103,141,269
2011,Haringey 011D,E01001979,1610,962,648,97,274,277
2011,Haringey 012A,E01002074,1426,909,517,95,135,287
2011,Haringey 012B,E01002077,1486,917,569,64,262,243
2011,Haringey 012C,E01002079,1179,801,378,91,111,176
2011,Haringey 012D,E01002081,1328,726,602,121,232,249
2011,Haringey 013A,E01002082,1073,620,453,85,130,238
2011,Haringey 013B,E01002086,1239,833,406,88,108,210
2011,Haringey 013C,E01002088,1437,1006,431,119,114,198
2011,Haringey 013D,E01002089,1057,620,437,84,138,215
2011,Haringey 014A,E01001967,1207,920,287,110,82,95
2011,Haringey 014B,E01001968,1428,1121,307,111,85,111
2011,Haringey 014C,E01001996,1220,958,262,86,80,96
2011,Haringey 014D,E01001997,1290,1076,214,66,61,87
2011,Haringey 015A,E01002075,1289,787,502,72,244,186
2011,Haringey 015B,E01002076,1388,852,536,104,195,237
2011,Haringey 015C,E01002078,1657,1109,548,134,141,273
2011,Haringey 015D,E01002080,1256,834,422,90,158,174
2011,Haringey 016A,E01002026,1195,732,463,95,119,249
2011,Haringey 016B,E01002029,1368,878,490,70,216,204
2011,Haringey 016C,E01002030,1294,940,354,99,106,149
2011,Haringey 016D,E01002031,1574,1130,444,103,121,220
2011,Haringey 017A,E01001991,1233,1024,209,49,64,96
2011,Haringey 017B,E01001992,1241,932,309,127,91,91
2011,Haringey 017C,E01001993,1142,824,318,142,74,102
2011,Haringey 017D,E01001995,1667,1172,495,115,119,261
2011,Haringey 018A,E01001980,1463,1013,450,102,118,230
2011,Haringey 018B,E01001981,1332,948,384,90,118,176
2011,Haringey 018C,E01001982,1351,993,358,95,92,171
2011,Haringey 018D,E01001983,1237,887,350,69,115,166
2011,Haringey 019A,E01002083,1153,835,318,121,79,118
2011,Haringey 019B,E01002084,1272,922,350,96,101,153
2011,Haringey 019C,E01002085,1676,1211,465,110,136,219
2011,Haringey 019D,E01002087,1268,897,371,88,89,194
2011,Haringey 020B,E01002014,1407,1092,315,100,86,129
2011,Haringey 020C,E01002015,1159,812,347,134,69,144
2011,Haringey 020D,E01002018,1021,746,275,91,69,115
2011,Haringey 020E,E01033085,1473,1193,280,40,99,141
2011,Haringey 020F,E01033086,786,450,336,57,65,214
2011,Haringey 021A,E01002020,1233,967,266,92,67,107
2011,Haringey 021B,E01002022,1584,1333,251,76,71,104
2011,Haringey 021C,E01002023,1092,834,258,105,71,82
2011,Haringey 021D,E01002025,1268,993,275,93,79,103
2011,Haringey 022A,E01002013,1066,861,205,79,41,85
2011,Haringey 022B,E01002019,1018,778,240,112,70,58
2011,Haringey 022C,E01002021,1133,849,284,134,80,70
2011,Haringey 022D,E01002024,963,741,222,78,62,82
2011,Haringey 023A,E01001998,1726,1353,373,99,125,149
2011,Haringey 023B,E01001999,1652,1231,421,105,125,191
2011,Haringey 023C,E01002003,1674,1184,490,75,154,261
2011,Haringey 023D,E01002004,1538,1142,396,105,138,153
2011,Haringey 024A,E01002067,1293,866,427,118,105,204
2011,Haringey 024B,E01002069,1544,1088,456,122,122,212
2011,Haringey 024C,E01002070,1538,1112,426,86,118,222
2011,Haringey 024D,E01002073,1315,889,426,88,111,227
2011,Haringey 025A,E01002066,1328,874,454,77,140,237
2011,Haringey 025B,E01002068,1480,1087,393,86,111,196
2011,Haringey 025C,E01002071,1158,741,417,96,120,201
2011,Haringey 025D,E01002072,1467,919,548,100,184,264
2011,Haringey 026A,E01002043,1539,1076,463,86,137,240
2011,Haringey 026B,E01002045,1684,1112,572,89,179,304
2011,Haringey 026C,E01002046,1257,826,431,138,100,193
2011,Haringey 026D,E01002049,1405,911,494,126,143,225
2011,Haringey 027A,E01002042,1183,866,317,64,98,155
2011,Haringey 027B,E01002044,1435,1059,376,93,124,159
2011,Haringey 027C,E01002047,1394,1014,380,98,149,133
2011,Haringey 027D,E01002048,1525,1097,428,93,109,226
2011,Haringey 028A,E01002016,1543,1215,328,96,94,138
2011,Haringey 028B,E01002017,1469,1199,270,63,93,114
2011,Haringey 028C,E01002059,1255,926,329,88,88,153
2011,Haringey 028D,E01002060,1403,1154,249,86,76,87
2011,Haringey 029A,E01002050,1083,701,382,79,105,198
2011,Haringey 029B,E01002051,1286,922,364,65,112,187
2011,Haringey 029C,E01002052,1112,716,396,70,104,222
2011,Haringey 029D,E01002055,985,662,323,53,101,169
2011,Haringey 030A,E01001994,1366,1047,319,120,90,109
2011,Haringey 030B,E01002008,1113,790,323,123,67,133
2011,Haringey 030C,E01002010,1214,896,318,118,57,143
2011,Haringey 030D,E01002011,1381,1080,301,89,82,130
2011,Haringey 031A,E01002000,1343,1052,291,66,95,130
2011,Haringey 031B,E01002001,1406,1085,321,81,121,119
2011,Haringey 031C,E01002002,1510,1129,381,55,159,167
2011,Haringey 031D,E01002058,1393,1061,332,68,112,152
2011,Haringey 032A,E01002053,1286,850,436,100,118,218
2011,Haringey 032B,E01002054,1237,800,437,60,114,263
2011,Haringey 032C,E01002056,1536,1064,472,100,159,213
2011,Haringey 032D,E01002057,1225,862,363,80,122,161
2011,Haringey 033A,E01001984,1303,1075,228,111,38,79
2011,Haringey 033B,E01001985,1299,1067,232,71,55,106
2011,Haringey 033C,E01001987,1466,1143,323,141,90,92
2011,Haringey 033D,E01001989,1338,1056,282,113,77,92
2011,Haringey 034A,E01001986,1284,1047,237,78,67,92
2011,Haringey 034B,E01001988,1431,1172,259,79,55,125
2011,Haringey 034C,E01001990,1842,1597,245,65,84,96
2011,Haringey 034D,E01002062,1545,1293,252,67,59,126
2011,Haringey 035A,E01002005,1444,1276,168,37,50,81
2011,Haringey 035B,E01002006,1365,1130,235,56,80,99
2011,Haringey 035C,E01002007,1295,1039,256,108,65,83
2011,Haringey 035D,E01002009,1387,1074,313,91,148,74
2011,Haringey 036A,E01002061,1401,1131,270,87,89,94
2011,Haringey 036B,E01002063,1270,1006,264,77,75,112
2011,Haringey 036C,E01002064,1193,891,302,67,94,141
2011,Haringey 036D,E01002065,1444,1181,263,58,85,120
2011,Haringey 037A,E01002034,1288,816,472,97,114,261
2011,Haringey 037B,E01002038,1137,678,459,69,99,291
2011,Haringey 037C,E01002041,1324,816,508,107,130,271
2011,Haringey 037D,E01032575,1296,817,479,69,134,276
2011,Islington 001A,E01002755,1012,659,353,97,58,198
2011,Islington 001B,E01002756,1087,807,280,75,67,138
2011,Islington 001C,E01002758,1186,742,444,93,92,259
2011,Islington 001D,E01002804,1305,867,438,93,88,257
2011,Islington 001E,E01002807,1366,969,397,85,105,207
2011,Islington 001F,E01002811,1132,780,352,96,70,186
2011,Islington 002A,E01002753,1154,811,343,92,100,151
2011,Islington 002B,E01002754,1176,889,287,84,90,113
2011,Islington 002C,E01002757,1088,748,340,80,91,169
2011,Islington 002D,E01002759,1276,966,310,101,82,127
2011,Islington 002E,E01002760,1135,695,440,95,108,237
2011,Islington 002F,E01002772,1481,1107,374,85,130,159
2011,Islington 003A,E01002735,1351,1014,337,76,88,173
2011,Islington 003B,E01002805,1329,1063,266,58,78,130
2011,Islington 003C,E01002806,1274,979,295,82,70,143
2011,Islington 003D,E01002808,1556,1148,408,100,104,204
2011,Islington 003E,E01002809,1300,930,370,63,128,179
2011,Islington 003F,E01002810,1247,895,352,83,72,197
2011,Islington 004A,E01002768,1289,949,340,125,68,147
2011,Islington 004B,E01002770,1226,934,292,72,83,137
2011,Islington 004C,E01002771,1157,880,277,72,76,129
2011,Islington 004D,E01002773,1052,656,396,132,77,187
2011,Islington 004E,E01002774,1704,1273,431,93,118,220
2011,Islington 005A,E01002732,1446,941,505,96,132,277
2011,Islington 005B,E01002734,1180,742,438,61,121,256
2011,Islington 005C,E01002736,1023,600,423,121,83,219
2011,Islington 005D,E01002737,1369,861,508,107,126,275
2011,Islington 005E,E01002751,1390,965,425,85,99,241
2011,Islington 006A,E01002742,1271,1044,227,84,72,71
2011,Islington 006B,E01002747,1333,1020,313,81,119,113
2011,Islington 006C,E01002748,1142,797,345,58,100,187
2011,Islington 006D,E01002749,972,685,287,71,91,125
2011,Islington 006F,E01033493,1229,1115,114,16,68,30
2011,Islington 006G,E01033494,1236,1000,236,75,69,92
2011,Islington 007A,E01002730,1509,1098,411,103,145,163
2011,Islington 007B,E01002731,2108,1626,482,91,178,213
2011,Islington 007C,E01002733,1172,927,245,54,99,92
2011,Islington 007D,E01002763,1201,792,409,59,215,135
2011,Islington 008A,E01002769,1702,1083,619,102,390,127
2011,Islington 008B,E01002785,1497,1115,382,105,116,161
2011,Islington 008C,E01002788,1575,1222,353,95,94,164
2011,Islington 008D,E01002789,1538,1216,322,99,111,112
2011,Islington 009A,E01002738,1397,1028,369,121,73,175
2011,Islington 009B,E01002741,1104,734,370,66,102,202
2011,Islington 009C,E01002743,1239,907,332,64,117,151
2011,Islington 009D,E01002744,1205,955,250,72,59,119
2011,Islington 009E,E01002752,1162,855,307,74,74,159
2011,Islington 010A,E01002764,1359,966,393,84,144,165
2011,Islington 010B,E01002783,1185,792,393,92,103,198
2011,Islington 010C,E01002784,1353,926,427,96,123,208
2011,Islington 010D,E01002786,1394,985,409,92,122,195
2011,Islington 010E,E01002787,1369,838,531,48,135,348
2011,Islington 011C,E01002762,1693,1289,404,118,150,136
2011,Islington 011D,E01002767,1628,1117,511,119,136,256
2011,Islington 011E,E01033486,830,586,244,35,79,130
2011,Islington 011F,E01033487,1055,893,162,5,103,54
2011,Islington 011G,E01033488,972,687,285,54,104,127
2011,Islington 011H,E01033491,1449,1126,323,74,102,147
2011,Islington 011I,E01033492,1211,1057,154,28,77,49
2011,Islington 012A,E01002777,1378,1084,294,79,66,149
2011,Islington 012B,E01002778,1223,761,462,86,132,244
2011,Islington 012C,E01002779,1563,1138,425,57,221,147
2011,Islington 012D,E01002781,1046,725,321,64,87,170
2011,Islington 012E,E01002782,1058,672,386,70,113,203
2011,Islington 013A,E01002739,1451,1151,300,95,85,120
2011,Islington 013B,E01002740,1461,1185,276,66,80,130
2011,Islington 013C,E01002745,1206,941,265,66,92,107
2011,Islington 013D,E01002795,1643,1235,408,87,113,208
2011,Islington 013E,E01002796,889,659,230,72,66,92
2011,Islington 014A,E01002716,1736,1198,538,121,131,286
2011,Islington 014B,E01002718,1417,1153,264,79,71,114
2011,Islington 014C,E01002721,1346,1010,336,71,89,176
2011,Islington 014D,E01002775,1229,1003,226,57,50,119
2011,Islington 014E,E01002776,1254,930,324,74,81,169
2011,Islington 014F,E01002780,1327,1009,318,81,63,174
2011,Islington 015A,E01002708,1632,1020,612,92,319,201
2011,Islington 015B,E01002712,1562,854,708,61,113,534
2011,Islington 015C,E01002713,1170,713,457,157,82,218
2011,Islington 015D,E01002765,1958,1157,801,89,415,297
2011,Islington 015E,E01002766,1366,787,579,94,277,208
2011,Islington 016A,E01002717,1033,759,274,89,54,131
2011,Islington 016B,E01002719,1177,908,269,97,55,117
2011,Islington 016C,E01002720,1671,1075,596,106,157,333
2011,Islington 016D,E01002790,1118,752,366,106,69,191
2011,Islington 016E,E01002791,1255,979,276,88,61,127
2011,Islington 016F,E01002793,1562,1140,422,114,86,222
2011,Islington 017A,E01002698,1745,1389,356,84,97,175
2011,Islington 017B,E01002699,1287,982,305,123,67,115
2011,Islington 017C,E01002700,1196,894,302,110,82,110
2011,Islington 017D,E01002714,1422,1124,298,58,119,121
2011,Islington 017E,E01002792,1559,1261,298,92,94,112
2011,Islington 018A,E01002722,1032,695,337,82,81,174
2011,Islington 018B,E01002797,1539,1138,401,101,99,201
2011,Islington 018C,E01002798,1640,1251,389,118,80,191
2011,Islington 018D,E01002799,1381,961,420,115,88,217
2011,Islington 018E,E01002800,742,439,303,69,73,161
2011,Islington 019A,E01002694,1114,704,410,70,122,218
2011,Islington 019B,E01002697,1643,797,846,93,549,204
2011,Islington 019C,E01002709,1389,896,493,122,181,190
2011,Islington 019D,E01002710,1238,812,426,92,128,206
2011,Islington 019E,E01002715,1108,666,442,71,152,219
2011,Islington 020A,E01002696,1535,1213,322,101,91,130
2011,Islington 020B,E01002794,1477,1149,328,95,95,138
2011,Islington 020C,E01002801,1299,1031,268,86,74,108
2011,Islington 020D,E01002802,1214,975,239,68,62,109
2011,Islington 020E,E01002803,1731,1204,527,100,260,167
2011,Islington 021A,E01002695,1349,1027,322,77,106,139
2011,Islington 021B,E01002711,1698,1247,451,53,199,199
2011,Islington 021C,E01002727,1364,1021,343,79,76,188
2011,Islington 021D,E01002728,1440,663,777,44,614,119
2011,Islington 021E,E01002729,1289,933,356,91,91,174
2011,Islington 022B,E01002707,1482,1050,432,83,213,136
2011,Islington 022C,E01002723,1209,790,419,86,178,155
2011,Islington 022D,E01002724,1795,1312,483,58,333,92
2011,Islington 022E,E01002725,1137,702,435,45,255,135
2011,Islington 022F,E01002726,1362,990,372,62,121,189
2011,Islington 022G,E01033489,1747,1099,648,32,553,63
2011,Islington 022H,E01033490,1463,799,664,42,527,95
2011,Islington 023A,E01002701,1261,805,456,107,195,154
2011,Islington 023B,E01002702,1554,955,599,76,304,219
2011,Islington 023C,E01002703,1296,847,449,78,193,178
2011,Islington 023D,E01002704,1764,1231,533,100,235,198
2011,Islington 023E,E01002706,1536,1087,449,86,169,194
2011,Kensington and Chelsea 001A,E01002852,1411,943,468,97,94,277
2011,Kensington and Chelsea 001B,E01002853,837,493,344,97,67,180
2011,Kensington and Chelsea 001C,E01002854,805,509,296,92,57,147
2011,Kensington and Chelsea 001D,E01002855,1344,845,499,112,99,288
2011,Kensington and Chelsea 001E,E01002857,1002,599,403,100,88,215
2011,Kensington and Chelsea 002A,E01002904,879,535,344,72,74,198
2011,Kensington and Chelsea 002B,E01002905,1188,762,426,100,98,228
2011,Kensington and Chelsea 002C,E01002906,1251,838,413,104,93,216
2011,Kensington and Chelsea 002D,E01002907,922,510,412,84,112,216
2011,Kensington and Chelsea 003A,E01002876,1305,927,378,155,76,147
2011,Kensington and Chelsea 003B,E01002877,1222,752,470,89,135,246
2011,Kensington and Chelsea 003C,E01002878,1321,988,333,99,68,166
2011,Kensington and Chelsea 003D,E01002908,1066,795,271,99,58,114
2011,Kensington and Chelsea 003E,E01002909,1795,1325,470,128,111,231
2011,Kensington and Chelsea 004A,E01002829,1251,924,327,88,73,166
2011,Kensington and Chelsea 004B,E01002830,1444,1054,390,132,68,190
2011,Kensington and Chelsea 004C,E01002831,1599,1159,440,119,81,240
2011,Kensington and Chelsea 004D,E01002832,1375,1008,367,99,106,162
2011,Kensington and Chelsea 004E,E01002856,1490,1107,383,98,80,205
2011,Kensington and Chelsea 005A,E01002870,1064,645,419,123,97,199
2011,Kensington and Chelsea 005B,E01002872,1016,629,387,166,50,171
2011,Kensington and Chelsea 005C,E01002879,1155,743,412,133,95,184
2011,Kensington and Chelsea 005D,E01002880,1142,694,448,104,109,235
2011,Kensington and Chelsea 005E,E01002881,1039,661,378,96,86,196
2011,Kensington and Chelsea 006A,E01002882,1027,767,260,106,50,104
2011,Kensington and Chelsea 006B,E01002883,1395,988,407,123,122,162
2011,Kensington and Chelsea 006C,E01002884,1219,887,332,62,168,102
2011,Kensington and Chelsea 006D,E01002885,1349,1110,239,65,76,98
2011,Kensington and Chelsea 006E,E01002886,1230,924,306,103,71,132
2011,Kensington and Chelsea 007A,E01002833,1206,936,270,81,59,130
2011,Kensington and Chelsea 007B,E01002871,1302,947,355,98,72,185
2011,Kensington and Chelsea 007C,E01002873,1045,749,296,93,66,137
2011,Kensington and Chelsea 007D,E01002874,1135,817,318,80,86,152
2011,Kensington and Chelsea 007E,E01002875,1075,762,313,110,62,141
2011,Kensington and Chelsea 008A,E01002824,1199,874,325,84,77,164
2011,Kensington and Chelsea 008B,E01002825,1486,972,514,130,139,245
2011,Kensington and Chelsea 008C,E01002826,1263,934,329,95,90,144
2011,Kensington and Chelsea 008D,E01002827,1462,1106,356,76,107,173
2011,Kensington and Chelsea 008E,E01002828,1063,766,297,83,68,146
2011,Kensington and Chelsea 009A,E01002864,1042,647,395,106,92,197
2011,Kensington and Chelsea 009B,E01002866,1417,1043,374,77,107,190
2011,Kensington and Chelsea 009C,E01002867,1593,1129,464,80,164,220
2011,Kensington and Chelsea 009D,E01002868,1272,856,416,139,86,191
2011,Kensington and Chelsea 009E,E01002869,1217,859,358,96,78,184
2011,Kensington and Chelsea 010A,E01002887,1192,883,309,70,142,97
2011,Kensington and Chelsea 010B,E01002889,1036,705,331,74,144,113
2011,Kensington and Chelsea 010C,E01002890,1277,808,469,143,100,226
2011,Kensington and Chelsea 010D,E01002891,1172,793,379,71,133,175
2011,Kensington and Chelsea 010E,E01002892,1544,1046,498,75,244,179
2011,Kensington and Chelsea 011A,E01002813,1376,1008,368,108,94,166
2011,Kensington and Chelsea 011B,E01002815,1160,768,392,82,134,176
2011,Kensington and Chelsea 011C,E01002816,1073,737,336,75,113,148
2011,Kensington and Chelsea 011D,E01002817,1215,807,408,112,92,204
2011,Kensington and Chelsea 011E,E01002865,1010,594,416,69,99,248
2011,Kensington and Chelsea 012A,E01002818,1685,1183,502,115,192,195
2011,Kensington and Chelsea 012B,E01002819,1309,889,420,92,165,163
2011,Kensington and Chelsea 012C,E01002859,1332,964,368,106,79,183
2011,Kensington and Chelsea 012D,E01002860,1221,873,348,122,84,142
2011,Kensington and Chelsea 012E,E01002863,1164,836,328,100,67,161
2011,Kensington and Chelsea 013A,E01002812,1551,1009,542,110,232,200
2011,Kensington and Chelsea 013B,E01002834,1140,791,349,63,148,138
2011,Kensington and Chelsea 013C,E01002839,1359,926,433,66,202,165
2011,Kensington and Chelsea 013D,E01002850,1238,788,450,66,252,132
2011,Kensington and Chelsea 013E,E01002888,1815,1196,619,88,352,179
2011,Kensington and Chelsea 014A,E01002821,1158,774,384,81,151,152
2011,Kensington and Chelsea 014B,E01002823,1038,670,368,111,77,180
2011,Kensington and Chelsea 014C,E01002858,1010,639,371,71,142,158
2011,Kensington and Chelsea 014D,E01002861,1121,788,333,107,55,171
2011,Kensington and Chelsea 014E,E01002862,1260,847,413,120,115,178
2011,Kensington and Chelsea 015A,E01002814,1548,1008,540,113,171,256
2011,Kensington and Chelsea 015B,E01002847,1392,1074,318,63,133,122
2011,Kensington and Chelsea 015C,E01002848,1348,971,377,88,124,165
2011,Kensington and Chelsea 015D,E01002851,1395,891,504,160,121,223
2011,Kensington and Chelsea 016A,E01002820,1042,748,294,79,81,134
2011,Kensington and Chelsea 016B,E01002822,904,667,237,74,45,118
2011,Kensington and Chelsea 016C,E01002835,1261,876,385,87,165,133
2011,Kensington and Chelsea 016D,E01002836,1183,847,336,76,156,104
2011,Kensington and Chelsea 016E,E01002837,1092,803,289,58,106,125
2011,Kensington and Chelsea 017A,E01002846,1155,875,280,66,95,119
2011,Kensington and Chelsea 017B,E01002849,1259,932,327,85,132,110
2011,Kensington and Chelsea 017C,E01002893,1504,1106,398,124,110,164
2011,Kensington and Chelsea 017D,E01002894,1197,942,255,55,87,113
2011,Kensington and Chelsea 017E,E01002898,1178,843,335,101,75,159
2011,Kensington and Chelsea 018A,E01002899,1074,774,300,145,39,116
2011,Kensington and Chelsea 018B,E01002900,1150,835,315,102,76,137
2011,Kensington and Chelsea 018C,E01002901,776,501,275,132,34,109
2011,Kensington and Chelsea 018D,E01002902,1413,1050,363,109,92,162
2011,Kensington and Chelsea 018E,E01002903,1177,840,337,115,45,177
2011,Kensington and Chelsea 019A,E01002844,1103,759,344,125,77,142
2011,Kensington and Chelsea 019B,E01002845,1088,721,367,122,83,162
2011,Kensington and Chelsea 019C,E01002910,1086,760,326,126,59,141
2011,Kensington and Chelsea 019D,E01002911,1309,960,349,82,74,193
2011,Kensington and Chelsea 019E,E01002914,1191,855,336,124,68,144
2011,Kensington and Chelsea 020A,E01002838,1421,718,703,63,546,94
2011,Kensington and Chelsea 020B,E01002895,1045,733,312,82,69,161
2011,Kensington and Chelsea 020C,E01002896,1445,1112,333,86,105,142
2011,Kensington and Chelsea 020D,E01002897,1123,848,275,62,106,107
2011,Kensington and Chelsea 020E,E01002912,1335,993,342,115,70,157
2011,Kensington and Chelsea 021A,E01002840,984,623,361,120,69,172
2011,Kensington and Chelsea 021B,E01002841,1130,844,286,67,58,161
2011,Kensington and Chelsea 021C,E01002842,917,501,416,129,66,221
2011,Kensington and Chelsea 021D,E01002843,954,585,369,117,60,192
2011,Kensington and Chelsea 021E,E01002913,1525,1082,443,97,111,235
2011,Lambeth 002A,E01003015,1244,857,387,84,143,160
2011,Lambeth 002B,E01003108,1174,838,336,107,78,151
2011,Lambeth 002C,E01003110,1548,1195,353,115,101,137
2011,Lambeth 002D,E01003111,1125,746,379,111,99,169
2011,Lambeth 002E,E01003112,1220,817,403,92,138,173
2011,Lambeth 003A,E01003101,1245,992,253,45,84,124
2011,Lambeth 003B,E01003105,1267,920,347,97,106,144
2011,Lambeth 003C,E01003106,1535,1229,306,96,93,117
2011,Lambeth 003D,E01003107,1603,1326,277,72,114,91
2011,Lambeth 003E,E01003109,1792,1324,468,89,174,205
2011,Lambeth 004A,E01003102,1467,1199,268,63,85,120
2011,Lambeth 004C,E01003104,1370,1087,283,64,113,106
2011,Lambeth 004D,E01003122,1507,1196,311,64,113,134
2011,Lambeth 004E,E01003129,1537,1254,283,55,118,110
2011,Lambeth 004F,E01033207,1333,932,401,97,81,223
2011,Lambeth 004G,E01033208,1493,1103,390,26,211,153
2011,Lambeth 005A,E01003098,1219,915,304,83,96,125
2011,Lambeth 005B,E01003099,1271,1002,269,50,105,114
2011,Lambeth 005C,E01003100,1770,1548,222,36,96,90
2011,Lambeth 005D,E01003180,1212,922,290,68,91,131
2011,Lambeth 005E,E01003183,1188,851,337,71,90,176
2011,Lambeth 006A,E01003097,1319,900,419,122,133,164
2011,Lambeth 006B,E01003121,1183,860,323,76,71,176
2011,Lambeth 006C,E01003123,1250,1041,209,66,69,74
2011,Lambeth 006D,E01003124,1155,866,289,59,106,124
2011,Lambeth 006E,E01003125,1222,846,376,79,93,204
2011,Lambeth 007A,E01003181,1171,852,319,86,74,159
2011,Lambeth 007B,E01003184,979,676,303,47,86,170
2011,Lambeth 007C,E01003185,1343,1053,290,64,85,141
2011,Lambeth 007D,E01003186,1622,1293,329,71,125,133
2011,Lambeth 007E,E01003187,1200,852,348,78,121,149
2011,Lambeth 008A,E01003089,1439,1015,424,69,173,182
2011,Lambeth 008B,E01003091,1280,972,308,62,110,136
2011,Lambeth 008C,E01003092,1326,930,396,91,121,184
2011,Lambeth 008D,E01003126,1171,876,295,57,103,135
2011,Lambeth 008E,E01003128,1143,859,284,55,82,147
2011,Lambeth 009A,E01003046,1233,887,346,70,110,166
2011,Lambeth 009B,E01003048,1232,864,368,63,100,205
2011,Lambeth 009C,E01003075,1180,791,389,93,104,192
2011,Lambeth 009D,E01003182,1420,1014,406,83,133,190
2011,Lambeth 009E,E01003188,1029,709,320,63,90,167
2011,Lambeth 010A,E01003088,1473,1186,287,55,102,130
2011,Lambeth 010B,E01003093,1673,1209,464,86,139,239
2011,Lambeth 010C,E01003094,1289,1009,280,89,77,114
2011,Lambeth 010D,E01003096,1875,1614,261,73,98,90
2011,Lambeth 010E,E01003127,1422,1130,292,61,92,139
2011,Lambeth 011A,E01003045,1410,934,476,87,141,248
2011,Lambeth 011B,E01003047,1310,957,353,78,93,182
2011,Lambeth 011C,E01003049,1220,866,354,72,118,164
2011,Lambeth 011D,E01003059,1245,886,359,78,110,171
2011,Lambeth 011E,E01003060,1176,798,378,94,93,191
2011,Lambeth 011F,E01003061,1031,814,217,45,64,108
2011,Lambeth 012A,E01003034,1384,1134,250,71,60,119
2011,Lambeth 012B,E01003035,1390,1207,183,45,48,90
2011,Lambeth 012C,E01003036,1311,1036,275,69,67,139
2011,Lambeth 012D,E01003090,2029,1699,330,62,114,154
2011,Lambeth 012E,E01003095,1487,1207,280,66,87,127
2011,Lambeth 013A,E01003037,1100,840,260,62,61,137
2011,Lambeth 013B,E01003038,1272,1077,195,55,72,68
2011,Lambeth 013C,E01003039,1724,1500,224,72,55,97
2011,Lambeth 013D,E01003040,1044,863,181,59,33,89
2011,Lambeth 013E,E01003042,877,716,161,51,38,72
2011,Lambeth 014A,E01003072,1336,1024,312,115,71,126
2011,Lambeth 014B,E01003073,1281,955,326,86,90,150
2011,Lambeth 014C,E01003076,1581,1291,290,47,120,123
2011,Lambeth 014D,E01003077,1466,1163,303,58,136,109
2011,Lambeth 014E,E01003078,1227,955,272,104,71,97
2011,Lambeth 015A,E01003019,1796,1510,286,92,81,113
2011,Lambeth 015B,E01003053,1532,1300,232,68,73,91
2011,Lambeth 015C,E01003054,1682,1527,155,44,51,60
2011,Lambeth 015D,E01003056,1682,1406,276,49,82,145
2011,Lambeth 015E,E01003058,1705,1486,219,43,82,94
2011,Lambeth 016A,E01003020,1444,1174,270,63,74,133
2011,Lambeth 016B,E01003050,1417,1145,272,58,92,122
2011,Lambeth 016C,E01003052,1334,924,410,53,138,219
2011,Lambeth 016D,E01003055,1330,1027,303,89,52,162
2011,Lambeth 016E,E01003176,1305,949,356,73,91,192
2011,Lambeth 017A,E01003029,1503,1249,254,68,59,127
2011,Lambeth 017B,E01003032,1417,1059,358,102,113,143
2011,Lambeth 017C,E01003041,1239,956,283,70,68,145
2011,Lambeth 017D,E01003057,1357,1050,307,48,85,174
2011,Lambeth 018A,E01003043,1345,1105,240,69,79,92
2011,Lambeth 018B,E01003044,961,694,267,50,71,146
2011,Lambeth 018C,E01003051,1272,907,365,46,131,188
2011,Lambeth 018D,E01003071,1912,1624,288,74,86,128
2011,Lambeth 018E,E01003074,1897,1541,356,82,79,195
2011,Lambeth 019A,E01003026,1262,1093,169,47,43,79
2011,Lambeth 019B,E01003027,1040,848,192,52,62,78
2011,Lambeth 019C,E01003028,1144,890,254,69,50,135
2011,Lambeth 019D,E01003030,1515,1331,184,43,49,92
2011,Lambeth 019E,E01003033,1175,957,218,58,64,96
2011,Lambeth 020A,E01003018,1793,1538,255,62,91,102
2011,Lambeth 020B,E01003171,1407,1140,267,55,82,130
2011,Lambeth 020C,E01003173,1312,1074,238,94,64,80
2011,Lambeth 020D,E01003177,1333,1060,273,60,84,129
2011,Lambeth 020E,E01003178,1354,1121,233,50,72,111
2011,Lambeth 021A,E01003021,1492,894,598,105,84,409
2011,Lambeth 021B,E01003022,1428,1151,277,62,93,122
2011,Lambeth 021C,E01003023,1970,1638,332,70,105,157
2011,Lambeth 021D,E01003024,1322,1009,313,47,91,175
2011,Lambeth 021E,E01003025,1562,1217,345,70,105,170
2011,Lambeth 022A,E01003136,1255,991,264,66,64,134
2011,Lambeth 022B,E01003137,1125,825,300,87,58,155
2011,Lambeth 022C,E01003159,1135,858,277,72,82,123
2011,Lambeth 022D,E01003160,1065,751,314,57,91,166
2011,Lambeth 022E,E01003162,1496,1084,412,76,124,212
2011,Lambeth 023A,E01003031,1391,1163,228,52,76,100
2011,Lambeth 023B,E01003156,1206,955,251,75,66,110
2011,Lambeth 023C,E01003157,1171,958,213,57,47,109
2011,Lambeth 023D,E01003158,1319,1164,155,63,30,62
2011,Lambeth 023E,E01003161,931,738,193,55,55,83
2011,Lambeth 023F,E01003163,1154,882,272,111,63,98
2011,Lambeth 024A,E01003132,1033,678,355,88,83,184
2011,Lambeth 024B,E01003172,1460,1095,365,81,94,190
2011,Lambeth 024C,E01003174,1442,1059,383,50,125,208
2011,Lambeth 024D,E01003175,1143,811,332,56,109,167
2011,Lambeth 024E,E01003179,1205,832,373,54,138,181
2011,Lambeth 025A,E01003164,1645,1266,379,87,91,201
2011,Lambeth 025B,E01003165,1172,865,307,114,73,120
2011,Lambeth 025C,E01003168,1159,803,356,96,101,159
2011,Lambeth 025D,E01003169,1894,1499,395,105,93,197
2011,Lambeth 025E,E01003170,1335,1068,267,135,46,86
2011,Lambeth 026A,E01003130,1384,1117,267,84,72,111
2011,Lambeth 026B,E01003131,1141,895,246,78,71,97
2011,Lambeth 026C,E01003135,1336,1029,307,76,65,166
2011,Lambeth 026D,E01003138,1266,1114,152,52,28,72
2011,Lambeth 026E,E01003151,1314,922,392,89,107,196
2011,Lambeth 027A,E01003079,1262,929,333,66,98,169
2011,Lambeth 027B,E01003080,1247,999,248,79,53,116
2011,Lambeth 027C,E01003133,1351,1084,267,55,63,149
2011,Lambeth 027D,E01003134,1184,902,282,92,60,130
2011,Lambeth 027E,E01003152,1502,1170,332,93,91,148
2011,Lambeth 028A,E01003064,1190,993,197,45,55,97
2011,Lambeth 028B,E01003066,1254,899,355,94,98,163
2011,Lambeth 028C,E01003081,1363,1033,330,55,100,175
2011,Lambeth 028D,E01003166,1771,1431,340,81,97,162
2011,Lambeth 028E,E01003167,1258,990,268,107,53,108
2011,Lambeth 029A,E01003116,1217,893,324,100,76,148
2011,Lambeth 029B,E01003117,1558,1261,297,106,61,130
2011,Lambeth 029C,E01003118,1375,1049,326,96,80,150
2011,Lambeth 029D,E01003153,1786,1557,229,48,94,87
2011,Lambeth 029E,E01003155,1442,1120,322,89,65,168
2011,Lambeth 030A,E01003083,1127,837,290,92,65,133
2011,Lambeth 030B,E01003084,1231,1007,224,67,58,99
2011,Lambeth 030C,E01003085,1253,921,332,123,88,121
2011,Lambeth 030D,E01003149,1327,1037,290,105,59,126
2011,Lambeth 030E,E01003154,1388,1008,380,103,94,183
2011,Lambeth 031A,E01003065,1034,715,319,76,70,173
2011,Lambeth 031B,E01003068,1088,812,276,73,54,149
2011,Lambeth 031C,E01003082,1032,748,284,91,60,133
2011,Lambeth 031D,E01003086,1108,766,342,65,95,182
2011,Lambeth 031E,E01003087,1075,684,391,64,80,247
2011,Lambeth 032A,E01003113,1588,1237,351,74,105,172
2011,Lambeth 032B,E01003114,1465,1174,291,77,92,122
2011,Lambeth 032C,E01003119,1516,1236,280,52,79,149
2011,Lambeth 032D,E01003120,1613,1284,329,59,76,194
2011,Lambeth 032E,E01003148,1360,1080,280,56,60,164
2011,Lambeth 032F,E01003150,1275,987,288,77,58,153
2011,Lambeth 033A,E01003062,1340,1100,240,79,53,108
2011,Lambeth 033B,E01003063,1061,749,312,88,72,152
2011,Lambeth 033C,E01003067,1117,853,264,87,64,113
2011,Lambeth 033D,E01003069,947,679,268,74,66,128
2011,Lambeth 033E,E01003070,1103,782,321,65,75,181
2011,Lambeth 034A,E01003115,1255,1013,242,53,68,121
2011,Lambeth 034B,E01003141,1262,901,361,121,75,165
2011,Lambeth 034C,E01003144,1149,843,306,108,86,112
2011,Lambeth 034D,E01003145,1357,1063,294,82,69,143
2011,Lambeth 034E,E01003147,1534,1151,383,111,100,172
2011,Lambeth 035A,E01003139,1138,853,285,95,74,116
2011,Lambeth 035B,E01003140,1078,823,255,92,63,100
2011,Lambeth 035C,E01003142,961,658,303,91,77,135
2011,Lambeth 035D,E01003143,1018,697,321,84,91,146
2011,Lambeth 035E,E01003146,1118,822,296,65,94,137
2011,Lambeth 036A,E01003013,1478,1121,357,55,243,59
2011,Lambeth 036B,E01003014,1281,878,403,113,175,115
2011,Lambeth 036C,E01003016,1251,649,602,59,458,85
2011,Lambeth 036D,E01003017,1389,1035,354,109,103,142
2011,Lambeth 036E,E01032582,1587,1182,405,94,173,138
2011,Lewisham 001A,E01003244,1075,746,329,48,108,173
2011,Lewisham 001B,E01003245,1044,700,344,46,119,179
2011,Lewisham 001C,E01003247,1476,1163,313,61,129,123
2011,Lewisham 001D,E01003249,1551,1157,394,73,139,182
2011,Lewisham 001E,E01003250,1378,1032,346,67,112,167
2011,Lewisham 002A,E01003246,1088,743,345,56,120,169
2011,Lewisham 002B,E01003248,1179,851,328,46,110,172
2011,Lewisham 002C,E01003251,1389,913,476,76,151,249
2011,Lewisham 002D,E01003252,1038,656,382,71,99,212
2011,Lewisham 002E,E01003253,1109,778,331,80,84,167
2011,Lewisham 003A,E01003297,1170,961,209,18,74,117
2011,Lewisham 003B,E01003299,1238,869,369,62,143,164
2011,Lewisham 003C,E01003301,1767,1307,460,49,287,124
2011,Lewisham 003D,E01003302,1151,836,315,73,91,151
2011,Lewisham 003E,E01003305,989,681,308,70,96,142
2011,Lewisham 005A,E01003207,1069,726,343,73,132,138
2011,Lewisham 005B,E01003209,1606,1183,423,78,214,131
2011,Lewisham 005C,E01003210,1460,1176,284,55,94,135
2011,Lewisham 005D,E01003212,1619,1237,382,115,148,119
2011,Lewisham 005E,E01003215,1662,1127,535,54,386,95
2011,Lewisham 006A,E01003338,1328,888,440,102,119,219
2011,Lewisham 006B,E01003339,1370,1045,325,80,95,150
2011,Lewisham 006C,E01003340,1619,1265,354,66,175,113
2011,Lewisham 006D,E01003341,1177,919,258,65,108,85
2011,Lewisham 006E,E01003343,1060,795,265,72,81,112
2011,Lewisham 007A,E01003199,1358,1103,255,80,55,120
2011,Lewisham 007B,E01003201,1224,895,329,75,90,164
2011,Lewisham 007C,E01003204,1055,821,234,66,62,106
2011,Lewisham 007D,E01003205,937,569,368,76,135,157
2011,Lewisham 007E,E01003206,1209,950,259,78,63,118
2011,Lewisham 008B,E01003211,1292,1043,249,62,70,117
2011,Lewisham 008C,E01003213,1604,1249,355,69,163,123
2011,Lewisham 008D,E01003214,1376,1044,332,61,100,171
2011,Lewisham 008E,E01033324,1242,898,344,104,88,152
2011,Lewisham 008F,E01033325,1134,1035,99,2,49,48
2011,Lewisham 009A,E01003198,1051,795,256,95,48,113
2011,Lewisham 009B,E01003200,1251,996,255,110,66,79
2011,Lewisham 009C,E01003202,1194,949,245,134,48,63
2011,Lewisham 009D,E01003203,1424,1115,309,85,81,143
2011,Lewisham 010A,E01003336,964,645,319,80,80,159
2011,Lewisham 010B,E01003337,1081,786,295,50,83,162
2011,Lewisham 010C,E01003342,1307,1050,257,58,82,117
2011,Lewisham 010D,E01003344,1404,1126,278,77,105,96
2011,Lewisham 010E,E01003345,1426,1089,337,68,109,160
2011,Lewisham 011A,E01003273,1634,1126,508,85,300,123
2011,Lewisham 011B,E01003277,1376,1106,270,59,78,133
2011,Lewisham 011C,E01003278,1526,1205,321,112,90,119
2011,Lewisham 011D,E01003279,1257,963,294,125,75,94
2011,Lewisham 012A,E01003288,1331,910,421,143,83,195
2011,Lewisham 012C,E01003290,1386,1060,326,77,88,161
2011,Lewisham 012D,E01003291,1069,694,375,86,79,210
2011,Lewisham 012E,E01003296,1649,1276,373,85,116,172
2011,Lewisham 012F,E01033327,1240,963,277,57,90,130
2011,Lewisham 012G,E01033341,964,693,271,49,76,146
2011,Lewisham 013A,E01003282,1981,1586,395,134,79,182
2011,Lewisham 013B,E01003283,1561,1270,291,110,84,97
2011,Lewisham 013C,E01003284,1350,1046,304,103,78,123
2011,Lewisham 013D,E01003286,1134,774,360,130,59,171
2011,Lewisham 014A,E01003272,1592,1164,428,100,219,109
2011,Lewisham 014B,E01003274,1333,1049,284,90,70,124
2011,Lewisham 014C,E01003275,1196,808,388,103,112,173
2011,Lewisham 014D,E01003276,1375,1034,341,98,109,134
2011,Lewisham 015A,E01003225,1162,904,258,108,68,82
2011,Lewisham 015B,E01003231,1234,932,302,88,88,126
2011,Lewisham 015C,E01003232,1283,968,315,107,83,125
2011,Lewisham 015D,E01003233,1297,967,330,106,93,131
2011,Lewisham 016A,E01003280,1150,808,342,90,87,165
2011,Lewisham 016B,E01003281,1115,823,292,129,56,107
2011,Lewisham 016C,E01003285,1249,965,284,107,72,105
2011,Lewisham 016D,E01003287,1459,1145,314,112,84,118
2011,Lewisham 017A,E01003292,1245,1005,240,68,73,99
2011,Lewisham 017B,E01003293,1167,847,320,80,79,161
2011,Lewisham 017D,E01003295,1280,914,366,93,125,148
2011,Lewisham 017E,E01033320,1167,833,334,88,58,188
2011,Lewisham 017F,E01033322,1050,886,164,23,43,98
2011,Lewisham 018A,E01003319,1285,910,375,87,92,196
2011,Lewisham 018B,E01003320,1088,768,320,66,88,166
2011,Lewisham 018C,E01003323,1131,816,315,79,86,150
2011,Lewisham 018D,E01003325,1225,890,335,83,65,187
2011,Lewisham 019A,E01003226,1365,1087,278,67,98,113
2011,Lewisham 019B,E01003227,1277,1018,259,93,65,101
2011,Lewisham 019C,E01003228,1168,939,229,89,38,102
2011,Lewisham 019D,E01003229,1156,812,344,99,66,179
2011,Lewisham 019E,E01003230,1458,1091,367,74,90,203
2011,Lewisham 020A,E01003317,1348,973,375,112,84,179
2011,Lewisham 020B,E01003318,1263,891,372,63,97,212
2011,Lewisham 020C,E01003321,1455,1084,371,100,65,206
2011,Lewisham 020D,E01003322,1078,808,270,85,64,121
2011,Lewisham 020E,E01003324,1096,795,301,66,74,161
2011,Lewisham 021A,E01003254,1090,841,249,116,45,88
2011,Lewisham 021B,E01003255,1569,1304,265,67,60,138
2011,Lewisham 021C,E01003260,1246,995,251,98,66,87
2011,Lewisham 021D,E01003261,1115,874,241,69,59,113
2011,Lewisham 021E,E01003262,1005,790,215,55,46,114
2011,Lewisham 022A,E01003217,1169,866,303,109,69,125
2011,Lewisham 022B,E01003218,1092,823,269,91,77,101
2011,Lewisham 022C,E01003220,1159,863,296,92,67,137
2011,Lewisham 022D,E01003222,1181,855,326,92,87,147
2011,Lewisham 022E,E01003224,1249,916,333,105,103,125
2011,Lewisham 023A,E01003263,1138,817,321,123,46,152
2011,Lewisham 023B,E01003268,1271,978,293,87,91,115
2011,Lewisham 023C,E01003269,1168,839,329,117,70,142
2011,Lewisham 023D,E01003270,1264,979,285,130,65,90
2011,Lewisham 023E,E01003271,1265,943,322,174,55,93
2011,Lewisham 024A,E01003307,1125,842,283,94,62,127
2011,Lewisham 024B,E01003308,1359,1001,358,95,90,173
2011,Lewisham 024C,E01003314,1224,1005,219,58,51,110
2011,Lewisham 024D,E01003315,1004,793,211,57,43,111
2011,Lewisham 024E,E01003316,1109,865,244,99,60,85
2011,Lewisham 025A,E01003216,1390,1014,376,86,107,183
2011,Lewisham 025B,E01003219,1216,904,312,129,89,94
2011,Lewisham 025C,E01003221,1428,987,441,136,102,203
2011,Lewisham 025D,E01003223,1249,900,349,123,94,132
2011,Lewisham 026A,E01003346,1061,742,319,99,73,147
2011,Lewisham 026B,E01003349,921,633,288,67,67,154
2011,Lewisham 026C,E01003351,945,655,290,92,64,134
2011,Lewisham 026D,E01003354,1202,906,296,88,89,119
2011,Lewisham 027A,E01003309,1059,707,352,105,80,167
2011,Lewisham 027B,E01003310,1230,943,287,53,73,161
2011,Lewisham 027C,E01003311,1150,854,296,141,65,90
2011,Lewisham 027D,E01003312,1344,1050,294,105,78,111
2011,Lewisham 027E,E01003313,1068,804,264,46,79,139
2011,Lewisham 028A,E01003256,1555,1138,417,101,130,186
2011,Lewisham 028B,E01003257,1152,846,306,139,58,109
2011,Lewisham 028C,E01003258,1001,697,304,60,92,152
2011,Lewisham 028D,E01003259,1257,967,290,103,68,119
2011,Lewisham 029A,E01003193,1138,791,347,140,50,157
2011,Lewisham 029B,E01003194,1218,871,347,120,63,164
2011,Lewisham 029C,E01003195,1099,820,279,99,59,121
2011,Lewisham 029D,E01003196,1130,777,353,97,89,167
2011,Lewisham 029E,E01003197,1156,769,387,100,80,207
2011,Lewisham 030A,E01003347,1112,716,396,85,85,226
2011,Lewisham 030B,E01003348,1027,715,312,100,71,141
2011,Lewisham 030C,E01003350,942,604,338,98,61,179
2011,Lewisham 030D,E01003352,1249,848,401,139,79,183
2011,Lewisham 030E,E01003353,1245,905,340,130,76,134
2011,Lewisham 031A,E01003264,1140,797,343,126,71,146
2011,Lewisham 031B,E01003265,1118,797,321,79,67,175
2011,Lewisham 031C,E01003266,1214,764,450,146,97,207
2011,Lewisham 031D,E01003267,1092,727,365,123,64,178
2011,Lewisham 033A,E01003329,1201,906,295,94,72,129
2011,Lewisham 033B,E01003330,1021,708,313,100,50,163
2011,Lewisham 033C,E01003331,997,693,304,133,65,106
2011,Lewisham 033D,E01003332,1115,833,282,98,51,133
2011,Lewisham 033E,E01003334,1254,931,323,101,48,174
2011,Lewisham 034A,E01003189,1101,710,391,82,93,216
2011,Lewisham 034B,E01003190,1284,904,380,82,80,218
2011,Lewisham 034C,E01003191,1044,752,292,80,54,158
2011,Lewisham 034D,E01003192,1164,788,376,113,57,206
2011,Lewisham 035A,E01003326,1055,760,295,106,68,121
2011,Lewisham 035B,E01003327,1408,995,413,106,171,136
2011,Lewisham 035C,E01003328,1311,977,334,116,57,161
2011,Lewisham 035D,E01003333,1173,813,360,112,114,134
2011,Lewisham 035E,E01003335,1012,726,286,82,72,132
2011,Lewisham 037A,E01003236,1061,674,387,109,76,202
2011,Lewisham 037B,E01003237,1002,668,334,94,70,170
2011,Lewisham 037C,E01003238,959,672,287,82,55,150
2011,Lewisham 037D,E01003239,964,688,276,86,66,124
2011,Lewisham 037E,E01032564,866,617,249,64,51,134
2011,Lewisham 038A,E01003235,930,647,283,96,56,131
2011,Lewisham 038B,E01003240,1230,864,366,108,61,197
2011,Lewisham 038C,E01003241,1116,734,382,151,61,170
2011,Lewisham 038D,E01003243,936,624,312,87,67,158
2011,Lewisham 038E,E01032565,926,623,303,99,58,146
2011,Lewisham 039A,E01003298,950,660,290,45,110,135
2011,Lewisham 039B,E01003300,1012,700,312,86,78,148
2011,Lewisham 039C,E01003303,1227,798,429,84,208,137
2011,Lewisham 039D,E01003304,1534,1139,395,70,152,173
2011,Lewisham 039E,E01032579,1142,834,308,45,108,155
2011,Newham 001A,E01003543,1868,1379,489,98,165,226
2011,Newham 001B,E01003544,1457,1070,387,66,126,195
2011,Newham 001C,E01003546,1365,945,420,65,143,212
2011,Newham 001D,E01003550,1316,908,408,77,116,215
2011,Newham 002A,E01003576,1309,822,487,75,145,267
2011,Newham 002B,E01003581,1352,813,539,80,186,273
2011,Newham 002C,E01003582,1132,663,469,95,138,236
2011,Newham 002D,E01003583,1352,892,460,82,130,248
2011,Newham 003A,E01003578,1395,922,473,44,187,242
2011,Newham 003B,E01003584,1533,985,548,103,170,275
2011,Newham 003C,E01003586,1374,859,515,79,165,271
2011,Newham 003D,E01003590,1068,713,355,73,80,202
2011,Newham 004A,E01003579,1327,793,534,86,153,295
2011,Newham 004B,E01003585,1187,710,477,87,130,260
2011,Newham 004C,E01003587,1800,1196,604,101,199,304
2011,Newham 004D,E01003591,1580,974,606,82,204,320
2011,Newham 005A,E01003528,933,560,373,69,104,200
2011,Newham 005B,E01003575,1177,716,461,81,131,249
2011,Newham 005C,E01003577,1236,722,514,83,161,270
2011,Newham 005D,E01003580,1226,740,486,84,144,258
2011,Newham 006A,E01003545,1275,880,395,69,135,191
2011,Newham 006B,E01003548,1837,1331,506,108,207,191
2011,Newham 006C,E01003549,1684,1167,517,89,191,237
2011,Newham 006D,E01003557,1583,1110,473,72,140,261
2011,Newham 007A,E01003547,1484,1041,443,118,138,187
2011,Newham 007B,E01003555,1419,916,503,97,154,252
2011,Newham 007C,E01003561,1434,904,530,77,199,254
2011,Newham 007D,E01003567,1374,885,489,94,146,249
2011,Newham 008A,E01003556,1502,940,562,59,301,202
2011,Newham 008B,E01003558,1191,745,446,64,145,237
2011,Newham 008C,E01003570,1571,989,582,102,179,301
2011,Newham 008D,E01003571,1706,1010,696,105,247,344
2011,Newham 008E,E01003572,1299,772,527,84,192,251
2011,Newham 009A,E01003551,1382,981,401,55,160,186
2011,Newham 009B,E01003553,1472,1004,468,76,153,239
2011,Newham 009C,E01003554,1538,1105,433,105,143,185
2011,Newham 009D,E01003559,2124,1645,479,86,195,198
2011,Newham 010A,E01003529,1850,1156,694,115,238,341
2011,Newham 010B,E01003530,1385,888,497,85,191,221
2011,Newham 010C,E01003531,1526,957,569,97,194,278
2011,Newham 010D,E01003532,1534,949,585,122,186,277
2011,Newham 010E,E01003534,1726,1088,638,113,201,324
2011,Newham 011A,E01003533,1374,897,477,92,130,255
2011,Newham 011B,E01003560,1348,816,532,83,192,257
2011,Newham 011C,E01003563,1507,904,603,71,196,336
2011,Newham 011D,E01003588,1313,815,498,88,180,230
2011,Newham 011E,E01003589,1360,852,508,82,166,260
2011,Newham 012A,E01003616,1368,1015,353,62,131,160
2011,Newham 012B,E01003617,2242,1715,527,88,218,221
2011,Newham 012C,E01003618,1828,1376,452,85,176,191
2011,Newham 012D,E01003619,1885,1391,494,89,207,198
2011,Newham 013C,E01003615,1432,1034,398,96,129,173
2011,Newham 013E,E01033578,1079,823,256,17,144,95
2011,Newham 013F,E01033579,1140,903,237,10,167,60
2011,Newham 013G,E01033583,2510,1864,646,123,250,273
2011,Newham 013H,E01033586,1103,842,261,56,81,124
2011,Newham 014A,E01003562,1732,1127,605,87,225,293
2011,Newham 014B,E01003564,1847,1213,634,86,223,325
2011,Newham 014C,E01003565,1400,870,530,72,185,273
2011,Newham 014D,E01003566,1325,833,492,76,152,264
2011,Newham 015A,E01003625,1239,786,453,55,148,250
2011,Newham 015B,E01003626,1204,790,414,69,151,194
2011,Newham 015C,E01003627,1232,783,449,75,148,226
2011,Newham 015D,E01003628,1230,806,424,59,134,231
2011,Newham 015E,E01003629,1191,772,419,68,121,230
2011,Newham 016A,E01003552,1272,821,451,86,136,229
2011,Newham 016B,E01003596,1291,908,383,69,113,201
2011,Newham 016C,E01003597,1221,788,433,77,131,225
2011,Newham 016D,E01003635,1578,1132,446,110,148,188
2011,Newham 017A,E01003568,1762,1116,646,129,218,299
2011,Newham 017B,E01003569,1520,919,601,109,218,274
2011,Newham 017C,E01003573,1619,1023,596,116,202,278
2011,Newham 017D,E01003574,2017,1247,770,146,269,355
2011,Newham 018A,E01003520,1530,969,561,74,225,262
2011,Newham 018B,E01003521,1804,1229,575,84,227,264
2011,Newham 018C,E01003522,1369,857,512,91,183,238
2011,Newham 018D,E01003525,1485,985,500,73,159,268
2011,Newham 018E,E01003526,1391,855,536,93,151,292
2011,Newham 019A,E01003488,1325,776,549,102,118,329
2011,Newham 019B,E01003489,1239,745,494,81,145,268
2011,Newham 019C,E01003490,1330,867,463,57,153,253
2011,Newham 019D,E01003524,1520,935,585,75,192,318
2011,Newham 020A,E01003631,1431,1037,394,84,101,209
2011,Newham 020B,E01003632,1718,1235,483,109,142,232
2011,Newham 020C,E01003633,1327,855,472,83,155,234
2011,Newham 020D,E01003634,1353,889,464,88,144,232
2011,Newham 020E,E01003636,1426,928,498,83,193,222
2011,Newham 021A,E01003598,1334,857,477,62,139,276
2011,Newham 021B,E01003600,1336,877,459,96,117,246
2011,Newham 021C,E01003630,1493,1000,493,92,182,219
2011,Newham 021D,E01003637,1418,1042,376,82,126,168
2011,Newham 022A,E01003491,1538,928,610,144,179,287
2011,Newham 022B,E01003592,1364,909,455,90,145,220
2011,Newham 022C,E01003599,1173,765,408,70,126,212
2011,Newham 022D,E01003606,1547,1032,515,94,169,252
2011,Newham 023A,E01003535,1168,722,446,68,152,226
2011,Newham 023B,E01003536,1275,861,414,77,122,215
2011,Newham 023C,E01003621,1177,742,435,66,134,235
2011,Newham 023D,E01003622,1120,713,407,62,129,216
2011,Newham 023E,E01003623,1182,717,465,71,149,245
2011,Newham 024A,E01003523,1465,927,538,96,188,254
2011,Newham 024B,E01003527,1239,853,386,92,123,171
2011,Newham 024C,E01003537,1472,1020,452,100,136,216
2011,Newham 024D,E01003542,1292,804,488,96,121,271
2011,Newham 024E,E01003624,1110,705,405,64,123,218
2011,Newham 025A,E01003492,1433,942,491,101,166,224
2011,Newham 025B,E01003493,1708,1105,603,124,172,307
2011,Newham 025C,E01003494,1419,983,436,87,133,216
2011,Newham 025D,E01003495,1513,1093,420,96,131,193
2011,Newham 026A,E01003594,1300,863,437,65,138,234
2011,Newham 026B,E01003595,1138,757,381,90,103,188
2011,Newham 026C,E01003602,1503,1104,399,97,134,168
2011,Newham 026D,E01003607,1216,839,377,61,128,188
2011,Newham 027A,E01003496,1146,844,302,46,101,155
2011,Newham 027B,E01003498,1287,884,403,59,119,225
2011,Newham 027C,E01003500,1492,1060,432,80,131,221
2011,Newham 027D,E01003593,1152,735,417,75,133,209
2011,Newham 028A,E01003601,1503,974,529,99,170,260
2011,Newham 028B,E01003603,1386,975,411,108,94,209
2011,Newham 028C,E01003605,1516,966,550,81,208,261
2011,Newham 028D,E01003608,1499,1098,401,84,135,182
2011,Newham 029A,E01003538,1404,941,463,86,126,251
2011,Newham 029B,E01003539,1512,1051,461,70,138,253
2011,Newham 029C,E01003540,1254,805,449,86,136,227
2011,Newham 029D,E01003541,1259,844,415,72,150,193
2011,Newham 030A,E01003499,1547,978,569,147,147,275
2011,Newham 030B,E01003501,1512,1017,495,89,150,256
2011,Newham 030C,E01003502,1400,940,460,74,162,224
2011,Newham 030D,E01003503,1241,799,442,81,127,234
2011,Newham 031A,E01003507,1542,1049,493,105,128,260
2011,Newham 031B,E01003508,1130,724,406,91,123,192
2011,Newham 031C,E01003509,1443,975,468,106,106,256
2011,Newham 031D,E01003604,1647,1130,517,77,177,263
2011,Newham 032A,E01003483,1103,728,375,48,122,205
2011,Newham 032B,E01003484,1221,945,276,34,109,133
2011,Newham 032C,E01003516,1327,855,472,88,125,259
2011,Newham 032D,E01003518,1209,910,299,65,83,151
2011,Newham 032E,E01003519,1204,859,345,58,125,162
2011,Newham 033A,E01003480,1762,1079,683,80,396,207
2011,Newham 033B,E01003482,2038,1542,496,44,185,267
2011,Newham 033C,E01003486,877,510,367,71,104,192
2011,Newham 033D,E01003487,988,603,385,43,104,238
2011,Newham 034A,E01003497,1275,839,436,110,117,209
2011,Newham 034D,E01003506,1073,669,404,87,120,197
2011,Newham 034F,E01033574,1013,852,161,7,100,54
2011,Newham 034G,E01033575,965,810,155,1,113,41
2011,Newham 034H,E01033576,1098,830,268,50,111,107
2011,Newham 034I,E01033584,1109,748,361,70,95,196
2011,Newham 034J,E01033585,1868,1285,583,130,200,253
2011,Newham 035A,E01003479,1118,850,268,52,79,137
2011,Newham 035B,E01003481,1218,735,483,67,248,168
2011,Newham 035C,E01003485,1148,842,306,66,91,149
2011,Newham 035D,E01003513,1171,868,303,49,117,137
2011,Newham 036A,E01003511,893,549,344,75,107,162
2011,Newham 036B,E01003512,1329,852,477,111,139,227
2011,Newham 036C,E01003514,1086,748,338,56,89,193
2011,Newham 036D,E01003515,1271,837,434,96,122,216
2011,Newham 036E,E01003517,1231,837,394,73,134,187
2011,Newham 037A,E01003609,2021,1509,512,93,168,251
2011,Newham 037C,E01003611,1215,829,386,81,121,184
2011,Newham 037E,E01033577,1193,954,239,26,96,117
2011,Newham 037F,E01033580,1346,1183,163,15,67,81
2011,Newham 037G,E01033581,1322,960,362,83,93,186
2011,Newham 037H,E01033582,1161,1007,154,13,64,77
2011,Southwark 001A,E01004029,1587,1297,290,38,149,103
2011,Southwark 001B,E01004032,1510,1204,306,49,173,84
2011,Southwark 001C,E01004053,1614,1348,266,72,94,100
2011,Southwark 001D,E01004054,1460,1260,200,56,80,64
2011,Southwark 001E,E01004055,978,639,339,114,62,163
2011,Southwark 002A,E01003927,2084,1485,599,71,411,117
2011,Southwark 002B,E01003929,1883,1537,346,81,152,113
2011,Southwark 002C,E01003934,1165,858,307,101,91,115
2011,Southwark 002D,E01003935,1168,646,522,49,385,88
2011,Southwark 002E,E01003939,1593,1261,332,41,183,108
2011,Southwark 003A,E01003976,1576,1204,372,69,141,162
2011,Southwark 003E,E01004027,1765,1346,419,55,176,188
2011,Southwark 003F,E01032637,1187,975,212,11,173,28
2011,Southwark 003G,E01032638,1093,965,128,34,44,50
2011,Southwark 003H,E01032640,1172,1056,116,31,44,41
2011,Southwark 003I,E01032646,1408,1203,205,32,86,87
2011,Southwark 003J,E01032803,1207,1039,168,14,99,55
2011,Southwark 003K,E01032834,1064,945,119,38,28,53
2011,Southwark 004A,E01003975,1175,805,370,47,126,197
2011,Southwark 004B,E01003978,1509,1162,347,31,169,147
2011,Southwark 004C,E01004022,2005,1515,490,129,177,184
2011,Southwark 004D,E01004023,1172,822,350,99,65,186
2011,Southwark 004E,E01004028,1287,936,351,63,116,172
2011,Southwark 006A,E01003938,1446,1063,383,64,176,143
2011,Southwark 006B,E01003940,1107,760,347,63,144,140
2011,Southwark 006C,E01003941,1645,1280,365,53,193,119
2011,Southwark 006D,E01003942,1275,743,532,48,330,154
2011,Southwark 006E,E01003979,1442,1039,403,70,182,151
2011,Southwark 006F,E01003981,1455,968,487,73,298,116
2011,Southwark 007A,E01004030,1237,954,283,65,91,127
2011,Southwark 007B,E01004031,1618,1156,462,91,202,169
2011,Southwark 007C,E01004033,1156,837,319,63,102,154
2011,Southwark 007D,E01004034,1115,773,342,51,121,170
2011,Southwark 007E,E01004036,1427,966,461,73,164,224
2011,Southwark 008A,E01004056,1752,1363,389,70,159,160
2011,Southwark 008B,E01004057,1253,975,278,74,74,130
2011,Southwark 008C,E01004058,1570,1373,197,39,95,63
2011,Southwark 008D,E01004059,1403,1159,244,36,141,67
2011,Southwark 008E,E01004060,1434,1095,339,83,100,156
2011,Southwark 009A,E01003936,1731,1063,668,26,591,51
2011,Southwark 009B,E01003937,1382,1098,284,34,169,81
2011,Southwark 009C,E01003943,1017,696,321,43,129,149
2011,Southwark 009F,E01032720,1390,962,428,47,226,155
2011,Southwark 010A,E01003977,1321,893,428,100,111,217
2011,Southwark 010B,E01004037,1528,1135,393,50,129,214
2011,Southwark 010C,E01004038,1746,1343,403,29,160,214
2011,Southwark 010D,E01004042,1314,826,488,133,116,239
2011,Southwark 010E,E01004043,1092,764,328,111,95,122
2011,Southwark 011A,E01003986,883,582,301,74,72,155
2011,Southwark 011B,E01003987,1296,842,454,125,140,189
2011,Southwark 011C,E01004024,1418,985,433,71,154,208
2011,Southwark 011D,E01004035,1172,798,374,99,80,195
2011,Southwark 012A,E01003960,1485,1043,442,70,223,149
2011,Southwark 012B,E01003961,1534,971,563,162,164,237
2011,Southwark 012E,E01003994,1215,843,372,71,145,156
2011,Southwark 012F,E01032722,1737,1238,499,111,197,191
2011,Southwark 013A,E01003980,1608,1001,607,103,324,180
2011,Southwark 013B,E01004039,1257,899,358,48,173,137
2011,Southwark 013C,E01004040,1262,872,390,74,126,190
2011,Southwark 013D,E01004041,1248,856,392,78,116,198
2011,Southwark 013E,E01004044,1016,693,323,67,86,170
2011,Southwark 014A,E01003992,1069,717,352,73,135,144
2011,Southwark 014B,E01003995,1075,820,255,52,67,136
2011,Southwark 014D,E01003998,1114,861,253,83,75,95
2011,Southwark 014E,E01003999,1118,878,240,55,72,113
2011,Southwark 014F,E01032639,1434,1045,389,52,249,88
2011,Southwark 014G,E01032719,981,662,319,44,137,138
2011,Southwark 015A,E01003964,1522,1082,440,85,150,205
2011,Southwark 015B,E01003966,1499,974,525,94,226,205
2011,Southwark 015C,E01003968,1027,691,336,80,79,177
2011,Southwark 015D,E01003971,1193,785,408,75,121,212
2011,Southwark 015E,E01003974,922,588,334,73,102,159
2011,Southwark 016A,E01003963,1220,798,422,59,149,214
2011,Southwark 016B,E01003967,1250,894,356,69,108,179
2011,Southwark 016C,E01003970,1078,710,368,90,116,162
2011,Southwark 016D,E01003972,1251,920,331,53,112,166
2011,Southwark 016E,E01003973,1221,899,322,67,107,148
2011,Southwark 017A,E01003923,1402,1089,313,81,115,117
2011,Southwark 017B,E01003969,1516,1118,398,65,183,150
2011,Southwark 017C,E01003991,925,601,324,116,87,121
2011,Southwark 017D,E01003993,1230,868,362,64,124,174
2011,Southwark 017E,E01003997,963,696,267,48,116,103
2011,Southwark 018A,E01003983,1398,923,475,97,151,227
2011,Southwark 018B,E01003988,1628,1108,520,133,142,245
2011,Southwark 018C,E01003989,1364,952,412,57,155,200
2011,Southwark 018D,E01003990,1527,1038,489,113,150,226
2011,Southwark 018E,E01004007,882,572,310,64,124,122
2011,Southwark 019A,E01003912,1095,691,404,60,129,215
2011,Southwark 019B,E01004011,1474,1012,462,87,180,195
2011,Southwark 019C,E01004012,1837,1369,468,77,179,212
2011,Southwark 019D,E01004013,1218,812,406,73,133,200
2011,Southwark 019E,E01004014,1283,863,420,69,135,216
2011,Southwark 020A,E01003911,1451,1081,370,51,141,178
2011,Southwark 020B,E01003916,1762,1289,473,66,254,153
2011,Southwark 020C,E01003917,1413,1024,389,113,103,173
2011,Southwark 020D,E01003918,1173,767,406,96,117,193
2011,Southwark 020E,E01003925,953,658,295,69,96,130
2011,Southwark 021A,E01003919,1426,1044,382,80,147,155
2011,Southwark 021B,E01003920,1318,920,398,96,117,185
2011,Southwark 021C,E01003921,1164,811,353,60,93,200
2011,Southwark 021D,E01003922,1453,1046,407,87,121,199
2011,Southwark 021E,E01003924,1433,1011,422,83,125,214
2011,Southwark 021F,E01003926,1051,717,334,75,117,142
2011,Southwark 022B,E01004008,1598,1071,527,105,178,244
2011,Southwark 022D,E01004010,1139,823,316,52,106,158
2011,Southwark 022E,E01004067,1641,1183,458,100,154,204
2011,Southwark 022F,E01032805,1880,1265,615,110,211,294
2011,Southwark 023A,E01003984,1604,1129,475,128,138,209
2011,Southwark 023B,E01004003,1312,905,407,105,80,222
2011,Southwark 023C,E01004004,1967,1479,488,108,139,241
2011,Southwark 023D,E01004005,1578,1067,511,99,120,292
2011,Southwark 023E,E01004006,1563,1136,427,95,120,212
2011,Southwark 024A,E01003913,1494,1096,398,97,156,145
2011,Southwark 024B,E01003914,1464,1116,348,88,135,125
2011,Southwark 024C,E01003915,1511,1109,402,91,129,182
2011,Southwark 024D,E01004050,1224,988,236,50,95,91
2011,Southwark 024E,E01004052,1411,1115,296,80,89,127
2011,Southwark 025A,E01004061,1428,1125,303,81,93,129
2011,Southwark 025B,E01004062,1454,1050,404,90,88,226
2011,Southwark 025C,E01004063,1570,1179,391,96,98,197
2011,Southwark 025D,E01004065,1198,959,239,71,67,101
2011,Southwark 025E,E01004066,1616,1171,445,98,143,204
2011,Southwark 026A,E01004000,1469,1061,408,110,101,197
2011,Southwark 026B,E01004001,1239,776,463,114,103,246
2011,Southwark 026C,E01004019,1752,1294,458,92,128,238
2011,Southwark 026D,E01004064,1436,997,439,110,117,212
2011,Southwark 026E,E01004068,1452,950,502,160,116,226
2011,Southwark 027A,E01004045,1078,815,263,44,91,128
2011,Southwark 027B,E01004047,1128,740,388,83,132,173
2011,Southwark 027C,E01004048,1214,951,263,47,101,115
2011,Southwark 027D,E01004049,1293,808,485,36,334,115
2011,Southwark 027E,E01004051,1095,841,254,73,116,65
2011,Southwark 028A,E01003953,1734,1426,308,110,62,136
2011,Southwark 028B,E01003955,1454,1156,298,85,64,149
2011,Southwark 028C,E01004015,1180,946,234,74,62,98
2011,Southwark 028D,E01004021,1767,1482,285,79,93,113
2011,Southwark 028E,E01004046,1280,991,289,84,81,124
2011,Southwark 029A,E01004002,1252,950,302,82,76,144
2011,Southwark 029B,E01004016,1711,1289,422,111,104,207
2011,Southwark 029C,E01004017,1175,906,269,102,57,110
2011,Southwark 029D,E01004020,1227,883,344,78,90,176
2011,Southwark 030A,E01003952,1295,1041,254,80,72,102
2011,Southwark 030B,E01003954,1230,986,244,96,44,104
2011,Southwark 030C,E01003956,1318,1085,233,84,52,97
2011,Southwark 030D,E01004071,1198,908,290,89,66,135
2011,Southwark 030E,E01004072,1277,978,299,97,94,108
2011,Southwark 031A,E01004069,989,732,257,91,78,88
2011,Southwark 031B,E01004070,1438,1122,316,96,96,124
2011,Southwark 031C,E01004073,1384,1119,265,90,73,102
2011,Southwark 031D,E01004074,1291,972,319,105,110,104
2011,Southwark 031E,E01004075,1239,932,307,130,86,91
2011,Southwark 032A,E01003949,1473,1191,282,88,57,137
2011,Southwark 032B,E01003950,1421,1011,410,114,93,203
2011,Southwark 032C,E01003957,1346,1047,299,98,77,124
2011,Southwark 032D,E01003958,1266,995,271,77,66,128
2011,Southwark 032E,E01004018,1459,1180,279,103,70,106
2011,Southwark 033A,E01003945,1247,968,279,112,57,110
2011,Southwark 033B,E01003946,1230,882,348,140,78,130
2011,Southwark 033C,E01003947,1027,694,333,89,86,158
2011,Southwark 033D,E01003948,1219,935,284,81,45,158
2011,Southwark 033E,E01003951,1118,737,381,103,169,109
2011,Southwark 034A,E01003930,1308,789,519,44,370,105
2011,Southwark 034B,E01003932,1309,877,432,64,196,172
2011,Southwark 034C,E01003933,1515,932,583,86,364,133
2011,Southwark 034D,E01032583,1359,946,413,60,199,154
2011,Southwark 034E,E01032584,1045,753,292,54,130,108
2011,Tower Hamlets 001A,E01004222,1797,1121,676,173,153,350
2011,Tower Hamlets 001B,E01004223,1537,1058,479,127,89,263
2011,Tower Hamlets 001C,E01004224,1545,1104,441,104,117,220
2011,Tower Hamlets 001D,E01004226,1264,891,373,64,104,205
2011,Tower Hamlets 002A,E01004197,1853,1350,503,61,143,299
2011,Tower Hamlets 002B,E01004198,1159,757,402,92,82,228
2011,Tower Hamlets 002C,E01004199,1107,656,451,83,103,265
2011,Tower Hamlets 002D,E01004201,1184,842,342,62,101,179
2011,Tower Hamlets 003A,E01004228,1493,1120,373,120,98,155
2011,Tower Hamlets 003B,E01004230,1600,1109,491,97,150,244
2011,Tower Hamlets 003C,E01004232,1419,1053,366,61,179,126
2011,Tower Hamlets 003D,E01004233,1299,843,456,117,102,237
2011,Tower Hamlets 003E,E01004234,1780,1373,407,97,158,152
2011,Tower Hamlets 004A,E01004225,1936,1696,240,44,97,99
2011,Tower Hamlets 004C,E01004229,1151,800,351,64,118,169
2011,Tower Hamlets 004D,E01004231,1249,799,450,67,137,246
2011,Tower Hamlets 004E,E01032764,1112,897,215,49,64,102
2011,Tower Hamlets 004F,E01032765,1207,870,337,41,112,184
2011,Tower Hamlets 004G,E01032784,1241,959,282,35,110,137
2011,Tower Hamlets 005A,E01004200,1380,1030,350,25,210,115
2011,Tower Hamlets 005B,E01004202,1406,1099,307,53,85,169
2011,Tower Hamlets 005C,E01004203,1424,1067,357,80,106,171
2011,Tower Hamlets 005D,E01004204,1145,706,439,88,107,244
2011,Tower Hamlets 006A,E01004311,1138,747,391,80,88,223
2011,Tower Hamlets 006B,E01004314,883,704,179,59,42,78
2011,Tower Hamlets 006C,E01004315,1367,980,387,97,103,187
2011,Tower Hamlets 006D,E01004318,1096,789,307,42,62,203
2011,Tower Hamlets 007A,E01004259,1424,1096,328,55,100,173
2011,Tower Hamlets 007B,E01004260,1282,860,422,67,111,244
2011,Tower Hamlets 007C,E01004263,1004,631,373,66,108,199
2011,Tower Hamlets 007D,E01004266,1193,873,320,71,91,158
2011,Tower Hamlets 008A,E01004235,935,600,335,55,76,204
2011,Tower Hamlets 008B,E01004236,1147,680,467,54,131,282
2011,Tower Hamlets 008C,E01004237,856,603,253,43,79,131
2011,Tower Hamlets 008D,E01004238,2007,1388,619,66,191,362
2011,Tower Hamlets 008E,E01004239,1152,732,420,89,103,228
2011,Tower Hamlets 009A,E01004312,1199,796,403,78,82,243
2011,Tower Hamlets 009B,E01004313,1504,1049,455,57,139,259
2011,Tower Hamlets 009C,E01004316,919,656,263,40,83,140
2011,Tower Hamlets 009D,E01004317,2338,1868,470,59,176,235
2011,Tower Hamlets 010A,E01004261,2142,813,1329,57,1077,195
2011,Tower Hamlets 010B,E01004262,1451,732,719,68,500,151
2011,Tower Hamlets 010C,E01004264,1069,627,442,68,138,236
2011,Tower Hamlets 010E,E01032785,1108,929,179,23,49,107
2011,Tower Hamlets 010F,E01032786,1118,797,321,48,84,189
2011,Tower Hamlets 011A,E01004207,1100,671,429,57,187,185
2011,Tower Hamlets 011B,E01004209,951,585,366,48,84,234
2011,Tower Hamlets 011D,E01004212,1451,830,621,51,366,204
2011,Tower Hamlets 011F,E01032787,1842,1144,698,92,214,392
2011,Tower Hamlets 012A,E01004240,1226,755,471,70,131,270
2011,Tower Hamlets 012B,E01004241,1124,676,448,70,135,243
2011,Tower Hamlets 012C,E01004242,1770,1122,648,60,220,368
2011,Tower Hamlets 012D,E01004267,1431,1035,396,43,150,203
2011,Tower Hamlets 012E,E01004268,1290,809,481,46,110,325
2011,Tower Hamlets 013A,E01004205,1541,930,611,78,160,373
2011,Tower Hamlets 013B,E01004206,1131,644,487,83,133,271
2011,Tower Hamlets 013C,E01004208,1721,1220,501,39,284,178
2011,Tower Hamlets 013D,E01004211,1307,999,308,37,111,160
2011,Tower Hamlets 014A,E01004269,1472,946,526,70,212,244
2011,Tower Hamlets 014B,E01004270,1856,1290,566,58,309,199
2011,Tower Hamlets 014C,E01004271,1056,669,387,59,109,219
2011,Tower Hamlets 014D,E01004272,1402,841,561,82,135,344
2011,Tower Hamlets 014E,E01004273,1319,773,546,75,136,335
2011,Tower Hamlets 015A,E01004306,1486,1071,415,63,135,217
2011,Tower Hamlets 015B,E01004307,2031,1465,566,34,421,111
2011,Tower Hamlets 015C,E01004308,1161,770,391,78,110,203
2011,Tower Hamlets 015D,E01004309,2320,1469,851,106,315,430
2011,Tower Hamlets 015E,E01004310,1647,1124,523,97,142,284
2011,Tower Hamlets 016A,E01004283,1695,1026,669,87,242,340
2011,Tower Hamlets 016B,E01004287,1544,947,597,132,154,311
2011,Tower Hamlets 016C,E01004289,1386,844,542,103,223,216
2011,Tower Hamlets 016D,E01004290,1034,718,316,65,131,120
2011,Tower Hamlets 017A,E01004322,997,574,423,40,216,167
2011,Tower Hamlets 017B,E01004323,1143,765,378,54,100,224
2011,Tower Hamlets 017C,E01004324,1137,721,416,66,110,240
2011,Tower Hamlets 017D,E01004326,1124,769,355,49,115,191
2011,Tower Hamlets 018A,E01004245,988,549,439,37,119,283
2011,Tower Hamlets 018B,E01004246,1476,1062,414,67,130,217
2011,Tower Hamlets 018C,E01004248,839,495,344,48,75,221
2011,Tower Hamlets 018D,E01004249,1429,903,526,76,117,333
2011,Tower Hamlets 019A,E01004284,1699,1186,513,76,136,301
2011,Tower Hamlets 019B,E01004285,1545,883,662,82,190,390
2011,Tower Hamlets 019C,E01004286,1670,1053,617,106,143,368
2011,Tower Hamlets 019D,E01004288,1071,658,413,64,100,249
2011,Tower Hamlets 020A,E01004243,1212,737,475,65,96,314
2011,Tower Hamlets 020B,E01004244,1264,749,515,104,121,290
2011,Tower Hamlets 020C,E01004247,1383,871,512,70,133,309
2011,Tower Hamlets 020D,E01004250,1588,1003,585,93,109,383
2011,Tower Hamlets 021A,E01004319,1411,875,536,94,139,303
2011,Tower Hamlets 021C,E01004321,1445,909,536,79,168,289
2011,Tower Hamlets 021D,E01004325,2149,1690,459,39,217,203
2011,Tower Hamlets 021E,E01032766,1131,872,259,24,116,119
2011,Tower Hamlets 021F,E01032767,1509,1275,234,27,145,62
2011,Tower Hamlets 022A,E01004298,1245,781,464,81,119,264
2011,Tower Hamlets 022B,E01004300,966,584,382,82,93,207
2011,Tower Hamlets 022C,E01004304,1418,812,606,91,162,353
2011,Tower Hamlets 022D,E01004305,1379,840,539,97,159,283
2011,Tower Hamlets 023A,E01004251,1471,953,518,87,115,316
2011,Tower Hamlets 023B,E01004254,1883,1642,241,30,90,121
2011,Tower Hamlets 023C,E01004255,1224,812,412,40,93,279
2011,Tower Hamlets 023D,E01004258,1231,942,289,77,70,142
2011,Tower Hamlets 024A,E01004252,2025,1449,576,73,157,346
2011,Tower Hamlets 024B,E01004253,1623,1024,599,97,142,360
2011,Tower Hamlets 024C,E01004256,1224,766,458,78,96,284
2011,Tower Hamlets 024D,E01004257,1258,822,436,59,123,254
2011,Tower Hamlets 025B,E01004301,932,582,350,35,108,207
2011,Tower Hamlets 025C,E01004302,1364,867,497,42,146,309
2011,Tower Hamlets 025D,E01004303,1779,1235,544,95,178,271
2011,Tower Hamlets 025E,E01032768,1172,1013,159,29,57,73
2011,Tower Hamlets 025F,E01032769,1042,858,184,33,48,103
2011,Tower Hamlets 026A,E01004292,1546,1323,223,53,81,89
2011,Tower Hamlets 026B,E01004294,1525,1188,337,61,86,190
2011,Tower Hamlets 026C,E01004295,1030,628,402,57,80,265
2011,Tower Hamlets 026D,E01004296,1251,893,358,71,79,208
2011,Tower Hamlets 027A,E01004291,1601,1343,258,79,62,117
2011,Tower Hamlets 027B,E01004293,1864,1539,325,109,87,129
2011,Tower Hamlets 027C,E01004297,1577,1325,252,75,67,110
2011,Tower Hamlets 028A,E01004215,2125,1534,591,100,202,289
2011,Tower Hamlets 028B,E01004219,1722,1182,540,75,162,303
2011,Tower Hamlets 028D,E01004221,1537,1204,333,58,114,161
2011,Tower Hamlets 028E,E01032776,973,816,157,5,91,61
2011,Tower Hamlets 028F,E01032777,941,755,186,14,74,98
2011,Tower Hamlets 028G,E01032778,965,777,188,10,83,95
2011,Tower Hamlets 028H,E01032779,892,740,152,4,62,86
2011,Tower Hamlets 028I,E01032780,1209,1027,182,21,85,76
2011,Tower Hamlets 030A,E01004214,1163,719,444,83,84,277
2011,Tower Hamlets 030B,E01004216,1309,1020,289,58,114,117
2011,Tower Hamlets 030C,E01004217,1347,980,367,96,77,194
2011,Tower Hamlets 030D,E01004218,1424,1075,349,83,119,147
2011,Tower Hamlets 031A,E01004274,1497,997,500,71,146,283
2011,Tower Hamlets 031B,E01004275,1474,1137,337,78,107,152
2011,Tower Hamlets 031C,E01004276,1841,1612,229,53,94,82
2011,Tower Hamlets 031D,E01004281,1524,1268,256,28,110,118
2011,Tower Hamlets 031F,E01032775,981,835,146,20,51,75
2011,Tower Hamlets 031G,E01032783,1187,950,237,50,73,114
2011,Tower Hamlets 032A,E01004280,1435,1049,386,72,107,207
2011,Tower Hamlets 032B,E01032770,1004,801,203,43,61,99
2011,Tower Hamlets 032C,E01032772,943,660,283,56,110,117
2011,Tower Hamlets 032D,E01032773,1291,1016,275,11,125,139
2011,Tower Hamlets 032E,E01032774,999,751,248,34,70,144
2011,Tower Hamlets 033A,E01004277,1474,1222,252,55,77,120
2011,Tower Hamlets 033B,E01032771,914,682,232,23,87,122
2011,Tower Hamlets 033C,E01032781,1362,1158,204,26,71,107
2011,Tower Hamlets 033D,E01032782,1265,923,342,15,161,166
2011,Wandsworth 001A,E01004560,1661,1361,300,92,79,129
2011,Wandsworth 001B,E01004566,1299,1083,216,91,54,71
2011,Wandsworth 001C,E01004582,1741,1338,403,122,116,165
2011,Wandsworth 001D,E01004583,1393,1051,342,159,64,119
2011,Wandsworth 002B,E01004562,1395,1006,389,123,102,164
2011,Wandsworth 002C,E01004563,1551,1152,399,62,135,202
2011,Wandsworth 002D,E01004564,1546,1276,270,87,81,102
2011,Wandsworth 002E,E01004567,1745,1272,473,69,148,256
2011,Wandsworth 002F,E01033098,926,697,229,21,147,61
2011,Wandsworth 002G,E01033100,1050,832,218,74,47,97
2011,Wandsworth 002H,E01033132,904,706,198,15,110,73
2011,Wandsworth 003A,E01004539,1470,1030,440,75,105,260
2011,Wandsworth 003B,E01004540,1657,1267,390,114,82,194
2011,Wandsworth 003C,E01004577,1559,1222,337,99,100,138
2011,Wandsworth 003D,E01004584,1237,819,418,87,130,201
2011,Wandsworth 004B,E01004579,1279,1016,263,94,51,118
2011,Wandsworth 004C,E01004580,1701,1393,308,85,114,109
2011,Wandsworth 004D,E01004581,1551,1213,338,112,98,128
2011,Wandsworth 004E,E01033099,863,686,177,44,61,72
2011,Wandsworth 004F,E01033101,1106,936,170,58,54,58
2011,Wandsworth 004G,E01033133,1043,893,150,31,53,66
2011,Wandsworth 005A,E01004565,1431,1213,218,66,55,97
2011,Wandsworth 005B,E01004590,1379,1003,376,131,82,163
2011,Wandsworth 005C,E01004591,1503,1241,262,73,59,130
2011,Wandsworth 005D,E01004592,1308,1005,303,122,47,134
2011,Wandsworth 006A,E01004604,1200,919,281,91,63,127
2011,Wandsworth 006B,E01004605,1339,1005,334,138,63,133
2011,Wandsworth 006C,E01004606,1398,1207,191,85,45,61
2011,Wandsworth 006D,E01004607,1330,1061,269,98,61,110
2011,Wandsworth 006E,E01004608,1391,1136,255,108,44,103
2011,Wandsworth 007A,E01004535,1230,833,397,78,102,217
2011,Wandsworth 007B,E01004537,1441,1000,441,109,131,201
2011,Wandsworth 007C,E01004538,1546,1191,355,104,95,156
2011,Wandsworth 007D,E01004541,1267,821,446,148,118,180
2011,Wandsworth 008A,E01004534,1578,1352,226,83,47,96
2011,Wandsworth 008B,E01004536,1688,1338,350,70,112,168
2011,Wandsworth 008C,E01004552,1799,1630,169,51,46,72
2011,Wandsworth 008D,E01004585,1595,1353,242,96,59,87
2011,Wandsworth 008E,E01004588,1657,1449,208,55,49,104
2011,Wandsworth 009A,E01004554,1240,1078,162,56,32,74
2011,Wandsworth 009B,E01004556,1148,945,203,60,30,113
2011,Wandsworth 009C,E01004586,1597,1416,181,57,45,79
2011,Wandsworth 009D,E01004587,1439,1243,196,62,39,95
2011,Wandsworth 009E,E01004589,1403,1214,189,58,52,79
2011,Wandsworth 010A,E01004509,1974,1700,274,83,88,103
2011,Wandsworth 010B,E01004511,1443,1246,197,68,50,79
2011,Wandsworth 010C,E01004602,1376,1172,204,68,58,78
2011,Wandsworth 010E,E01004609,1854,1585,269,84,75,110
2011,Wandsworth 010F,E01033093,1307,1123,184,61,30,93
2011,Wandsworth 010G,E01033135,874,769,105,37,24,44
2011,Wandsworth 011A,E01004506,1605,1329,276,94,68,114
2011,Wandsworth 011B,E01004638,1046,738,308,96,73,139
2011,Wandsworth 011C,E01004639,1384,1077,307,105,80,122
2011,Wandsworth 011D,E01004640,1415,1135,280,103,64,113
2011,Wandsworth 011E,E01004641,1443,1056,387,159,102,126
2011,Wandsworth 012A,E01004508,1754,1495,259,68,79,112
2011,Wandsworth 012B,E01004510,1686,1482,204,72,38,94
2011,Wandsworth 012C,E01004514,1435,1219,216,90,30,96
2011,Wandsworth 012D,E01004515,1438,1208,230,59,59,112
2011,Wandsworth 012E,E01004551,1552,1302,250,65,64,121
2011,Wandsworth 013A,E01004568,1343,764,579,39,403,137
2011,Wandsworth 013B,E01004574,1246,813,433,64,143,226
2011,Wandsworth 013C,E01004575,1355,905,450,132,158,160
2011,Wandsworth 013D,E01004576,1144,778,366,84,100,182
2011,Wandsworth 014A,E01004500,1360,1116,244,114,54,76
2011,Wandsworth 014B,E01004501,1267,974,293,84,57,152
2011,Wandsworth 014C,E01004503,1348,1061,287,77,72,138
2011,Wandsworth 014D,E01004505,1329,1067,262,124,44,94
2011,Wandsworth 014E,E01004507,1564,1327,237,91,62,84
2011,Wandsworth 015A,E01004553,1373,1178,195,64,31,100
2011,Wandsworth 015B,E01004557,1156,969,187,56,34,97
2011,Wandsworth 015C,E01004558,1251,1042,209,57,38,114
2011,Wandsworth 015D,E01004559,985,766,219,62,46,111
2011,Wandsworth 015E,E01004619,1028,792,236,54,54,128
2011,Wandsworth 016A,E01004572,1256,938,318,95,67,156
2011,Wandsworth 016B,E01004642,1398,957,441,110,162,169
2011,Wandsworth 016C,E01004643,1499,1083,416,109,89,218
2011,Wandsworth 016D,E01004644,1449,998,451,152,124,175
2011,Wandsworth 016E,E01004645,1423,999,424,111,81,232
2011,Wandsworth 017A,E01004477,1194,921,273,119,38,116
2011,Wandsworth 017B,E01004478,1077,831,246,73,44,129
2011,Wandsworth 017C,E01004479,1167,905,262,81,56,125
2011,Wandsworth 017D,E01004550,1014,797,217,59,51,107
2011,Wandsworth 017E,E01004555,1178,915,263,77,49,137
2011,Wandsworth 018A,E01004494,1377,1094,283,75,56,152
2011,Wandsworth 018B,E01004513,1466,1173,293,96,66,131
2011,Wandsworth 018C,E01004600,1579,1166,413,63,132,218
2011,Wandsworth 018D,E01004601,1754,1385,369,94,95,180
2011,Wandsworth 019A,E01004493,1469,1231,238,72,58,108
2011,Wandsworth 019B,E01004512,1140,893,247,66,45,136
2011,Wandsworth 019C,E01004620,1277,1019,258,75,52,131
2011,Wandsworth 019D,E01004621,1319,1038,281,80,67,134
2011,Wandsworth 019E,E01004623,1316,1071,245,84,42,119
2011,Wandsworth 019F,E01004627,1222,946,276,80,52,144
2011,Wandsworth 020A,E01004499,1321,1107,214,72,52,90
2011,Wandsworth 020B,E01004502,1279,1046,233,71,59,103
2011,Wandsworth 020C,E01004504,1134,878,256,93,55,108
2011,Wandsworth 020D,E01004594,1250,963,287,112,70,105
2011,Wandsworth 020E,E01004596,1224,986,238,93,56,89
2011,Wandsworth 020F,E01004629,1192,865,327,113,92,122
2011,Wandsworth 021A,E01004472,1425,1176,249,106,53,90
2011,Wandsworth 021B,E01004474,1656,1473,183,44,42,97
2011,Wandsworth 021C,E01004476,1424,1199,225,75,52,98
2011,Wandsworth 021D,E01004542,1234,1014,220,82,45,93
2011,Wandsworth 021E,E01004544,1165,940,225,64,54,107
2011,Wandsworth 022A,E01004628,1880,1328,552,133,107,312
2011,Wandsworth 022B,E01004630,1263,852,411,95,101,215
2011,Wandsworth 022C,E01004631,1133,867,266,65,63,138
2011,Wandsworth 022D,E01004633,1195,874,321,62,104,155
2011,Wandsworth 023A,E01004569,1942,1188,754,97,405,252
2011,Wandsworth 023B,E01004570,1423,938,485,108,162,215
2011,Wandsworth 023C,E01004571,1284,882,402,91,155,156
2011,Wandsworth 023D,E01004573,1248,895,353,99,96,158
2011,Wandsworth 024A,E01004495,1184,865,319,61,113,145
2011,Wandsworth 024B,E01004496,1743,1533,210,66,45,99
2011,Wandsworth 024C,E01004497,1062,819,243,81,55,107
2011,Wandsworth 024D,E01004622,2041,902,1139,79,54,1006
2011,Wandsworth 024E,E01004624,1255,998,257,83,64,110
2011,Wandsworth 025A,E01004593,1512,1259,253,98,38,117
2011,Wandsworth 025B,E01004595,1442,1197,245,104,55,86
2011,Wandsworth 025C,E01004597,1364,1129,235,76,45,114
2011,Wandsworth 025D,E01004598,1512,1364,148,47,35,66
2011,Wandsworth 025E,E01004599,1086,886,200,87,38,75
2011,Wandsworth 026A,E01004473,1422,1179,243,79,51,113
2011,Wandsworth 026B,E01004475,1178,999,179,57,29,93
2011,Wandsworth 026C,E01004480,1418,1230,188,65,50,73
2011,Wandsworth 026D,E01004483,1746,1527,219,54,62,103
2011,Wandsworth 026E,E01004484,1284,1086,198,61,54,83
2011,Wandsworth 026F,E01004486,1261,1034,227,78,42,107
2011,Wandsworth 027A,E01004543,1364,1124,240,63,46,131
2011,Wandsworth 027B,E01004545,1414,1255,159,63,46,50
2011,Wandsworth 027C,E01004546,1241,1064,177,69,33,75
2011,Wandsworth 027D,E01004549,1311,976,335,121,51,163
2011,Wandsworth 027E,E01004625,962,684,278,96,65,117
2011,Wandsworth 027F,E01004626,1441,1076,365,91,63,211
2011,Wandsworth 028A,E01004632,1142,906,236,71,63,102
2011,Wandsworth 028B,E01004634,1207,963,244,96,39,109
2011,Wandsworth 028C,E01004635,1294,994,300,102,64,134
2011,Wandsworth 028D,E01004636,1134,869,265,68,58,139
2011,Wandsworth 028E,E01004637,1133,848,285,83,65,137
2011,Wandsworth 029A,E01004481,1460,1216,244,69,69,106
2011,Wandsworth 029B,E01004488,1197,891,306,82,69,155
2011,Wandsworth 029C,E01004547,1072,794,278,86,57,135
2011,Wandsworth 029D,E01004548,1760,1434,326,110,80,136
2011,Wandsworth 030A,E01004482,1250,974,276,84,83,109
2011,Wandsworth 030B,E01004485,1331,1078,253,93,64,96
2011,Wandsworth 030C,E01004487,1281,1023,258,51,54,153
2011,Wandsworth 030D,E01004489,1116,866,250,50,60,140
2011,Wandsworth 031A,E01004490,1190,1006,184,71,43,70
2011,Wandsworth 031B,E01004491,1770,1220,550,52,365,133
2011,Wandsworth 031C,E01004492,1423,1142,281,80,75,126
2011,Wandsworth 031D,E01004498,1433,1257,176,59,41,76
2011,Wandsworth 032A,E01004532,1166,901,265,73,63,129
2011,Wandsworth 032B,E01004611,1228,915,313,107,82,124
2011,Wandsworth 032C,E01004612,1348,961,387,96,130,161
2011,Wandsworth 032D,E01004618,1214,920,294,98,96,100
2011,Wandsworth 033A,E01004531,1268,914,354,111,89,154
2011,Wandsworth 033B,E01004533,1057,756,301,79,83,139
2011,Wandsworth 033C,E01004610,1544,1015,529,142,230,157
2011,Wandsworth 033D,E01004613,1215,810,405,106,143,156
2011,Wandsworth 034A,E01004614,1695,1249,446,103,183,160
2011,Wandsworth 034B,E01004615,1284,841,443,89,141,213
2011,Wandsworth 034C,E01004616,1793,1290,503,92,241,170
2011,Wandsworth 034D,E01004617,1369,953,416,61,216,139
2011,Wandsworth 035A,E01004525,1497,1104,393,75,161,157
2011,Wandsworth 035B,E01004526,1298,992,306,81,91,134
2011,Wandsworth 035C,E01004527,1260,923,337,107,109,121
2011,Wandsworth 035D,E01004528,1147,806,341,76,87,178
2011,Wandsworth 035E,E01004529,1666,1341,325,77,86,162
2011,Wandsworth 035F,E01004530,1511,1145,366,95,138,133
2011,Wandsworth 036A,E01004516,1324,922,402,103,175,124
2011,Wandsworth 036B,E01004518,1284,982,302,110,73,119
2011,Wandsworth 036C,E01004519,1271,932,339,106,88,145
2011,Wandsworth 036D,E01004520,965,677,288,109,70,109
2011,Wandsworth 036E,E01004523,1172,859,313,128,70,115
2011,Wandsworth 037A,E01004517,1508,1169,339,78,91,170
2011,Wandsworth 037B,E01004521,1452,1096,356,96,92,168
2011,Wandsworth 037C,E01004522,1199,904,295,79,70,146
2011,Wandsworth 037D,E01004524,1197,824,373,104,84,185
2011,Westminster 001A,E01004647,1081,703,378,106,82,190
2011,Westminster 001B,E01004649,1248,822,426,87,117,222
2011,Westminster 001C,E01004724,1365,958,407,95,115,197
2011,Westminster 001D,E01004730,1227,822,405,122,104,179
2011,Westminster 002A,E01004646,1116,698,418,92,109,217
2011,Westminster 002B,E01004648,1840,1300,540,137,143,260
2011,Westminster 002C,E01004650,1536,1117,419,102,109,208
2011,Westminster 002D,E01004710,1133,654,479,101,117,261
2011,Westminster 002E,E01004711,1290,851,439,92,108,239
2011,Westminster 003A,E01004651,1610,1115,495,125,163,207
2011,Westminster 003B,E01004725,1170,584,586,154,178,254
2011,Westminster 003C,E01004726,1370,933,437,89,132,216
2011,Westminster 003D,E01004728,1194,758,436,132,130,174
2011,Westminster 003E,E01004729,1198,679,519,194,108,217
2011,Westminster 004A,E01004718,1505,1040,465,120,116,229
2011,Westminster 004B,E01004719,1391,929,462,114,76,272
2011,Westminster 004C,E01004720,1427,896,531,156,99,276
2011,Westminster 004D,E01004721,1497,931,566,150,124,292
2011,Westminster 004E,E01004722,1769,1009,760,122,194,444
2011,Westminster 005A,E01004674,1519,936,583,117,139,327
2011,Westminster 005B,E01004675,1760,1160,600,136,125,339
2011,Westminster 005C,E01004677,1512,1107,405,91,84,230
2011,Westminster 005D,E01004678,1542,1085,457,85,108,264
2011,Westminster 005E,E01004679,1605,1097,508,79,141,288
2011,Westminster 005F,E01004723,1757,1205,552,89,139,324
2011,Westminster 006A,E01004676,1349,1006,343,62,108,173
2011,Westminster 006B,E01004706,1318,1128,190,41,45,104
2011,Westminster 006C,E01004707,1534,1222,312,84,93,135
2011,Westminster 006D,E01004708,1341,1018,323,60,79,184
2011,Westminster 006E,E01004756,1485,1093,392,67,108,217
2011,Westminster 007A,E01004701,1296,962,334,97,64,173
2011,Westminster 007B,E01004703,1750,1245,505,122,124,259
2011,Westminster 007D,E01004705,1165,927,238,54,74,110
2011,Westminster 007E,E01004709,1316,911,405,80,100,225
2011,Westminster 007F,E01033600,1041,794,247,73,56,118
2011,Westminster 007G,E01033608,1236,951,285,68,65,152
2011,Westminster 008A,E01004659,1560,1114,446,69,252,125
2011,Westminster 008B,E01004660,1448,987,461,90,225,146
2011,Westminster 008C,E01004712,1468,1021,447,103,234,110
2011,Westminster 008D,E01004727,1684,1054,630,97,335,198
2011,Westminster 009A,E01004670,1779,819,960,206,208,546
2011,Westminster 009E,E01004702,1848,1028,820,147,234,439
2011,Westminster 009F,E01033598,887,446,441,104,75,262
2011,Westminster 009G,E01033601,1095,646,449,122,108,219
2011,Westminster 009H,E01033602,1116,588,528,96,134,298
2011,Westminster 009I,E01033603,1108,719,389,57,127,205
2011,Westminster 009J,E01033604,1010,635,375,47,121,207
2011,Westminster 009K,E01033605,1452,772,680,160,135,385
2011,Westminster 010A,E01004754,1067,589,478,104,119,255
2011,Westminster 010B,E01004755,1733,1170,563,58,133,372
2011,Westminster 010C,E01004757,1140,648,492,86,124,282
2011,Westminster 010F,E01032512,1746,1029,717,100,137,480
2011,Westminster 010G,E01032513,927,564,363,93,70,200
2011,Westminster 011A,E01004713,1554,1251,303,89,105,109
2011,Westminster 011B,E01004714,1864,1381,483,81,219,183
2011,Westminster 011C,E01004716,1172,833,339,93,130,116
2011,Westminster 011D,E01004717,1326,1036,290,72,146,72
2011,Westminster 011E,E01004762,1729,1143,586,142,160,284
2011,Westminster 012A,E01004657,1255,932,323,82,115,126
2011,Westminster 012B,E01004658,1328,774,554,69,300,185
2011,Westminster 012C,E01004661,1576,1057,519,94,250,175
2011,Westminster 012D,E01004662,1645,1179,466,90,229,147
2011,Westminster 012E,E01004663,1321,883,438,128,113,197
2011,Westminster 013A,E01004715,1543,945,598,112,357,129
2011,Westminster 013B,E01004763,2023,1584,439,41,223,175
2011,Westminster 013D,E01004765,1762,1286,476,97,161,218
2011,Westminster 013E,E01033595,1054,805,249,53,68,128
2011,Westminster 013F,E01033596,1005,744,261,66,57,138
2011,Westminster 014A,E01004653,1461,1105,356,115,80,161
2011,Westminster 014B,E01004654,1938,1523,415,103,132,180
2011,Westminster 014D,E01004656,1773,1269,504,145,107,252
2011,Westminster 014E,E01004760,1270,907,363,97,63,203
2011,Westminster 014F,E01033606,949,758,191,40,43,108
2011,Westminster 014G,E01033607,992,737,255,79,51,125
2011,Westminster 015A,E01004680,1186,802,384,107,112,165
2011,Westminster 015B,E01004683,1341,984,357,80,113,164
2011,Westminster 015C,E01004684,1274,625,649,73,331,245
2011,Westminster 015E,E01004686,1237,719,518,70,142,306
2011,Westminster 015F,E01033593,910,558,352,34,170,148
2011,Westminster 015G,E01033594,1176,768,408,87,165,156
2011,Westminster 016A,E01004681,1862,1411,451,91,170,190
2011,Westminster 016B,E01004682,1386,950,436,65,258,113
2011,Westminster 016C,E01004694,1565,1189,376,70,176,130
2011,Westminster 016D,E01004697,1280,974,306,70,110,126
2011,Westminster 016E,E01004700,1489,1163,326,65,118,143
2011,Westminster 017A,E01004652,1585,1136,449,81,216,152
2011,Westminster 017B,E01004693,1140,839,301,87,87,127
2011,Westminster 017C,E01004695,1132,823,309,35,195,79
2011,Westminster 017D,E01004696,1171,697,474,98,113,263
2011,Westminster 017E,E01004698,1362,1058,304,52,161,91
2011,Westminster 017F,E01004699,1997,1495,502,62,221,219
2011,Westminster 018A,E01004734,1735,1218,517,109,241,167
2011,Westminster 018B,E01004735,1640,1047,593,146,282,165
2011,Westminster 018C,E01004736,1589,1193,396,83,228,85
2011,Westminster 018D,E01004761,1678,1234,444,101,146,197
2011,Westminster 019A,E01004687,1316,920,396,110,71,215
2011,Westminster 019B,E01004688,1778,607,1171,47,1023,101
2011,Westminster 019C,E01004689,974,642,332,64,111,157
2011,Westminster 019D,E01004690,1089,739,350,67,86,197
2011,Westminster 019E,E01004691,1256,816,440,102,142,196
2011,Westminster 019F,E01004692,1266,689,577,87,249,241
2011,Westminster 020A,E01004731,1575,1228,347,85,94,168
2011,Westminster 020B,E01004732,1153,694,459,115,81,263
2011,Westminster 020C,E01004733,1664,1194,470,91,230,149
2011,Westminster 020D,E01004744,1049,752,297,91,69,137
2011,Westminster 020E,E01004748,1183,808,375,103,150,122
2011,Westminster 021A,E01004740,1140,752,388,147,61,180
2011,Westminster 021B,E01004743,1106,793,313,65,89,159
2011,Westminster 021C,E01004745,1729,1285,444,138,98,208
2011,Westminster 021D,E01004746,1076,738,338,92,63,183
2011,Westminster 021E,E01004747,1819,1325,494,122,134,238
2011,Westminster 022A,E01004742,1233,1006,227,68,69,90
2011,Westminster 022B,E01004749,2043,1522,521,84,247,190
2011,Westminster 022C,E01004751,1475,1191,284,92,71,121
2011,Westminster 022D,E01004752,1386,1031,355,94,82,179
2011,Westminster 022E,E01004753,1605,1248,357,103,79,175
2011,Westminster 023B,E01004666,841,600,241,67,43,131
2011,Westminster 023C,E01004667,1082,790,292,92,47,153
2011,Westminster 023D,E01004668,1023,725,298,82,70,146
2011,Westminster 023E,E01004750,1425,973,452,164,82,206
2011,Westminster 023F,E01033597,833,591,242,52,80,110
2011,Westminster 023G,E01033599,1062,672,390,47,107,236
2011,Westminster 024A,E01004665,998,559,439,91,109,239
2011,Westminster 024B,E01004669,1209,772,437,106,108,223
2011,Westminster 024C,E01004737,980,687,293,113,57,123
2011,Westminster 024D,E01004738,1117,884,233,77,55,101
2011,Westminster 024E,E01004739,1166,929,237,86,93,58
2011,Westminster 024F,E01004741,1018,766,252,78,74,100
2011,Barking and Dagenham 001A,E01000027,1088,725,363,104,77,182
2011,Barking and Dagenham 001B,E01000028,995,634,361,99,91,171
2011,Barking and Dagenham 001C,E01000029,1068,698,370,201,63,106
2011,Barking and Dagenham 001D,E01000030,1209,790,419,100,85,234
2011,Barking and Dagenham 002A,E01000031,1157,799,358,154,73,131
2011,Barking and Dagenham 002B,E01000032,1157,810,347,123,68,156
2011,Barking and Dagenham 002C,E01000110,1026,736,290,120,63,107
2011,Barking and Dagenham 002D,E01000111,1256,856,400,132,92,176
2011,Barking and Dagenham 002E,E01000112,1357,975,382,109,94,179
2011,Barking and Dagenham 002F,E01000113,1196,862,334,118,68,148
2011,Barking and Dagenham 003A,E01000034,944,618,326,113,76,137
2011,Barking and Dagenham 003B,E01000037,1329,1043,286,129,55,102
2011,Barking and Dagenham 003C,E01000038,1021,709,312,136,66,110
2011,Barking and Dagenham 003D,E01000039,1144,817,327,140,67,120
2011,Barking and Dagenham 004A,E01000063,1101,757,344,104,61,179
2011,Barking and Dagenham 004B,E01000100,1114,755,359,118,72,169
2011,Barking and Dagenham 004C,E01000101,1078,715,363,109,70,184
2011,Barking and Dagenham 004D,E01000109,1190,832,358,119,89,150
2011,Barking and Dagenham 004E,E01000114,1450,993,457,156,84,217
2011,Barking and Dagenham 006A,E01000033,919,606,313,96,64,153
2011,Barking and Dagenham 006B,E01000060,1174,790,384,124,72,188
2011,Barking and Dagenham 006C,E01000061,1154,746,408,36,114,258
2011,Barking and Dagenham 006D,E01000062,1299,908,391,129,75,187
2011,Barking and Dagenham 006E,E01000064,1252,855,397,109,99,189
2011,Barking and Dagenham 007A,E01000065,1157,756,401,128,84,189
2011,Barking and Dagenham 007B,E01000078,1144,722,422,112,78,232
2011,Barking and Dagenham 007C,E01000080,1062,721,341,93,79,169
2011,Barking and Dagenham 007D,E01000081,1173,788,385,102,69,214
2011,Barking and Dagenham 007E,E01000082,1158,759,399,119,72,208
2011,Barking and Dagenham 007F,E01000083,1155,762,393,116,69,208
2011,Barking and Dagenham 007G,E01000102,1057,709,348,110,60,178
2011,Barking and Dagenham 008A,E01000021,1141,743,398,89,106,203
2011,Barking and Dagenham 008B,E01000022,899,606,293,61,76,156
2011,Barking and Dagenham 008C,E01000023,825,601,224,72,44,108
2011,Barking and Dagenham 008D,E01000024,912,601,311,79,67,165
2011,Barking and Dagenham 008E,E01000025,1139,778,361,98,66,197
2011,Barking and Dagenham 008F,E01000077,1031,710,321,81,68,172
2011,Barking and Dagenham 009A,E01000015,1493,1027,466,86,112,268
2011,Barking and Dagenham 009B,E01000016,1120,761,359,112,72,175
2011,Barking and Dagenham 009C,E01000017,1108,715,393,93,78,222
2011,Barking and Dagenham 009D,E01000018,1085,737,348,95,71,182
2011,Barking and Dagenham 009E,E01000079,1026,649,377,120,62,195
2011,Barking and Dagenham 010A,E01000035,1119,772,347,128,83,136
2011,Barking and Dagenham 010B,E01000036,980,698,282,95,80,107
2011,Barking and Dagenham 010C,E01000107,1117,775,342,139,63,140
2011,Barking and Dagenham 010D,E01000108,1156,832,324,130,67,127
2011,Barking and Dagenham 011A,E01000066,1323,877,446,111,95,240
2011,Barking and Dagenham 011B,E01000067,1394,916,478,135,138,205
2011,Barking and Dagenham 011C,E01000069,1267,862,405,112,130,163
2011,Barking and Dagenham 011D,E01000070,1410,945,465,159,134,172
2011,Barking and Dagenham 011E,E01000071,1571,1081,490,149,130,211
2011,Barking and Dagenham 012A,E01000057,987,671,316,83,65,168
2011,Barking and Dagenham 012B,E01000073,1074,736,338,89,66,183
2011,Barking and Dagenham 012C,E01000074,1052,724,328,101,61,166
2011,Barking and Dagenham 012D,E01000075,1204,758,446,157,97,192
2011,Barking and Dagenham 012E,E01000076,1296,856,440,114,87,239
2011,Barking and Dagenham 013A,E01000013,1134,760,374,115,76,183
2011,Barking and Dagenham 013B,E01000014,1170,798,372,112,66,194
2011,Barking and Dagenham 013C,E01000059,1050,709,341,90,74,177
2011,Barking and Dagenham 013D,E01000084,920,640,280,81,52,147
2011,Barking and Dagenham 013E,E01000085,1162,745,417,118,59,240
2011,Barking and Dagenham 013F,E01000086,985,695,290,89,60,141
2011,Barking and Dagenham 014A,E01000103,1179,802,377,85,108,184
2011,Barking and Dagenham 014B,E01000104,1216,834,382,91,89,202
2011,Barking and Dagenham 014C,E01000105,1441,945,496,146,82,268
2011,Barking and Dagenham 014D,E01000106,1355,872,483,125,80,278
2011,Barking and Dagenham 015A,E01000007,1034,731,303,34,114,155
2011,Barking and Dagenham 015B,E01000008,1023,696,327,28,110,189
2011,Barking and Dagenham 015C,E01000010,2159,1502,657,71,259,327
2011,Barking and Dagenham 015D,E01000012,1324,890,434,61,127,246
2011,Barking and Dagenham 016A,E01000006,1251,874,377,72,117,188
2011,Barking and Dagenham 016B,E01000009,1377,906,471,110,120,241
2011,Barking and Dagenham 016C,E01000011,1239,820,419,69,122,228
2011,Barking and Dagenham 016D,E01000044,1253,871,382,91,112,179
2011,Barking and Dagenham 016E,E01000068,1171,800,371,104,106,161
2011,Barking and Dagenham 017A,E01000041,1150,776,374,107,71,196
2011,Barking and Dagenham 017B,E01000042,1189,731,458,82,109,267
2011,Barking and Dagenham 017C,E01000045,1130,754,376,91,95,190
2011,Barking and Dagenham 017D,E01000046,1188,838,350,82,94,174
2011,Barking and Dagenham 017E,E01000072,1331,847,484,123,91,270
2011,Barking and Dagenham 018A,E01000054,1150,790,360,107,81,172
2011,Barking and Dagenham 018B,E01000055,1093,770,323,89,80,154
2011,Barking and Dagenham 018C,E01000056,1048,700,348,101,76,171
2011,Barking and Dagenham 018D,E01000058,1284,888,396,104,93,199
2011,Barking and Dagenham 018E,E01000095,1061,761,300,69,84,147
2011,Barking and Dagenham 019A,E01000040,1096,727,369,96,76,197
2011,Barking and Dagenham 019B,E01000043,913,593,320,98,78,144
2011,Barking and Dagenham 019C,E01000050,1112,685,427,102,113,212
2011,Barking and Dagenham 019D,E01000052,1385,971,414,101,96,217
2011,Barking and Dagenham 019E,E01000092,1773,1255,518,93,132,293
2011,Barking and Dagenham 020A,E01000053,1029,711,318,93,62,163
2011,Barking and Dagenham 020B,E01000087,942,636,306,91,66,149
2011,Barking and Dagenham 020C,E01000088,1216,846,370,107,76,187
2011,Barking and Dagenham 020D,E01000089,1143,810,333,80,89,164
2011,Barking and Dagenham 020E,E01000090,1068,746,322,94,94,134
2011,Barking and Dagenham 021B,E01000048,1096,674,422,47,125,250
2011,Barking and Dagenham 021C,E01000049,1112,732,380,66,99,215
2011,Barking and Dagenham 021D,E01000051,1252,738,514,46,141,327
2011,Barking and Dagenham 021E,E01033587,1140,821,319,37,71,211
2011,Barking and Dagenham 021F,E01033588,1061,736,325,55,73,197
2011,Barking and Dagenham 022A,E01000091,1069,698,371,82,85,204
2011,Barking and Dagenham 022B,E01000093,1048,690,358,63,71,224
2011,Barking and Dagenham 022C,E01000094,922,707,215,15,64,136
2011,Barking and Dagenham 022D,E01000096,1188,765,423,52,121,250
2011,Barking and Dagenham 023A,E01000019,970,656,314,101,55,158
2011,Barking and Dagenham 023B,E01000020,1226,835,391,98,96,197
2011,Barking and Dagenham 023C,E01000097,1089,717,372,124,68,180
2011,Barking and Dagenham 023D,E01000098,1186,803,383,84,90,209
2011,Barking and Dagenham 023E,E01000099,1191,827,364,110,70,184
2011,Barking and Dagenham 023F,E01032580,961,603,358,67,100,191
2011,Barnet 001A,E01000248,1183,895,288,114,73,101
2011,Barnet 001B,E01000249,1099,840,259,109,75,75
2011,Barnet 001C,E01000250,1634,1233,401,149,89,163
2011,Barnet 001D,E01000254,1082,801,281,150,38,93
2011,Barnet 001E,E01000292,1049,742,307,153,66,88
2011,Barnet 001F,E01000293,1283,962,321,148,83,90
2011,Barnet 002A,E01000167,977,695,282,97,71,114
2011,Barnet 002B,E01000246,1093,776,317,164,56,97
2011,Barnet 002C,E01000247,1293,1004,289,105,71,113
2011,Barnet 002D,E01000251,1422,998,424,159,87,178
2011,Barnet 002E,E01000252,1180,878,302,120,79,103
2011,Barnet 003A,E01000166,1144,788,356,152,73,131
2011,Barnet 003B,E01000168,1140,772,368,166,79,123
2011,Barnet 003C,E01000169,1121,854,267,110,57,100
2011,Barnet 003D,E01000172,1185,796,389,139,130,120
2011,Barnet 004A,E01000285,1105,760,345,138,79,128
2011,Barnet 004B,E01000287,1146,751,395,140,93,162
2011,Barnet 004C,E01000288,1124,815,309,130,76,103
2011,Barnet 004D,E01000289,1264,806,458,129,123,206
2011,Barnet 004E,E01000291,1068,705,363,102,91,170
2011,Barnet 004F,E01000294,1132,795,337,154,57,126
2011,Barnet 005A,E01000267,1152,869,283,120,76,87
2011,Barnet 005B,E01000268,1265,958,307,86,74,147
2011,Barnet 005C,E01000269,1034,775,259,121,55,83
2011,Barnet 005D,E01000270,1089,790,299,143,64,92
2011,Barnet 006A,E01000170,1172,843,329,125,74,130
2011,Barnet 006B,E01000171,1379,1053,326,64,86,176
2011,Barnet 006C,E01000173,1256,896,360,146,95,119
2011,Barnet 006D,E01000174,1265,921,344,131,83,130
2011,Barnet 006E,E01000175,1138,847,291,146,51,94
2011,Barnet 007A,E01000228,1011,745,266,87,87,92
2011,Barnet 007B,E01000253,1183,757,426,194,94,138
2011,Barnet 007C,E01000279,1039,688,351,128,96,127
2011,Barnet 007D,E01000280,1022,720,302,134,71,97
2011,Barnet 007E,E01000286,1109,773,336,116,80,140
2011,Barnet 007F,E01000290,1113,734,379,164,76,139
2011,Barnet 008A,E01000271,1033,754,279,126,55,98
2011,Barnet 008B,E01000272,957,679,278,119,71,88
2011,Barnet 008C,E01000273,1104,758,346,143,74,129
2011,Barnet 008D,E01000281,835,627,208,38,54,116
2011,Barnet 008E,E01000282,1218,861,357,140,89,128
2011,Barnet 009A,E01000115,1066,743,323,125,86,112
2011,Barnet 009B,E01000116,1228,913,315,161,62,92
2011,Barnet 009C,E01000119,1241,844,397,187,94,116
2011,Barnet 009D,E01000120,1081,737,344,147,95,102
2011,Barnet 009E,E01000122,1088,788,300,128,86,86
2011,Barnet 010A,E01000117,1314,955,359,162,83,114
2011,Barnet 010B,E01000118,1390,1047,343,141,85,117
2011,Barnet 010C,E01000121,988,625,363,71,99,193
2011,Barnet 010D,E01000123,1283,978,305,103,67,135
2011,Barnet 010E,E01000124,1206,865,341,100,83,158
2011,Barnet 011A,E01000265,1392,996,396,121,100,175
2011,Barnet 011B,E01000266,1124,812,312,154,73,85
2011,Barnet 011C,E01000274,1333,950,383,123,97,163
2011,Barnet 011D,E01000320,1052,754,298,133,73,92
2011,Barnet 011E,E01000322,1321,959,362,132,84,146
2011,Barnet 012A,E01000275,1184,868,316,124,73,119
2011,Barnet 012B,E01000277,1167,778,389,121,107,161
2011,Barnet 012C,E01000283,999,725,274,109,70,95
2011,Barnet 012D,E01000284,1241,918,323,111,78,134
2011,Barnet 012E,E01000321,1289,990,299,85,79,135
2011,Barnet 013A,E01000195,1276,840,436,117,99,220
2011,Barnet 013B,E01000229,1191,852,339,84,89,166
2011,Barnet 013C,E01000230,1206,846,360,141,97,122
2011,Barnet 013D,E01000231,1294,964,330,100,113,117
2011,Barnet 013E,E01000232,1304,896,408,147,90,171
2011,Barnet 013F,E01000233,1312,952,360,126,99,135
2011,Barnet 014A,E01000186,1080,794,286,113,82,91
2011,Barnet 014B,E01000187,1084,760,324,123,73,128
2011,Barnet 014C,E01000188,1127,842,285,107,77,101
2011,Barnet 014D,E01000189,1248,825,423,70,119,234
2011,Barnet 014E,E01000190,1083,755,328,115,92,121
2011,Barnet 014F,E01000191,1056,746,310,130,85,95
2011,Barnet 015A,E01000158,1098,800,298,93,74,131
2011,Barnet 015B,E01000159,1271,878,393,143,112,138
2011,Barnet 015C,E01000160,1654,1275,379,112,103,164
2011,Barnet 015D,E01000161,1413,1061,352,101,109,142
2011,Barnet 015E,E01000162,1146,812,334,104,89,141
2011,Barnet 015F,E01000324,1284,913,371,135,94,142
2011,Barnet 016A,E01000256,1306,946,360,127,113,120
2011,Barnet 016B,E01000258,1192,887,305,127,89,89
2011,Barnet 016C,E01000263,1064,795,269,97,74,98
2011,Barnet 016D,E01000264,1228,870,358,99,82,177
2011,Barnet 017A,E01000255,1081,725,356,130,113,113
2011,Barnet 017B,E01000257,1252,859,393,78,118,197
2011,Barnet 017C,E01000261,1069,756,313,121,110,82
2011,Barnet 017D,E01000262,1561,1080,481,129,136,216
2011,Barnet 018A,E01000192,1292,919,373,111,104,158
2011,Barnet 018B,E01000193,1235,864,371,111,138,122
2011,Barnet 018C,E01000194,1230,892,338,104,99,135
2011,Barnet 018D,E01000226,1212,827,385,99,94,192
2011,Barnet 018E,E01000227,1285,940,345,143,92,110
2011,Barnet 019A,E01000299,1383,1011,372,102,115,155
2011,Barnet 019B,E01000300,1241,932,309,119,75,115
2011,Barnet 019C,E01000302,1359,995,364,105,103,156
2011,Barnet 019D,E01000317,1198,880,318,102,84,132
2011,Barnet 019E,E01000318,1345,969,376,152,106,118
2011,Barnet 019F,E01000323,1505,1151,354,114,74,166
2011,Barnet 020A,E01000276,1050,735,315,96,83,136
2011,Barnet 020B,E01000278,1021,708,313,130,59,124
2011,Barnet 020C,E01000301,1054,762,292,105,70,117
2011,Barnet 020D,E01000303,1078,784,294,102,85,107
2011,Barnet 020E,E01000304,1230,958,272,80,77,115
2011,Barnet 021A,E01000130,1183,820,363,74,105,184
2011,Barnet 021B,E01000132,1027,718,309,76,83,150
2011,Barnet 021C,E01000133,1125,737,388,94,99,195
2011,Barnet 021D,E01000234,1239,913,326,118,72,136
2011,Barnet 021E,E01000235,1192,840,352,81,113,158
2011,Barnet 022A,E01000156,1418,1066,352,117,100,135
2011,Barnet 022B,E01000157,1172,906,266,76,65,125
2011,Barnet 022C,E01000163,1211,860,351,76,82,193
2011,Barnet 022D,E01000164,1225,866,359,89,95,175
2011,Barnet 022E,E01000165,1427,1079,348,113,81,154
2011,Barnet 022F,E01000315,1212,801,411,98,111,202
2011,Barnet 023A,E01000197,1428,1118,310,116,76,118
2011,Barnet 023B,E01000295,1330,971,359,116,116,127
2011,Barnet 023C,E01000296,1338,1036,302,86,94,122
2011,Barnet 023D,E01000298,1382,1082,300,89,86,125
2011,Barnet 024A,E01000125,1957,1320,637,125,174,338
2011,Barnet 024B,E01000127,1074,747,327,72,88,167
2011,Barnet 024C,E01000128,1283,897,386,106,109,171
2011,Barnet 024D,E01000129,1252,810,442,94,100,248
2011,Barnet 024E,E01000131,1342,903,439,135,108,196
2011,Barnet 024F,E01000134,1181,847,334,89,95,150
2011,Barnet 025A,E01000198,1313,943,370,99,118,153
2011,Barnet 025B,E01000199,1114,777,337,146,76,115
2011,Barnet 025C,E01000204,1311,972,339,133,91,115
2011,Barnet 025D,E01000259,1871,1358,513,165,148,200
2011,Barnet 025E,E01000260,1445,1060,385,101,104,180
2011,Barnet 026A,E01000126,1485,1014,471,57,167,247
2011,Barnet 026B,E01000151,1127,705,422,64,125,233
2011,Barnet 026C,E01000152,1116,716,400,69,139,192
2011,Barnet 026D,E01000153,1107,669,438,123,102,213
2011,Barnet 026E,E01000154,979,627,352,79,88,185
2011,Barnet 027A,E01000176,1187,781,406,156,78,172
2011,Barnet 027B,E01000178,1267,945,322,109,95,118
2011,Barnet 027C,E01000184,1005,683,322,97,87,138
2011,Barnet 027D,E01000297,1144,867,277,105,66,106
2011,Barnet 027E,E01000316,1764,1298,466,135,142,189
2011,Barnet 027F,E01000319,1105,842,263,95,73,95
2011,Barnet 028A,E01000196,1423,1103,320,104,96,120
2011,Barnet 028B,E01000200,1292,899,393,136,118,139
2011,Barnet 028C,E01000201,1103,763,340,88,122,130
2011,Barnet 028D,E01000202,1265,929,336,107,113,116
2011,Barnet 028E,E01000203,1227,828,399,80,169,150
2011,Barnet 029A,E01000177,1287,1034,253,106,71,76
2011,Barnet 029B,E01000179,1294,1078,216,80,53,83
2011,Barnet 029C,E01000180,1188,853,335,134,87,114
2011,Barnet 029D,E01000181,1319,1067,252,114,70,68
2011,Barnet 029E,E01000182,1320,1024,296,125,82,89
2011,Barnet 029F,E01000185,1092,735,357,84,98,175
2011,Barnet 030A,E01000147,1335,911,424,133,121,170
2011,Barnet 030B,E01000148,1421,913,508,107,138,263
2011,Barnet 030D,E01000155,1452,1115,337,59,120,158
2011,Barnet 030E,E01033572,1235,855,380,107,113,160
2011,Barnet 030F,E01033573,1401,878,523,16,404,103
2011,Barnet 031A,E01000239,1572,1114,458,80,180,198
2011,Barnet 031B,E01000240,1254,847,407,111,134,162
2011,Barnet 031C,E01000241,1339,967,372,118,133,121
2011,Barnet 031D,E01000309,1386,959,427,96,168,163
2011,Barnet 032A,E01000237,1554,1150,404,60,206,138
2011,Barnet 032B,E01000242,1075,716,359,111,115,133
2011,Barnet 032C,E01000243,1443,1014,429,105,215,109
2011,Barnet 032D,E01000244,1332,832,500,102,284,114
2011,Barnet 032E,E01000245,1460,971,489,108,165,216
2011,Barnet 032F,E01000314,1426,1024,402,88,159,155
2011,Barnet 033A,E01000183,1025,771,254,106,60,88
2011,Barnet 033B,E01000206,1069,721,348,78,106,164
2011,Barnet 033C,E01000207,1107,772,335,117,93,125
2011,Barnet 033D,E01000208,1141,842,299,100,76,123
2011,Barnet 033E,E01000210,1071,812,259,85,66,108
2011,Barnet 033F,E01000213,957,631,326,92,95,139
2011,Barnet 034A,E01000236,1213,869,344,67,123,154
2011,Barnet 034B,E01000238,1319,953,366,87,135,144
2011,Barnet 034C,E01000310,1577,1158,419,116,139,164
2011,Barnet 034D,E01000311,1014,686,328,78,122,128
2011,Barnet 035A,E01000205,1064,790,274,111,69,94
2011,Barnet 035B,E01000209,1064,734,330,190,58,82
2011,Barnet 035C,E01000211,1568,1196,372,90,135,147
2011,Barnet 035D,E01000212,1041,739,302,106,66,130
2011,Barnet 035E,E01000216,1294,976,318,77,89,152
2011,Barnet 035F,E01000217,1150,796,354,68,107,179
2011,Barnet 036A,E01000150,1532,1120,412,143,98,171
2011,Barnet 036B,E01000305,1254,881,373,92,103,178
2011,Barnet 036C,E01000306,1320,916,404,132,126,146
2011,Barnet 036D,E01000308,1107,703,404,116,84,204
2011,Barnet 036E,E01000312,1244,896,348,71,90,187
2011,Barnet 036F,E01000313,1422,1006,416,93,137,186
2011,Barnet 037A,E01000145,992,678,314,66,108,140
2011,Barnet 037B,E01000215,1251,866,385,93,120,172
2011,Barnet 037C,E01000218,1203,836,367,63,117,187
2011,Barnet 037D,E01000219,1279,913,366,79,125,162
2011,Barnet 037E,E01000220,1235,873,362,65,106,191
2011,Barnet 037F,E01000225,980,651,329,79,99,151
2011,Barnet 038A,E01000135,1123,774,349,82,132,135
2011,Barnet 038B,E01000136,1040,728,312,88,95,129
2011,Barnet 038C,E01000144,1201,892,309,55,133,121
2011,Barnet 038D,E01000146,1352,1042,310,62,127,121
2011,Barnet 038E,E01000214,1294,993,301,84,109,108
2011,Barnet 039A,E01000141,1656,1278,378,58,158,162
2011,Barnet 039B,E01000221,878,561,317,56,91,170
2011,Barnet 039C,E01000223,922,639,283,69,70,144
2011,Barnet 039D,E01000307,1224,847,377,118,124,135
2011,Barnet 040A,E01000138,1063,728,335,95,111,129
2011,Barnet 040B,E01000142,1770,1321,449,81,118,250
2011,Barnet 040C,E01000222,1128,751,377,111,106,160
2011,Barnet 040D,E01000224,1130,757,373,86,114,173
2011,Barnet 041A,E01000137,1177,756,421,108,97,216
2011,Barnet 041B,E01000139,1103,811,292,76,96,120
2011,Barnet 041C,E01000140,1296,923,373,84,147,142
2011,Barnet 041D,E01000143,1077,709,368,81,133,154
2011,Bexley 001A,E01000466,1170,770,400,115,110,175
2011,Bexley 001B,E01000467,1145,839,306,57,111,138
2011,Bexley 001C,E01000468,1798,1339,459,57,193,209
2011,Bexley 001D,E01000469,1214,865,349,102,98,149
2011,Bexley 002A,E01000416,1079,748,331,113,82,136
2011,Bexley 002B,E01000418,1388,1001,387,131,97,159
2011,Bexley 002C,E01000422,1190,791,399,79,101,219
2011,Bexley 002D,E01000464,1034,722,312,100,76,136
2011,Bexley 002E,E01000465,1135,782,353,118,69,166
2011,Bexley 002F,E01000470,1004,644,360,91,99,170
2011,Bexley 003A,E01000333,1169,808,361,144,50,167
2011,Bexley 003B,E01000335,1214,854,360,107,77,176
2011,Bexley 003C,E01000336,1342,926,416,110,99,207
2011,Bexley 003D,E01000337,1212,930,282,108,59,115
2011,Bexley 003E,E01000338,1302,990,312,107,83,122
2011,Bexley 004A,E01000403,1435,968,467,190,71,206
2011,Bexley 004B,E01000404,1585,1151,434,53,105,276
2011,Bexley 004C,E01000405,983,735,248,58,54,136
2011,Bexley 004D,E01000408,1185,851,334,95,93,146
2011,Bexley 005A,E01000332,1101,758,343,169,75,99
2011,Bexley 005B,E01000402,1105,767,338,148,61,129
2011,Bexley 005C,E01000406,1170,824,346,110,87,149
2011,Bexley 005D,E01000407,1065,681,384,225,46,113
2011,Bexley 006A,E01000334,1175,851,324,166,66,92
2011,Bexley 006B,E01000417,1238,880,358,167,52,139
2011,Bexley 006C,E01000419,1030,715,315,192,36,87
2011,Bexley 006D,E01000420,1146,806,340,188,77,75
2011,Bexley 006E,E01000442,1132,801,331,187,45,99
2011,Bexley 007A,E01000437,948,677,271,138,57,76
2011,Bexley 007B,E01000438,1167,858,309,125,61,123
2011,Bexley 007C,E01000439,980,730,250,85,52,113
2011,Bexley 007D,E01000440,1051,743,308,196,42,70
2011,Bexley 007E,E01000441,1149,796,353,121,57,175
2011,Bexley 008A,E01000373,1034,723,311,64,40,207
2011,Bexley 008B,E01000429,1161,813,348,63,69,216
2011,Bexley 008C,E01000430,1204,918,286,77,76,133
2011,Bexley 008D,E01000431,1177,789,388,83,101,204
2011,Bexley 008E,E01000432,1106,723,383,151,76,156
2011,Bexley 008F,E01000433,1218,807,411,110,91,210
2011,Bexley 008G,E01000434,1029,673,356,82,81,193
2011,Bexley 009A,E01000356,1077,724,353,220,47,86
2011,Bexley 009B,E01000357,1041,763,278,140,66,72
2011,Bexley 009C,E01000359,953,666,287,188,55,44
2011,Bexley 009D,E01000421,1028,690,338,215,53,70
2011,Bexley 009E,E01000450,1257,855,402,152,64,186
2011,Bexley 009F,E01000451,1245,930,315,156,72,87
2011,Bexley 009G,E01000452,1014,798,216,92,51,73
2011,Bexley 010A,E01000367,1126,791,335,142,69,124
2011,Bexley 010B,E01000368,1056,727,329,114,60,155
2011,Bexley 010C,E01000372,1173,773,400,160,63,177
2011,Bexley 010D,E01000380,1055,783,272,130,43,99
2011,Bexley 010E,E01000435,982,662,320,127,60,133
2011,Bexley 011A,E01000353,1225,851,374,241,62,71
2011,Bexley 011B,E01000354,1085,788,297,150,48,99
2011,Bexley 011C,E01000355,1067,728,339,210,46,83
2011,Bexley 011D,E01000358,1179,859,320,188,53,79
2011,Bexley 011E,E01000436,1224,891,333,208,53,72
2011,Bexley 013A,E01000401,1164,805,359,179,69,111
2011,Bexley 013B,E01000453,1063,813,250,133,43,74
2011,Bexley 013C,E01000454,1143,819,324,162,45,117
2011,Bexley 013D,E01000455,1212,900,312,141,73,98
2011,Bexley 013E,E01000456,1026,786,240,110,57,73
2011,Bexley 014A,E01000325,1187,882,305,192,53,60
2011,Bexley 014B,E01000326,963,762,201,106,28,67
2011,Bexley 014C,E01000369,1241,898,343,184,56,103
2011,Bexley 014D,E01000370,1136,797,339,209,47,83
2011,Bexley 014E,E01000371,1152,872,280,171,43,66
2011,Bexley 015A,E01000360,1192,903,289,118,53,118
2011,Bexley 015B,E01000362,1039,745,294,173,42,79
2011,Bexley 015C,E01000365,1136,803,333,181,54,98
2011,Bexley 015D,E01000366,1180,922,258,136,42,80
2011,Bexley 015E,E01000394,1020,733,287,181,42,64
2011,Bexley 016A,E01000388,1101,714,387,233,54,100
2011,Bexley 016B,E01000392,1165,879,286,72,68,146
2011,Bexley 016C,E01000409,1210,909,301,168,54,79
2011,Bexley 016D,E01000411,1028,743,285,151,59,75
2011,Bexley 016E,E01000414,1209,861,348,150,72,126
2011,Bexley 016F,E01000415,1114,804,310,145,70,95
2011,Bexley 017A,E01000327,1105,786,319,205,56,58
2011,Bexley 017B,E01000328,1100,783,317,187,41,89
2011,Bexley 017C,E01000329,950,670,280,140,54,86
2011,Bexley 017D,E01000330,1086,766,320,166,50,104
2011,Bexley 017E,E01000331,1117,765,352,159,59,134
2011,Bexley 018A,E01000340,1077,781,296,167,42,87
2011,Bexley 018B,E01000395,1067,777,290,154,78,58
2011,Bexley 018C,E01000396,1026,772,254,139,48,67
2011,Bexley 018D,E01000410,1152,877,275,145,56,74
2011,Bexley 018E,E01000412,1194,922,272,121,69,82
2011,Bexley 018F,E01000413,966,748,218,104,47,67
2011,Bexley 019A,E01000374,997,653,344,117,58,169
2011,Bexley 019B,E01000375,1078,756,322,129,76,117
2011,Bexley 019C,E01000376,1085,806,279,146,33,100
2011,Bexley 019D,E01000377,1052,772,280,174,32,74
2011,Bexley 019E,E01000378,1535,1159,376,156,64,156
2011,Bexley 019F,E01000379,1184,857,327,149,58,120
2011,Bexley 020A,E01000348,1085,788,297,179,49,69
2011,Bexley 020B,E01000349,1144,820,324,205,38,81
2011,Bexley 020C,E01000361,1145,878,267,125,55,87
2011,Bexley 020D,E01000363,1091,796,295,166,59,70
2011,Bexley 020E,E01000389,1216,884,332,189,47,96
2011,Bexley 020F,E01000390,935,663,272,135,52,85
2011,Bexley 020G,E01000393,1199,910,289,147,62,80
2011,Bexley 021A,E01000346,1154,877,277,155,43,79
2011,Bexley 021B,E01000347,1076,785,291,157,56,78
2011,Bexley 021C,E01000350,1109,816,293,150,67,76
2011,Bexley 021D,E01000352,1130,819,311,174,52,85
2011,Bexley 021E,E01000391,1249,939,310,130,74,106
2011,Bexley 022A,E01000341,1047,751,296,187,35,74
2011,Bexley 022B,E01000342,1191,917,274,141,57,76
2011,Bexley 022C,E01000343,1098,799,299,133,70,96
2011,Bexley 022D,E01000345,1001,736,265,132,58,75
2011,Bexley 022E,E01000460,1075,792,283,134,73,76
2011,Bexley 023A,E01000364,1134,810,324,178,51,95
2011,Bexley 023B,E01000444,1190,823,367,221,67,79
2011,Bexley 023C,E01000447,1102,855,247,125,47,75
2011,Bexley 023D,E01000448,939,666,273,170,48,55
2011,Bexley 023E,E01000449,1002,681,321,193,49,79
2011,Bexley 024A,E01000351,1176,862,314,180,59,75
2011,Bexley 024B,E01000443,908,643,265,138,45,82
2011,Bexley 024C,E01000445,1169,784,385,245,58,82
2011,Bexley 024D,E01000446,1174,923,251,143,33,75
2011,Bexley 024E,E01000461,1255,933,322,172,77,73
2011,Bexley 025A,E01000339,1085,776,309,160,44,105
2011,Bexley 025B,E01000344,1132,834,298,158,67,73
2011,Bexley 025C,E01000423,1154,851,303,182,49,72
2011,Bexley 025D,E01000425,1201,871,330,199,48,83
2011,Bexley 025E,E01000463,920,685,235,118,50,67
2011,Bexley 026A,E01000424,1280,926,354,201,61,92
2011,Bexley 026B,E01000426,1233,948,285,141,52,92
2011,Bexley 026C,E01000427,1350,930,420,220,69,131
2011,Bexley 026D,E01000457,1311,943,368,146,124,98
2011,Bexley 026E,E01000462,1135,787,348,145,118,85
2011,Bexley 027A,E01000382,1096,759,337,206,49,82
2011,Bexley 027B,E01000384,1222,898,324,135,80,109
2011,Bexley 027C,E01000387,1095,771,324,176,58,90
2011,Bexley 027D,E01000428,1248,845,403,152,131,120
2011,Bexley 027E,E01000458,1046,735,311,191,65,55
2011,Bexley 027F,E01000459,1168,770,398,192,94,112
2011,Bexley 028A,E01000381,1104,775,329,134,51,144
2011,Bexley 028B,E01000383,1088,745,343,198,43,102
2011,Bexley 028C,E01000385,1270,881,389,132,63,194
2011,Bexley 028D,E01000386,984,638,346,102,62,182
2011,Bexley 029A,E01000398,1132,789,343,164,62,117
2011,Bexley 029B,E01000399,1136,787,349,197,57,95
2011,Bexley 029C,E01000400,1109,803,306,142,62,102
2011,Bexley 029D,E01032566,1212,841,371,176,52,143
2011,Brent 001A,E01000587,1231,840,391,136,96,159
2011,Brent 001B,E01000589,1466,1007,459,173,93,193
2011,Brent 001C,E01000590,1329,922,407,162,87,158
2011,Brent 001D,E01000592,1244,861,383,149,85,149
2011,Brent 001E,E01000593,1590,1136,454,146,133,175
2011,Brent 001F,E01000594,1266,883,383,128,101,154
2011,Brent 002A,E01000513,1212,837,375,104,112,159
2011,Brent 002B,E01000514,1130,858,272,80,74,118
2011,Brent 002C,E01000516,1304,910,394,116,91,187
2011,Brent 002D,E01000520,1196,786,410,122,86,202
2011,Brent 002E,E01000588,1568,1068,500,106,167,227
2011,Brent 003A,E01000515,1252,870,382,76,114,192
2011,Brent 003B,E01000517,1208,830,378,133,98,147
2011,Brent 003E,E01000543,1213,847,366,123,104,139
2011,Brent 003F,E01000591,1582,1041,541,149,173,219
2011,Brent 003G,E01033463,2168,1469,699,265,213,221
2011,Brent 004A,E01000536,1219,859,360,156,100,104
2011,Brent 004B,E01000538,1168,829,339,142,105,92
2011,Brent 004C,E01000539,1153,812,341,166,84,91
2011,Brent 004D,E01000540,1138,790,348,158,89,101
2011,Brent 004E,E01000541,1043,767,276,102,69,105
2011,Brent 005A,E01000518,1202,816,386,111,119,156
2011,Brent 005B,E01000519,1387,921,466,115,163,188
2011,Brent 005C,E01000623,1304,916,388,111,105,172
2011,Brent 005D,E01000624,1205,816,389,144,92,153
2011,Brent 005E,E01000629,1466,1043,423,134,108,181
2011,Brent 006A,E01000480,1332,924,408,131,130,147
2011,Brent 006B,E01000484,886,564,322,89,83,150
2011,Brent 006C,E01000485,1026,695,331,107,92,132
2011,Brent 006D,E01000486,1259,885,374,121,116,137
2011,Brent 006E,E01000487,1398,967,431,115,113,203
2011,Brent 007A,E01000572,1090,781,309,121,94,94
2011,Brent 007B,E01000573,1151,793,358,114,97,147
2011,Brent 007C,E01000574,991,717,274,80,93,101
2011,Brent 007D,E01000575,1416,1040,376,111,117,148
2011,Brent 007E,E01000577,1681,1127,554,75,168,311
2011,Brent 008A,E01000562,1175,822,353,157,98,98
2011,Brent 008B,E01000563,1142,773,369,155,119,95
2011,Brent 008C,E01000566,1170,804,366,130,105,131
2011,Brent 008D,E01000568,1962,1328,634,77,460,97
2011,Brent 008E,E01000569,1203,856,347,147,104,96
2011,Brent 009A,E01000479,1231,799,432,151,117,164
2011,Brent 009B,E01000481,1154,806,348,77,107,164
2011,Brent 009C,E01000482,2030,1317,713,131,212,370
2011,Brent 009D,E01000483,1226,815,411,86,105,220
2011,Brent 009E,E01000625,1091,710,381,130,99,152
2011,Brent 010B,E01000498,1130,725,405,99,120,186
2011,Brent 010D,E01000622,1204,865,339,81,77,181
2011,Brent 010E,E01000626,1053,689,364,68,86,210
2011,Brent 010F,E01033464,2045,1311,734,196,210,328
2011,Brent 011A,E01000497,1307,875,432,118,138,176
2011,Brent 011B,E01000499,1189,744,445,109,143,193
2011,Brent 011C,E01000501,1286,832,454,113,114,227
2011,Brent 011D,E01000502,972,639,333,89,78,166
2011,Brent 011E,E01000503,1452,994,458,143,133,182
2011,Brent 012A,E01000570,1181,794,387,120,110,157
2011,Brent 012B,E01000571,1269,823,446,135,120,191
2011,Brent 012C,E01000576,1244,867,377,115,135,127
2011,Brent 012D,E01000578,1323,905,418,129,93,196
2011,Brent 013A,E01000564,1195,826,369,88,99,182
2011,Brent 013B,E01000565,1109,742,367,116,87,164
2011,Brent 013C,E01000607,1661,1140,521,151,169,201
2011,Brent 013D,E01000608,1659,1184,475,112,136,227
2011,Brent 013E,E01000613,1278,907,371,83,93,195
2011,Brent 014A,E01000506,1248,897,351,58,90,203
2011,Brent 014B,E01000509,1080,716,364,102,104,158
2011,Brent 014C,E01000510,1226,822,404,91,123,190
2011,Brent 014D,E01000511,1161,788,373,82,109,182
2011,Brent 014E,E01000627,1372,930,442,113,124,205
2011,Brent 014F,E01000628,1387,941,446,97,134,215
2011,Brent 015A,E01000553,1649,1177,472,128,131,213
2011,Brent 015B,E01000554,1391,1028,363,90,104,169
2011,Brent 015C,E01000555,1132,803,329,77,117,135
2011,Brent 015D,E01000556,1544,1168,376,58,144,174
2011,Brent 015E,E01000557,1535,1160,375,77,126,172
2011,Brent 015F,E01000558,1235,930,305,82,79,144
2011,Brent 016A,E01000567,1008,721,287,115,56,116
2011,Brent 016B,E01000606,1250,866,384,116,89,179
2011,Brent 016C,E01000609,1530,1067,463,124,123,216
2011,Brent 016D,E01000611,1100,761,339,100,86,153
2011,Brent 017B,E01000615,1224,864,360,101,109,150
2011,Brent 017C,E01000617,1343,905,438,124,123,191
2011,Brent 017D,E01000618,1169,766,403,142,84,177
2011,Brent 017E,E01000619,1243,854,389,127,110,152
2011,Brent 017F,E01033424,1207,830,377,18,117,242
2011,Brent 017G,E01033457,1327,1014,313,81,77,155
2011,Brent 018A,E01000504,1362,1030,332,85,99,148
2011,Brent 018B,E01000505,1260,856,404,95,125,184
2011,Brent 018C,E01000507,1255,876,379,104,130,145
2011,Brent 018D,E01000512,1372,1061,311,84,97,130
2011,Brent 018E,E01000559,1212,908,304,95,88,121
2011,Brent 019A,E01000610,1410,992,418,126,97,195
2011,Brent 019B,E01000612,1259,881,378,108,109,161
2011,Brent 019C,E01000631,1466,1003,463,141,133,189
2011,Brent 019D,E01000633,1548,1080,468,116,132,220
2011,Brent 019E,E01000634,1751,1225,526,86,176,264
2011,Brent 020A,E01000616,1372,1022,350,93,106,151
2011,Brent 020B,E01000620,1315,869,446,136,113,197
2011,Brent 020C,E01000621,1362,982,380,113,117,150
2011,Brent 020D,E01000635,1879,1345,534,117,182,235
2011,Brent 020E,E01000636,1415,1016,399,125,120,154
2011,Brent 021A,E01000596,1139,686,453,94,109,250
2011,Brent 021B,E01000601,969,595,374,68,112,194
2011,Brent 021C,E01000602,1064,664,400,102,119,179
2011,Brent 021D,E01000603,1041,715,326,69,86,171
2011,Brent 021E,E01000604,1224,739,485,90,173,222
2011,Brent 021F,E01000605,1131,689,442,83,122,237
2011,Brent 022A,E01000488,1177,823,354,75,114,165
2011,Brent 022B,E01000637,1308,966,342,75,110,157
2011,Brent 022C,E01000639,1462,1183,279,60,108,111
2011,Brent 022D,E01000642,1734,1363,371,87,129,155
2011,Brent 022E,E01000644,1482,1095,387,100,111,176
2011,Brent 023A,E01000490,1346,1116,230,49,61,120
2011,Brent 023B,E01000494,1379,988,391,105,125,161
2011,Brent 023C,E01000495,1287,933,354,119,82,153
2011,Brent 023D,E01000560,1349,1031,318,69,120,129
2011,Brent 023E,E01000561,1423,1062,361,80,105,176
2011,Brent 024A,E01000638,1469,1099,370,73,101,196
2011,Brent 024B,E01000640,1631,1161,470,91,140,239
2011,Brent 024C,E01000641,1465,1063,402,83,137,182
2011,Brent 024D,E01000643,1523,939,584,115,157,312
2011,Brent 025A,E01000508,1375,899,476,113,112,251
2011,Brent 025B,E01000521,1579,1018,561,93,162,306
2011,Brent 025C,E01000522,1317,881,436,103,139,194
2011,Brent 025D,E01000526,1580,986,594,133,179,282
2011,Brent 025E,E01000527,1495,1008,487,109,111,267
2011,Brent 025F,E01000528,1069,687,382,95,112,175
2011,Brent 026A,E01000471,1251,888,363,105,110,148
2011,Brent 026B,E01000474,1496,1008,488,100,134,254
2011,Brent 026C,E01000476,1263,848,415,118,126,171
2011,Brent 026D,E01000477,1422,1006,416,78,113,225
2011,Brent 026E,E01000630,1727,1170,557,127,154,276
2011,Brent 027A,E01000595,1128,660,468,97,132,239
2011,Brent 027D,E01000599,926,618,308,63,98,147
2011,Brent 027E,E01000600,1429,872,557,123,147,287
2011,Brent 027F,E01033456,1491,912,579,142,177,260
2011,Brent 028A,E01000545,1547,1246,301,92,96,113
2011,Brent 028B,E01000546,1329,1026,303,89,79,135
2011,Brent 028C,E01000547,1412,1047,365,93,99,173
2011,Brent 028D,E01000548,1739,1339,400,103,106,191
2011,Brent 028E,E01000549,1564,1263,301,111,63,127
2011,Brent 029A,E01000472,1078,833,245,71,60,114
2011,Brent 029B,E01000473,1491,991,500,127,149,224
2011,Brent 029C,E01000475,1518,1077,441,109,112,220
2011,Brent 029D,E01000478,1279,897,382,134,94,154
2011,Brent 029E,E01000632,1606,1078,528,167,151,210
2011,Brent 030A,E01000489,1160,840,320,95,110,115
2011,Brent 030B,E01000491,1465,1043,422,106,98,218
2011,Brent 030C,E01000492,1001,743,258,94,61,103
2011,Brent 030D,E01000493,1241,909,332,144,79,109
2011,Brent 030E,E01000581,1172,917,255,81,61,113
2011,Brent 031A,E01000523,1887,1329,558,108,146,304
2011,Brent 031B,E01000524,1796,1224,572,107,164,301
2011,Brent 031C,E01000525,1447,1001,446,98,117,231
2011,Brent 031E,E01000533,1676,1192,484,115,103,266
2011,Brent 031F,E01000535,1675,1251,424,91,144,189
2011,Brent 031G,E01033455,902,628,274,50,61,163
2011,Brent 031H,E01033485,1481,980,501,102,137,262
2011,Brent 032A,E01000579,1338,1019,319,93,93,133
2011,Brent 032B,E01000580,1500,1158,342,106,87,149
2011,Brent 032C,E01000582,1392,1090,302,89,74,139
2011,Brent 032D,E01000583,1856,1437,419,95,131,193
2011,Brent 032E,E01000586,2012,1585,427,68,121,238
2011,Brent 033A,E01000530,1438,1105,333,124,83,126
2011,Brent 033B,E01000531,1619,1205,414,110,102,202
2011,Brent 033C,E01000532,1313,1010,303,94,64,145
2011,Brent 033D,E01000534,1325,966,359,91,118,150
2011,Brent 033E,E01000584,1282,974,308,114,78,116
2011,Brent 033F,E01000585,1379,1102,277,87,63,127
2011,Brent 034A,E01000544,1329,919,410,64,121,225
2011,Brent 034B,E01000550,1529,1080,449,115,110,224
2011,Brent 034C,E01000551,1520,1025,495,102,130,263
2011,Brent 034D,E01000552,1263,818,445,90,113,242
2011,Bromley 001A,E01000779,929,675,254,141,37,76
2011,Bromley 001B,E01000780,1058,737,321,144,49,128
2011,Bromley 001C,E01000781,998,660,338,109,60,169
2011,Bromley 001D,E01000782,979,644,335,83,60,192
2011,Bromley 001E,E01000783,1019,691,328,98,64,166
2011,Bromley 001F,E01000785,974,665,309,96,47,166
2011,Bromley 002A,E01000689,974,697,277,117,39,121
2011,Bromley 002B,E01000690,1014,742,272,150,48,74
2011,Bromley 002C,E01000691,1043,767,276,138,46,92
2011,Bromley 002D,E01000692,1162,885,277,165,42,70
2011,Bromley 002E,E01000784,1095,827,268,122,61,85
2011,Bromley 004A,E01000799,1255,992,263,81,70,112
2011,Bromley 004B,E01000802,1326,1026,300,101,69,130
2011,Bromley 004C,E01000803,1200,906,294,104,72,118
2011,Bromley 004D,E01000804,1055,783,272,141,53,78
2011,Bromley 004E,E01000805,1156,863,293,117,62,114
2011,Bromley 005A,E01000740,1339,1071,268,49,81,138
2011,Bromley 005B,E01000741,1289,982,307,76,59,172
2011,Bromley 005C,E01000742,1608,1261,347,70,73,204
2011,Bromley 005D,E01000745,1370,1065,305,83,54,168
2011,Bromley 005E,E01000746,1466,1130,336,115,62,159
2011,Bromley 006A,E01000709,988,733,255,149,26,80
2011,Bromley 006B,E01000710,1296,1017,279,142,40,97
2011,Bromley 006C,E01000711,1390,1102,288,136,43,109
2011,Bromley 006D,E01000714,1500,1235,265,139,45,81
2011,Bromley 006E,E01000718,1514,1106,408,141,81,186
2011,Bromley 007A,E01000645,996,696,300,159,61,80
2011,Bromley 007B,E01000649,1387,1000,387,189,76,122
2011,Bromley 007C,E01000694,1069,726,343,191,53,99
2011,Bromley 007D,E01000695,1047,728,319,160,64,95
2011,Bromley 007E,E01000696,1000,687,313,173,50,90
2011,Bromley 007F,E01000697,1211,961,250,145,42,63
2011,Bromley 008A,E01000674,1174,912,262,121,37,104
2011,Bromley 008B,E01000676,1293,1012,281,93,51,137
2011,Bromley 008C,E01000820,1017,715,302,117,38,147
2011,Bromley 008D,E01000822,1196,905,291,111,62,118
2011,Bromley 008E,E01000823,1295,1030,265,120,55,90
2011,Bromley 008F,E01000824,900,716,184,66,40,78
2011,Bromley 008G,E01000825,1189,887,302,127,46,129
2011,Bromley 009A,E01000743,1300,841,459,130,78,251
2011,Bromley 009B,E01000744,1072,697,375,78,85,212
2011,Bromley 009C,E01000796,1157,767,390,79,120,191
2011,Bromley 009D,E01000798,1112,732,380,96,71,213
2011,Bromley 009E,E01000800,1238,911,327,69,85,173
2011,Bromley 009F,E01000806,1262,949,313,56,91,166
2011,Bromley 010A,E01000693,1019,610,409,197,122,90
2011,Bromley 010B,E01000698,875,564,311,191,44,76
2011,Bromley 010C,E01000736,1068,738,330,126,65,139
2011,Bromley 010D,E01000737,925,601,324,126,41,157
2011,Bromley 011A,E01000672,1093,805,288,167,40,81
2011,Bromley 011B,E01000673,1118,845,273,130,48,95
2011,Bromley 011C,E01000716,1104,793,311,177,53,81
2011,Bromley 011D,E01000717,1295,1008,287,144,50,93
2011,Bromley 011E,E01000828,1131,822,309,168,52,89
2011,Bromley 012A,E01000712,1297,1012,285,149,44,92
2011,Bromley 012B,E01000713,1338,1039,299,161,44,94
2011,Bromley 012C,E01000715,1236,962,274,159,34,81
2011,Bromley 012D,E01000770,998,682,316,203,41,72
2011,Bromley 012E,E01000772,1016,700,316,193,40,83
2011,Bromley 013A,E01000700,1147,894,253,94,50,109
2011,Bromley 013B,E01000702,1031,851,180,81,36,63
2011,Bromley 013C,E01000703,1193,946,247,104,56,87
2011,Bromley 013D,E01000706,968,726,242,104,40,98
2011,Bromley 013E,E01000797,1210,913,297,133,48,116
2011,Bromley 014A,E01000729,1238,781,457,131,63,263
2011,Bromley 014B,E01000730,1143,753,390,82,98,210
2011,Bromley 014C,E01000735,1034,693,341,119,65,157
2011,Bromley 014D,E01000738,1055,758,297,160,48,89
2011,Bromley 014E,E01000739,995,615,380,123,53,204
2011,Bromley 015A,E01000699,1096,855,241,56,62,123
2011,Bromley 015B,E01000701,1028,796,232,91,32,109
2011,Bromley 015C,E01000704,1039,808,231,112,60,59
2011,Bromley 015D,E01000705,982,757,225,81,50,94
2011,Bromley 015E,E01000801,1052,785,267,105,50,112
2011,Bromley 016A,E01000646,1163,858,305,138,49,118
2011,Bromley 016B,E01000647,1154,912,242,101,58,83
2011,Bromley 016C,E01000648,1245,952,293,121,56,116
2011,Bromley 016D,E01000653,1093,690,403,226,60,117
2011,Bromley 016E,E01000678,1239,936,303,120,69,114
2011,Bromley 018A,E01000670,1461,1133,328,161,67,100
2011,Bromley 018B,E01000675,1226,948,278,129,61,88
2011,Bromley 018C,E01000677,1325,1101,224,95,41,88
2011,Bromley 018D,E01000762,1156,834,322,193,49,80
2011,Bromley 018E,E01000829,1264,1001,263,128,45,90
2011,Bromley 019A,E01000719,1330,948,382,133,70,179
2011,Bromley 019B,E01000720,1143,774,369,111,63,195
2011,Bromley 019C,E01000721,897,532,365,121,71,173
2011,Bromley 019D,E01000724,1130,759,371,96,84,191
2011,Bromley 019E,E01000728,1071,688,383,218,32,133
2011,Bromley 020A,E01000651,1079,794,285,164,44,77
2011,Bromley 020B,E01000668,1193,930,263,116,52,95
2011,Bromley 020C,E01000669,1194,938,256,108,45,103
2011,Bromley 020D,E01000671,1264,954,310,164,54,92
2011,Bromley 020E,E01000679,1188,942,246,124,48,74
2011,Bromley 021A,E01000826,1163,810,353,209,80,64
2011,Bromley 021B,E01000827,1196,828,368,218,54,96
2011,Bromley 021C,E01000830,1089,745,344,189,60,95
2011,Bromley 021D,E01000831,1158,833,325,197,47,81
2011,Bromley 021E,E01000833,998,706,292,155,57,80
2011,Bromley 022A,E01000650,1315,898,417,202,78,137
2011,Bromley 022B,E01000652,1158,834,324,197,56,71
2011,Bromley 022C,E01000807,1098,754,344,189,61,94
2011,Bromley 022D,E01000809,1053,773,280,184,40,56
2011,Bromley 023A,E01000722,1173,843,330,154,46,130
2011,Bromley 023B,E01000725,1174,853,321,138,51,132
2011,Bromley 023C,E01000731,940,651,289,111,53,125
2011,Bromley 023D,E01000732,1052,713,339,174,49,116
2011,Bromley 023E,E01000733,1138,835,303,143,46,114
2011,Bromley 024A,E01000769,1063,716,347,99,58,190
2011,Bromley 024B,E01000773,1006,730,276,149,51,76
2011,Bromley 024C,E01000775,1547,1146,401,179,89,133
2011,Bromley 024D,E01000777,1098,830,268,118,69,81
2011,Bromley 024E,E01000778,1122,833,289,126,62,101
2011,Bromley 025A,E01000808,1115,746,369,213,49,107
2011,Bromley 025B,E01000810,1078,728,350,224,45,81
2011,Bromley 025C,E01000811,979,714,265,151,38,76
2011,Bromley 025D,E01000813,1118,762,356,232,42,82
2011,Bromley 025E,E01000815,1105,752,353,216,61,76
2011,Bromley 026A,E01000661,1108,699,409,125,81,203
2011,Bromley 026B,E01000662,1220,874,346,124,69,153
2011,Bromley 026C,E01000663,1104,780,324,149,52,123
2011,Bromley 026D,E01000664,1136,818,318,129,71,118
2011,Bromley 027A,E01000763,1047,749,298,168,50,80
2011,Bromley 027B,E01000764,1122,802,320,157,65,98
2011,Bromley 027C,E01000766,1213,883,330,192,53,85
2011,Bromley 027D,E01000767,1144,856,288,165,42,81
2011,Bromley 027E,E01000834,956,729,227,108,59,60
2011,Bromley 028A,E01000727,1114,797,317,177,41,99
2011,Bromley 028B,E01000734,945,708,237,116,34,87
2011,Bromley 028C,E01000790,1481,1113,368,149,76,143
2011,Bromley 028D,E01000812,1136,788,348,199,43,106
2011,Bromley 028E,E01000814,1156,794,362,210,68,84
2011,Bromley 029A,E01000723,914,608,306,205,28,73
2011,Bromley 029B,E01000726,947,674,273,167,35,71
2011,Bromley 029C,E01000787,1000,691,309,190,42,77
2011,Bromley 029D,E01000788,1122,792,330,174,50,106
2011,Bromley 029E,E01000791,991,683,308,204,41,63
2011,Bromley 030A,E01000832,1056,755,301,175,62,64
2011,Bromley 030B,E01000835,1119,836,283,141,57,85
2011,Bromley 030C,E01000836,983,743,240,123,65,52
2011,Bromley 030D,E01000837,1017,725,292,161,46,85
2011,Bromley 030E,E01000838,982,694,288,169,59,60
2011,Bromley 030F,E01000839,1106,797,309,185,62,62
2011,Bromley 030G,E01000840,1048,710,338,234,45,59
2011,Bromley 030H,E01000841,1108,811,297,169,51,77
2011,Bromley 031A,E01000753,1186,788,398,269,49,80
2011,Bromley 031B,E01000754,1165,843,322,173,62,87
2011,Bromley 031C,E01000755,1027,733,294,186,55,53
2011,Bromley 031D,E01000757,1097,731,366,245,57,64
2011,Bromley 031E,E01000758,1037,756,281,177,59,45
2011,Bromley 032A,E01000786,986,651,335,235,32,68
2011,Bromley 032B,E01000789,1121,745,376,65,71,240
2011,Bromley 032C,E01000792,773,517,256,152,40,64
2011,Bromley 032D,E01000793,1131,763,368,241,48,79
2011,Bromley 032E,E01000795,984,695,289,151,42,96
2011,Bromley 033A,E01000665,1296,965,331,168,53,110
2011,Bromley 033B,E01000666,1304,896,408,253,54,101
2011,Bromley 033C,E01000667,1118,741,377,225,50,102
2011,Bromley 033D,E01000756,1094,726,368,201,57,110
2011,Bromley 034A,E01000759,1113,815,298,164,58,76
2011,Bromley 034B,E01000760,1029,767,262,145,51,66
2011,Bromley 034C,E01000761,1131,832,299,175,57,67
2011,Bromley 034D,E01000765,1221,905,316,155,64,97
2011,Bromley 034E,E01000768,1116,766,350,183,95,72
2011,Bromley 035A,E01000681,1221,924,297,165,50,82
2011,Bromley 035B,E01000682,1035,741,294,170,59,65
2011,Bromley 035C,E01000683,1170,882,288,137,42,109
2011,Bromley 035D,E01000684,1456,1070,386,219,59,108
2011,Bromley 035E,E01000794,1124,749,375,258,35,82
2011,Bromley 036A,E01000749,1132,758,374,244,43,87
2011,Bromley 036B,E01000750,1088,716,372,166,71,135
2011,Bromley 036C,E01000751,1368,1012,356,166,57,133
2011,Bromley 036D,E01000752,1050,714,336,224,29,83
2011,Bromley 037A,E01000680,1192,834,358,231,34,93
2011,Bromley 037B,E01000685,1107,824,283,126,47,110
2011,Bromley 037C,E01000686,1069,766,303,188,32,83
2011,Bromley 037D,E01000687,1161,825,336,205,45,86
2011,Bromley 037E,E01000688,985,711,274,165,40,69
2011,Bromley 039A,E01000654,959,762,197,110,26,61
2011,Bromley 039B,E01000655,979,755,224,116,34,74
2011,Bromley 039C,E01000656,1070,821,249,148,37,64
2011,Bromley 039D,E01000657,1171,898,273,155,43,75
2011,Bromley 039E,E01000659,1112,886,226,131,50,45
2011,Bromley 040A,E01000816,1102,801,301,157,46,98
2011,Bromley 040B,E01000818,1072,779,293,159,48,86
2011,Bromley 040C,E01000819,1183,821,362,126,70,166
2011,Bromley 040D,E01032562,1021,687,334,96,68,170
2011,Bromley 040E,E01032563,1002,697,305,181,38,86
2011,Bromley 041A,E01000707,1009,820,189,84,33,72
2011,Bromley 041B,E01000708,1107,842,265,128,45,92
2011,Bromley 041C,E01000771,1188,906,282,150,58,74
2011,Bromley 041D,E01000774,1062,790,272,150,41,81
2011,Bromley 041E,E01032568,1059,780,279,106,48,125
2011,Bromley 042A,E01000658,1006,679,327,231,41,55
2011,Bromley 042B,E01000747,1374,992,382,192,44,146
2011,Bromley 042C,E01000748,1190,800,390,256,35,99
2011,Bromley 042D,E01032570,1124,793,331,200,49,82
2011,Croydon 001A,E01001137,1340,1009,331,137,62,132
2011,Croydon 001B,E01001138,1180,949,231,77,59,95
2011,Croydon 001C,E01001156,1183,885,298,89,83,126
2011,Croydon 001D,E01001162,1261,921,340,104,71,165
2011,Croydon 001E,E01001164,1550,1268,282,79,49,154
2011,Croydon 002A,E01001084,1314,929,385,176,80,129
2011,Croydon 002B,E01001157,1259,884,375,144,91,140
2011,Croydon 002C,E01001159,1339,946,393,159,84,150
2011,Croydon 002D,E01001160,1437,985,452,175,136,141
2011,Croydon 002E,E01001163,1417,1075,342,124,90,128
2011,Croydon 003A,E01001083,1158,801,357,154,99,104
2011,Croydon 003B,E01001086,1317,932,385,143,100,142
2011,Croydon 003C,E01001087,1692,1230,462,126,136,200
2011,Croydon 003D,E01001161,1327,829,498,122,145,231
2011,Croydon 004A,E01001085,1138,788,350,133,81,136
2011,Croydon 004B,E01001088,1205,882,323,105,88,130
2011,Croydon 004C,E01001089,1293,884,409,123,107,179
2011,Croydon 004D,E01001090,1629,1165,464,118,130,216
2011,Croydon 004E,E01001091,1187,851,336,148,73,115
2011,Croydon 005A,E01001147,1105,766,339,78,94,167
2011,Croydon 005B,E01001148,1158,882,276,83,72,121
2011,Croydon 005C,E01001151,1138,773,365,103,96,166
2011,Croydon 005D,E01001152,1176,870,306,67,75,164
2011,Croydon 005E,E01001158,1141,855,286,96,78,112
2011,Croydon 006A,E01001146,1190,871,319,109,86,124
2011,Croydon 006B,E01001149,1102,837,265,83,79,103
2011,Croydon 006C,E01001150,1186,893,293,97,96,100
2011,Croydon 006D,E01001153,1160,873,287,83,98,106
2011,Croydon 006E,E01001154,1353,995,358,78,108,172
2011,Croydon 007A,E01001136,1401,1034,367,86,78,203
2011,Croydon 007B,E01001139,1196,898,298,116,75,107
2011,Croydon 007C,E01001140,1211,969,242,81,59,102
2011,Croydon 007D,E01001142,1119,825,294,118,62,114
2011,Croydon 007E,E01001144,1250,878,372,57,106,209
2011,Croydon 008A,E01001141,909,661,248,62,61,125
2011,Croydon 008B,E01001143,1371,963,408,133,88,187
2011,Croydon 008C,E01001145,1210,842,368,58,106,204
2011,Croydon 008D,E01001191,1319,1018,301,73,64,164
2011,Croydon 008E,E01001192,1155,875,280,73,62,145
2011,Croydon 009A,E01000994,1153,803,350,106,97,147
2011,Croydon 009B,E01000995,1137,813,324,90,100,134
2011,Croydon 009C,E01000996,949,691,258,93,75,90
2011,Croydon 009D,E01000997,1005,708,297,86,79,132
2011,Croydon 009E,E01000999,1016,708,308,95,81,132
2011,Croydon 009F,E01001002,969,689,280,84,96,100
2011,Croydon 010A,E01000998,1170,838,332,80,90,162
2011,Croydon 010B,E01001000,945,701,244,82,72,90
2011,Croydon 010C,E01001003,1081,805,276,80,63,133
2011,Croydon 010D,E01001111,1166,848,318,72,123,123
2011,Croydon 010E,E01001155,1169,737,432,152,89,191
2011,Croydon 011A,E01001174,1146,793,353,130,106,117
2011,Croydon 011B,E01001175,1093,744,349,85,100,164
2011,Croydon 011C,E01001176,1321,898,423,100,126,197
2011,Croydon 011D,E01001182,1009,672,337,92,88,157
2011,Croydon 011E,E01001183,1168,806,362,105,101,156
2011,Croydon 011F,E01001184,995,672,323,124,101,98
2011,Croydon 013A,E01001001,861,599,262,68,67,127
2011,Croydon 013B,E01001109,1367,912,455,135,107,213
2011,Croydon 013C,E01001112,1215,882,333,90,99,144
2011,Croydon 013D,E01001113,1299,978,321,79,77,165
2011,Croydon 013E,E01001114,961,675,286,41,81,164
2011,Croydon 013F,E01001116,973,708,265,57,83,125
2011,Croydon 014A,E01000992,1370,967,403,92,100,211
2011,Croydon 014B,E01001185,1231,927,304,92,72,140
2011,Croydon 014C,E01001186,1280,919,361,119,77,165
2011,Croydon 014D,E01001188,1306,967,339,79,91,169
2011,Croydon 014E,E01001193,1225,834,391,54,132,205
2011,Croydon 015A,E01001004,1470,1052,418,55,129,234
2011,Croydon 015B,E01001115,1172,754,418,112,126,180
2011,Croydon 015C,E01001117,2028,1449,579,116,143,320
2011,Croydon 015D,E01001178,959,614,345,37,97,211
2011,Croydon 015E,E01001181,1290,902,388,80,96,212
2011,Croydon 016A,E01001006,1045,773,272,48,67,157
2011,Croydon 016B,E01001007,1396,967,429,100,127,202
2011,Croydon 016C,E01001177,1132,773,359,56,126,177
2011,Croydon 016D,E01001179,1071,764,307,89,85,133
2011,Croydon 016E,E01001180,1205,887,318,71,97,150
2011,Croydon 017A,E01000980,1045,783,262,61,77,124
2011,Croydon 017B,E01000981,1187,923,264,87,59,118
2011,Croydon 017C,E01000982,1213,931,282,85,56,141
2011,Croydon 017D,E01000983,1311,1025,286,112,74,100
2011,Croydon 017E,E01001187,1430,1073,357,81,100,176
2011,Croydon 018A,E01000989,1235,935,300,151,67,82
2011,Croydon 018B,E01000991,1212,902,310,203,45,62
2011,Croydon 018C,E01001131,1127,854,273,154,46,73
2011,Croydon 018D,E01001132,1111,768,343,223,72,48
2011,Croydon 018E,E01001134,1234,932,302,142,62,98
2011,Croydon 019A,E01001005,1172,847,325,75,86,164
2011,Croydon 019B,E01001008,1110,743,367,79,111,177
2011,Croydon 019C,E01001009,1262,899,363,60,125,178
2011,Croydon 019D,E01001010,1040,742,298,74,64,160
2011,Croydon 019E,E01001011,1409,1003,406,80,107,219
2011,Croydon 020A,E01001012,1440,981,459,77,112,270
2011,Croydon 020B,E01001013,1445,901,544,110,132,302
2011,Croydon 020C,E01001048,1471,1148,323,74,72,177
2011,Croydon 020D,E01001110,1335,985,350,54,102,194
2011,Croydon 020E,E01001118,1354,885,469,115,125,229
2011,Croydon 021A,E01000985,1085,800,285,155,56,74
2011,Croydon 021B,E01000986,1262,919,343,153,71,119
2011,Croydon 021C,E01000987,1088,820,268,133,66,69
2011,Croydon 021D,E01000993,1194,897,297,132,73,92
2011,Croydon 022A,E01000975,1287,998,289,82,66,141
2011,Croydon 022B,E01000976,1452,1082,370,124,78,168
2011,Croydon 022C,E01000977,1350,994,356,126,45,185
2011,Croydon 022D,E01000978,1424,1124,300,94,72,134
2011,Croydon 022E,E01000979,1348,1083,265,91,49,125
2011,Croydon 022F,E01000984,1325,955,370,111,67,192
2011,Croydon 023A,E01001044,1392,1025,367,170,54,143
2011,Croydon 023B,E01001046,1310,977,333,139,63,131
2011,Croydon 023C,E01001049,1058,691,367,153,95,119
2011,Croydon 023D,E01001050,1123,776,347,161,57,129
2011,Croydon 024A,E01001014,1952,1478,474,93,106,275
2011,Croydon 024B,E01001042,1417,1089,328,58,87,183
2011,Croydon 024C,E01001165,1238,989,249,89,64,96
2011,Croydon 024D,E01001166,1328,971,357,100,73,184
2011,Croydon 024E,E01001168,1318,991,327,107,83,137
2011,Croydon 025A,E01001127,1210,879,331,194,53,84
2011,Croydon 025B,E01001128,1071,699,372,98,98,176
2011,Croydon 025C,E01001130,1053,681,372,39,115,218
2011,Croydon 025D,E01001135,1211,903,308,176,66,66
2011,Croydon 026A,E01001062,1156,802,354,209,74,71
2011,Croydon 026B,E01001063,1167,858,309,159,71,79
2011,Croydon 026C,E01001064,1173,794,379,220,69,90
2011,Croydon 026D,E01001129,1092,813,279,162,56,61
2011,Croydon 026E,E01001133,1053,716,337,223,44,70
2011,Croydon 027A,E01001035,1399,1127,272,81,75,116
2011,Croydon 027B,E01001043,2052,1628,424,66,112,246
2011,Croydon 027C,E01001045,1457,1135,322,93,50,179
2011,Croydon 027D,E01001047,1352,1054,298,102,73,123
2011,Croydon 027E,E01001170,1496,1122,374,95,76,203
2011,Croydon 028A,E01001167,1599,1200,399,130,103,166
2011,Croydon 028B,E01001169,1142,772,370,103,90,177
2011,Croydon 028C,E01001171,1124,737,387,125,71,191
2011,Croydon 028D,E01001172,1198,763,435,96,94,245
2011,Croydon 028E,E01001173,1856,1382,474,159,112,203
2011,Croydon 029A,E01001036,1114,782,332,153,64,115
2011,Croydon 029B,E01001037,1033,841,192,54,43,95
2011,Croydon 029C,E01001038,1488,1202,286,91,47,148
2011,Croydon 029D,E01001039,1091,811,280,141,61,78
2011,Croydon 029E,E01001040,1287,1033,254,92,45,117
2011,Croydon 030A,E01001051,996,631,365,144,58,163
2011,Croydon 030B,E01001052,918,602,316,91,60,165
2011,Croydon 030C,E01001054,1171,751,420,126,86,208
2011,Croydon 030D,E01001056,1093,686,407,63,95,249
2011,Croydon 030E,E01001057,1085,665,420,51,104,265
2011,Croydon 031A,E01001033,1180,920,260,105,60,95
2011,Croydon 031B,E01001034,1184,944,240,80,51,109
2011,Croydon 031C,E01001041,1203,949,254,75,52,127
2011,Croydon 031D,E01001095,1112,868,244,71,62,111
2011,Croydon 031E,E01001100,1093,824,269,146,43,80
2011,Croydon 032A,E01001053,1022,699,323,128,52,143
2011,Croydon 032B,E01001055,1098,731,367,132,68,167
2011,Croydon 032C,E01001077,1032,770,262,138,40,84
2011,Croydon 032D,E01001078,966,668,298,85,59,154
2011,Croydon 032E,E01001082,1102,765,337,101,58,178
2011,Croydon 033A,E01001120,931,716,215,121,41,53
2011,Croydon 033B,E01001122,1205,865,340,143,128,69
2011,Croydon 033C,E01001123,1068,741,327,196,64,67
2011,Croydon 033D,E01001124,1159,807,352,227,57,68
2011,Croydon 033E,E01001125,1254,893,361,173,72,116
2011,Croydon 034A,E01001058,941,704,237,126,38,73
2011,Croydon 034B,E01001059,1086,811,275,132,48,95
2011,Croydon 034C,E01001060,1152,885,267,116,61,90
2011,Croydon 034D,E01001061,1124,845,279,100,56,123
2011,Croydon 034E,E01001065,1026,783,243,138,35,70
2011,Croydon 034F,E01001066,910,602,308,106,64,138
2011,Croydon 034G,E01001119,1135,860,275,178,33,64
2011,Croydon 034H,E01001126,1061,765,296,197,36,63
2011,Croydon 035A,E01001032,968,679,289,186,42,61
2011,Croydon 035B,E01001101,1035,756,279,154,59,66
2011,Croydon 035C,E01001102,996,681,315,161,58,96
2011,Croydon 035D,E01001107,1213,857,356,194,60,102
2011,Croydon 035E,E01001108,1235,881,354,214,54,86
2011,Croydon 036A,E01001076,1086,740,346,116,57,173
2011,Croydon 036B,E01001079,1113,748,365,111,75,179
2011,Croydon 036C,E01001080,1062,640,422,114,61,247
2011,Croydon 036D,E01001081,957,625,332,105,58,169
2011,Croydon 037A,E01001073,1109,836,273,114,51,108
2011,Croydon 037B,E01001092,1221,792,429,171,76,182
2011,Croydon 037C,E01001093,1233,908,325,103,78,144
2011,Croydon 037D,E01001096,1145,801,344,185,72,87
2011,Croydon 037E,E01001097,1594,1220,374,132,69,173
2011,Croydon 037F,E01001098,1063,777,286,152,49,85
2011,Croydon 038A,E01001028,1188,832,356,178,80,98
2011,Croydon 038B,E01001029,1183,835,348,131,68,149
2011,Croydon 038C,E01001030,1020,727,293,117,68,108
2011,Croydon 038D,E01001031,1087,809,278,142,61,75
2011,Croydon 038E,E01001094,1142,762,380,175,79,126
2011,Croydon 039A,E01001103,1127,783,344,213,46,85
2011,Croydon 039B,E01001105,1194,859,335,145,76,114
2011,Croydon 039C,E01001106,1051,771,280,124,45,111
2011,Croydon 039D,E01001121,1030,712,318,211,39,68
2011,Croydon 040A,E01001069,969,704,265,130,38,97
2011,Croydon 040B,E01001070,1164,830,334,163,66,105
2011,Croydon 040C,E01001075,1084,832,252,113,38,101
2011,Croydon 040D,E01001099,1084,796,288,108,64,116
2011,Croydon 041A,E01001015,1036,733,303,130,60,113
2011,Croydon 041B,E01001016,1227,856,371,212,64,95
2011,Croydon 041C,E01001023,957,732,225,101,43,81
2011,Croydon 041D,E01001067,1174,873,301,166,46,89
2011,Croydon 041E,E01001074,1464,1080,384,157,81,146
2011,Croydon 042A,E01001068,1379,1034,345,148,77,120
2011,Croydon 042B,E01001071,1374,1079,295,141,43,111
2011,Croydon 042C,E01001072,1035,698,337,200,54,83
2011,Croydon 042D,E01001104,1224,927,297,155,63,79
2011,Croydon 043A,E01001017,1208,867,341,216,38,87
2011,Croydon 043B,E01001024,1062,788,274,133,65,76
2011,Croydon 043C,E01001025,940,700,240,142,41,57
2011,Croydon 043D,E01001026,1245,942,303,153,55,95
2011,Croydon 043E,E01001027,1140,853,287,140,51,96
2011,Croydon 044A,E01001018,1113,845,268,168,32,68
2011,Croydon 044B,E01001019,1088,773,315,197,53,65
2011,Croydon 044C,E01001020,1159,831,328,191,56,81
2011,Croydon 044D,E01001021,858,557,301,127,56,118
2011,Croydon 044E,E01001022,1001,676,325,212,45,68
2011,Croydon 045A,E01000990,1000,650,350,127,83,140
2011,Croydon 045B,E01001189,879,668,211,59,66,86
2011,Croydon 045C,E01001190,1112,856,256,73,71,112
2011,Croydon 045D,E01001194,1141,895,246,67,70,109
2011,Croydon 045E,E01032569,1180,779,401,88,106,207
2011,Ealing 001A,E01001269,1465,1142,323,107,82,134
2011,Ealing 001B,E01001271,1345,999,346,124,88,134
2011,Ealing 001C,E01001309,1366,1004,362,138,86,138
2011,Ealing 001D,E01001310,1346,977,369,105,98,166
2011,Ealing 001E,E01001311,1494,992,502,133,94,275
2011,Ealing 002A,E01001307,1400,1070,330,126,79,125
2011,Ealing 002B,E01001308,1541,1123,418,179,110,129
2011,Ealing 002C,E01001312,1360,1018,342,109,80,153
2011,Ealing 002D,E01001313,1295,950,345,134,94,117
2011,Ealing 002E,E01001314,1194,912,282,117,68,97
2011,Ealing 003A,E01001315,1091,800,291,98,66,127
2011,Ealing 003B,E01001316,1105,764,341,91,53,197
2011,Ealing 003C,E01001317,1302,911,391,93,91,207
2011,Ealing 003D,E01001318,1217,823,394,93,89,212
2011,Ealing 003E,E01001320,1021,666,355,77,97,181
2011,Ealing 003F,E01001321,1449,988,461,166,100,195
2011,Ealing 004A,E01001270,1281,948,333,112,89,132
2011,Ealing 004B,E01001319,1071,769,302,101,68,133
2011,Ealing 004C,E01001322,1289,934,355,113,92,150
2011,Ealing 004D,E01001323,1304,953,351,113,87,151
2011,Ealing 005A,E01001341,1283,929,354,111,96,147
2011,Ealing 005B,E01001342,1410,1010,400,103,107,190
2011,Ealing 005C,E01001343,1135,842,293,108,64,121
2011,Ealing 005D,E01001345,1225,837,388,122,104,162
2011,Ealing 006A,E01001265,1264,965,299,84,56,159
2011,Ealing 006B,E01001266,1404,976,428,153,117,158
2011,Ealing 006C,E01001267,1388,944,444,155,79,210
2011,Ealing 006D,E01001272,1213,925,288,99,77,112
2011,Ealing 006E,E01001349,1057,748,309,89,69,151
2011,Ealing 007A,E01001344,1639,1212,427,127,94,206
2011,Ealing 007B,E01001346,1388,988,400,158,85,157
2011,Ealing 007C,E01001347,1189,904,285,101,72,112
2011,Ealing 007D,E01001348,1207,879,328,130,54,144
2011,Ealing 008A,E01001257,1186,760,426,91,103,232
2011,Ealing 008B,E01001324,1133,818,315,63,63,189
2011,Ealing 008C,E01001326,1169,788,381,96,91,194
2011,Ealing 008D,E01001330,1127,739,388,88,63,237
2011,Ealing 008E,E01001332,1091,736,355,84,87,184
2011,Ealing 009A,E01001325,1225,799,426,134,100,192
2011,Ealing 009B,E01001327,1288,855,433,95,114,224
2011,Ealing 009C,E01001328,1184,787,397,96,93,208
2011,Ealing 009D,E01001329,1208,847,361,100,100,161
2011,Ealing 009E,E01001331,1118,740,378,65,94,219
2011,Ealing 010B,E01001258,1242,898,344,127,87,130
2011,Ealing 010C,E01001262,1107,757,350,120,81,149
2011,Ealing 010D,E01001263,1219,801,418,108,92,218
2011,Ealing 010E,E01001264,1131,777,354,100,80,174
2011,Ealing 010F,E01032743,1473,1063,410,44,111,255
2011,Ealing 010G,E01032744,1013,686,327,80,62,185
2011,Ealing 011A,E01001276,1372,1033,339,110,95,134
2011,Ealing 011B,E01001277,1438,1077,361,113,116,132
2011,Ealing 011C,E01001278,1461,1050,411,111,103,197
2011,Ealing 011D,E01001280,1315,949,366,120,88,158
2011,Ealing 012A,E01001218,1350,900,450,126,102,222
2011,Ealing 012B,E01001260,1406,999,407,147,100,160
2011,Ealing 012C,E01001261,1667,1227,440,107,126,207
2011,Ealing 012D,E01001268,1220,879,341,134,61,146
2011,Ealing 013A,E01001209,1235,924,311,126,85,100
2011,Ealing 013B,E01001211,1270,929,341,128,72,141
2011,Ealing 013C,E01001279,1092,759,333,170,69,94
2011,Ealing 013D,E01001281,1091,828,263,122,57,84
2011,Ealing 014A,E01001217,1147,810,337,108,91,138
2011,Ealing 014B,E01001259,1094,807,287,93,63,131
2011,Ealing 014C,E01001291,1210,867,343,109,100,134
2011,Ealing 014D,E01001292,1289,909,380,112,121,147
2011,Ealing 014E,E01001293,1191,831,360,101,111,148
2011,Ealing 015A,E01001196,1276,831,445,86,105,254
2011,Ealing 015B,E01001238,2385,1785,600,71,285,244
2011,Ealing 015C,E01001239,1203,842,361,75,108,178
2011,Ealing 015D,E01001246,1000,755,245,56,72,117
2011,Ealing 015E,E01001247,1688,1232,456,111,122,223
2011,Ealing 016A,E01001210,1174,711,463,131,94,238
2011,Ealing 016B,E01001282,1095,731,364,124,78,162
2011,Ealing 016C,E01001283,1120,720,400,142,76,182
2011,Ealing 016D,E01001285,1221,874,347,92,83,172
2011,Ealing 016E,E01001286,1171,829,342,91,98,153
2011,Ealing 016F,E01001287,1014,667,347,74,100,173
2011,Ealing 017A,E01001294,1457,1006,451,131,117,203
2011,Ealing 017B,E01001295,1376,988,388,113,106,169
2011,Ealing 017C,E01001296,1115,760,355,94,102,159
2011,Ealing 017D,E01001297,1366,924,442,122,127,193
2011,Ealing 017E,E01001298,1400,914,486,145,111,230
2011,Ealing 018A,E01001204,1191,840,351,127,104,120
2011,Ealing 018B,E01001205,1151,796,355,71,113,171
2011,Ealing 018C,E01001206,1133,674,459,61,150,248
2011,Ealing 018D,E01001207,1258,1017,241,79,71,91
2011,Ealing 018E,E01001208,937,661,276,125,71,80
2011,Ealing 018F,E01001212,1207,840,367,147,63,157
2011,Ealing 019A,E01001222,1951,1561,390,70,119,201
2011,Ealing 019B,E01001224,1210,875,335,141,83,111
2011,Ealing 019C,E01001226,1166,888,278,106,69,103
2011,Ealing 019D,E01001227,1137,837,300,101,73,126
2011,Ealing 019E,E01001228,1446,1067,379,112,109,158
2011,Ealing 020A,E01001221,1625,1350,275,86,80,109
2011,Ealing 020B,E01001223,1220,866,354,115,92,147
2011,Ealing 020C,E01001225,1385,1009,376,125,107,144
2011,Ealing 020D,E01001235,1333,1086,247,62,62,123
2011,Ealing 020E,E01001236,1251,954,297,101,75,121
2011,Ealing 020F,E01001273,1208,844,364,106,97,161
2011,Ealing 020G,E01001274,1140,736,404,92,107,205
2011,Ealing 020H,E01001275,1508,1154,354,115,58,181
2011,Ealing 021A,E01001195,1372,882,490,91,210,189
2011,Ealing 021B,E01001197,1228,842,386,100,95,191
2011,Ealing 021C,E01001198,1130,853,277,84,85,108
2011,Ealing 021D,E01001199,1311,988,323,80,87,156
2011,Ealing 022A,E01001284,1139,865,274,120,69,85
2011,Ealing 022B,E01001288,1091,832,259,89,72,98
2011,Ealing 022C,E01001289,1002,774,228,76,58,94
2011,Ealing 022D,E01001290,1423,1100,323,100,102,121
2011,Ealing 023A,E01001213,1407,894,513,140,120,253
2011,Ealing 023B,E01001214,1350,923,427,150,107,170
2011,Ealing 023C,E01001215,1285,808,477,138,123,216
2011,Ealing 023D,E01001216,1158,765,393,112,86,195
2011,Ealing 023E,E01001361,1334,829,505,88,127,290
2011,Ealing 024A,E01001240,1230,864,366,84,139,143
2011,Ealing 024B,E01001241,1157,822,335,98,110,127
2011,Ealing 024C,E01001242,1043,664,379,89,127,163
2011,Ealing 024D,E01001243,1230,856,374,85,125,164
2011,Ealing 024E,E01001244,1934,1380,554,102,215,237
2011,Ealing 024F,E01001245,1520,1207,313,66,108,139
2011,Ealing 025A,E01001200,1177,931,246,65,69,112
2011,Ealing 025B,E01001201,1211,953,258,75,68,115
2011,Ealing 025C,E01001202,1552,1083,469,88,150,231
2011,Ealing 025D,E01001203,1424,1047,377,98,70,209
2011,Ealing 025E,E01001351,1486,1082,404,106,112,186
2011,Ealing 026A,E01001359,1594,1028,566,127,144,295
2011,Ealing 026B,E01001360,1437,923,514,139,156,219
2011,Ealing 026C,E01001362,1511,993,518,104,144,270
2011,Ealing 026D,E01001363,1198,778,420,108,97,215
2011,Ealing 026E,E01001364,1253,714,539,131,152,256
2011,Ealing 026F,E01001365,1652,1058,594,150,140,304
2011,Ealing 027A,E01001231,1444,1044,400,149,123,128
2011,Ealing 027B,E01001234,1156,915,241,69,64,108
2011,Ealing 027C,E01001350,1131,843,288,92,75,121
2011,Ealing 027D,E01001352,1171,901,270,71,91,108
2011,Ealing 027E,E01001354,1398,1066,332,85,113,134
2011,Ealing 028A,E01001249,1776,1276,500,108,121,271
2011,Ealing 028B,E01001250,1619,1171,448,134,68,246
2011,Ealing 028C,E01001255,1200,907,293,105,66,122
2011,Ealing 028D,E01001383,1424,1113,311,118,102,91
2011,Ealing 028E,E01001388,1249,862,387,108,93,186
2011,Ealing 028F,E01001389,1348,1068,280,105,54,121
2011,Ealing 029A,E01001219,1380,813,567,104,151,312
2011,Ealing 029B,E01001220,996,588,408,71,102,235
2011,Ealing 029C,E01001334,1145,678,467,91,123,253
2011,Ealing 029D,E01001337,1129,763,366,83,105,178
2011,Ealing 029E,E01001338,1417,977,440,137,113,190
2011,Ealing 029F,E01001339,1295,791,504,101,133,270
2011,Ealing 029G,E01001340,1521,841,680,49,90,541
2011,Ealing 030A,E01001251,1266,983,283,97,74,112
2011,Ealing 030B,E01001252,1474,1134,340,105,85,150
2011,Ealing 030C,E01001253,1250,969,281,87,75,119
2011,Ealing 030D,E01001254,1257,972,285,109,60,116
2011,Ealing 031A,E01001229,1126,805,321,108,69,144
2011,Ealing 031B,E01001230,1233,969,264,103,54,107
2011,Ealing 031C,E01001232,1182,851,331,122,77,132
2011,Ealing 031D,E01001233,1123,831,292,98,79,115
2011,Ealing 031E,E01001237,1271,997,274,80,73,121
2011,Ealing 031F,E01001386,1366,1038,328,130,95,103
2011,Ealing 032A,E01001303,1243,1007,236,88,66,82
2011,Ealing 032B,E01001382,1106,833,273,117,66,90
2011,Ealing 032C,E01001384,1316,1079,237,85,60,92
2011,Ealing 032D,E01001385,1292,1002,290,125,84,81
2011,Ealing 032E,E01001387,1223,978,245,87,61,97
2011,Ealing 033A,E01001353,1296,957,339,101,81,157
2011,Ealing 033B,E01001355,1327,944,383,130,97,156
2011,Ealing 033C,E01001356,1334,822,512,139,95,278
2011,Ealing 033D,E01001357,787,558,229,43,77,109
2011,Ealing 033E,E01001358,1065,666,399,67,119,213
2011,Ealing 034A,E01001375,1276,1013,263,116,56,91
2011,Ealing 034B,E01001377,1299,926,373,148,85,140
2011,Ealing 034C,E01001379,1278,987,291,108,74,109
2011,Ealing 034D,E01001381,1346,1043,303,95,101,107
2011,Ealing 035A,E01001248,1172,865,307,137,68,102
2011,Ealing 035B,E01001299,1341,978,363,160,104,99
2011,Ealing 035C,E01001305,1292,1001,291,129,77,85
2011,Ealing 035D,E01001306,1223,982,241,115,51,75
2011,Ealing 037A,E01001366,1434,924,510,111,144,255
2011,Ealing 037B,E01001367,1327,859,468,80,134,254
2011,Ealing 037C,E01001368,1266,813,453,110,123,220
2011,Ealing 037D,E01001370,1503,956,547,102,171,274
2011,Ealing 037E,E01001371,1480,974,506,132,134,240
2011,Ealing 037F,E01001372,1341,890,451,77,141,233
2011,Ealing 037G,E01001373,1096,745,351,64,109,178
2011,Ealing 038A,E01001333,1382,905,477,102,102,273
2011,Ealing 038B,E01001335,1308,915,393,155,100,138
2011,Ealing 038C,E01001336,1183,749,434,144,92,198
2011,Ealing 038D,E01001369,1405,938,467,101,120,246
2011,Ealing 039A,E01001300,1227,1010,217,83,61,73
2011,Ealing 039B,E01001301,1481,1024,457,105,272,80
2011,Ealing 039C,E01001302,1220,979,241,100,54,87
2011,Ealing 039D,E01001304,1283,1014,269,107,58,104
2011,Ealing 040A,E01001374,1424,1117,307,112,64,131
2011,Ealing 040B,E01001376,1283,959,324,112,67,145
2011,Ealing 040C,E01001380,1401,1094,307,129,104,74
2011,Ealing 040D,E01032572,1300,1050,250,90,51,109
2011,Enfield 001A,E01001444,1215,857,358,124,105,129
2011,Enfield 001B,E01001446,1291,899,392,120,85,187
2011,Enfield 001C,E01001546,1263,890,373,123,84,166
2011,Enfield 001D,E01001552,1266,902,364,140,80,144
2011,Enfield 002A,E01001442,1047,662,385,86,86,213
2011,Enfield 002B,E01001545,1233,759,474,88,123,263
2011,Enfield 002C,E01001547,1255,835,420,161,76,183
2011,Enfield 002D,E01001548,1264,822,442,131,93,218
2011,Enfield 002E,E01001551,1177,717,460,139,104,217
2011,Enfield 003B,E01001445,1631,1151,480,98,102,280
2011,Enfield 003C,E01001447,1373,872,501,142,108,251
2011,Enfield 003D,E01001448,1292,871,421,98,116,207
2011,Enfield 003E,E01001449,1108,759,349,105,77,167
2011,Enfield 003F,E01033148,1295,858,437,70,128,239
2011,Enfield 003G,E01033150,1145,828,317,20,81,216
2011,Enfield 004A,E01001408,1235,955,280,124,47,109
2011,Enfield 004B,E01001411,1319,998,321,119,68,134
2011,Enfield 004C,E01001412,1336,930,406,176,77,153
2011,Enfield 004D,E01001413,1153,872,281,164,50,67
2011,Enfield 004E,E01001414,1077,658,419,148,83,188
2011,Enfield 005A,E01001407,1174,859,315,119,63,133
2011,Enfield 005B,E01001409,1355,933,422,100,83,239
2011,Enfield 005C,E01001410,1191,811,380,74,70,236
2011,Enfield 005D,E01001516,1286,844,442,140,87,215
2011,Enfield 005E,E01001537,1225,942,283,122,50,111
2011,Enfield 006A,E01001439,1367,834,533,111,111,311
2011,Enfield 006B,E01001441,1093,724,369,97,73,199
2011,Enfield 006C,E01001517,1271,756,515,106,115,294
2011,Enfield 006D,E01001549,1317,838,479,93,96,290
2011,Enfield 006E,E01001550,1147,729,418,115,116,187
2011,Enfield 007A,E01001433,1240,798,442,82,147,213
2011,Enfield 007B,E01001434,1109,760,349,102,83,164
2011,Enfield 007C,E01001435,1042,707,335,109,96,130
2011,Enfield 007D,E01001436,1314,867,447,152,108,187
2011,Enfield 007E,E01001438,1183,763,420,115,126,179
2011,Enfield 008A,E01001469,1186,837,349,134,77,138
2011,Enfield 008B,E01001536,1280,964,316,153,43,120
2011,Enfield 008C,E01001540,1328,1039,289,120,64,105
2011,Enfield 008D,E01001541,1104,884,220,100,35,85
2011,Enfield 008E,E01001542,1102,769,333,136,54,143
2011,Enfield 009A,E01001538,1221,917,304,163,59,82
2011,Enfield 009B,E01001539,1216,910,306,138,56,112
2011,Enfield 009C,E01001543,1176,859,317,155,65,97
2011,Enfield 009D,E01001544,1144,802,342,165,67,110
2011,Enfield 010A,E01001457,1209,903,306,160,55,91
2011,Enfield 010B,E01001468,995,634,361,131,44,186
2011,Enfield 010C,E01001471,1333,1003,330,169,43,118
2011,Enfield 010D,E01001472,1253,936,317,130,63,124
2011,Enfield 010E,E01001474,1377,1052,325,161,63,101
2011,Enfield 011A,E01001415,1110,761,349,159,87,103
2011,Enfield 011B,E01001417,1433,872,561,171,259,131
2011,Enfield 011C,E01001418,1218,811,407,177,103,127
2011,Enfield 011D,E01001422,1196,796,400,144,107,149
2011,Enfield 012A,E01001440,1152,748,404,139,102,163
2011,Enfield 012B,E01001504,1084,690,394,112,101,181
2011,Enfield 012C,E01001505,1241,803,438,99,132,207
2011,Enfield 012D,E01001507,1336,873,463,115,117,231
2011,Enfield 012E,E01001508,1396,921,475,105,119,251
2011,Enfield 012F,E01001513,1208,788,420,94,118,208
2011,Enfield 013A,E01001416,1278,925,353,166,93,94
2011,Enfield 013B,E01001470,1126,776,350,169,95,86
2011,Enfield 013C,E01001473,1099,730,369,180,78,111
2011,Enfield 013D,E01001475,1218,829,389,200,86,103
2011,Enfield 014A,E01001437,1598,1026,572,131,120,321
2011,Enfield 014B,E01001506,1113,700,413,74,111,228
2011,Enfield 014C,E01001509,1236,804,432,93,102,237
2011,Enfield 014D,E01001510,960,578,382,52,77,253
2011,Enfield 015A,E01001405,1238,869,369,205,43,121
2011,Enfield 015B,E01001406,1190,861,329,85,70,174
2011,Enfield 015C,E01001450,1403,1032,371,144,71,156
2011,Enfield 015D,E01001512,1275,975,300,107,59,134
2011,Enfield 015E,E01001515,1350,874,476,72,129,275
2011,Enfield 016A,E01001401,939,695,244,117,50,77
2011,Enfield 016B,E01001478,1103,763,340,118,78,144
2011,Enfield 016C,E01001484,931,616,315,104,75,136
2011,Enfield 016D,E01001511,1227,877,350,119,81,150
2011,Enfield 016E,E01001514,1317,975,342,93,96,153
2011,Enfield 016F,E01001518,1330,997,333,121,88,124
2011,Enfield 017A,E01001451,1148,829,319,157,69,93
2011,Enfield 017B,E01001452,997,712,285,147,57,81
2011,Enfield 017C,E01001453,1200,847,353,176,69,108
2011,Enfield 017D,E01001454,1125,801,324,160,67,97
2011,Enfield 018A,E01001476,1173,783,390,112,87,191
2011,Enfield 018B,E01001477,1254,771,483,124,129,230
2011,Enfield 018C,E01001481,1172,772,400,118,97,185
2011,Enfield 018D,E01001502,1388,829,559,128,210,221
2011,Enfield 018E,E01001503,1289,836,453,146,96,211
2011,Enfield 019A,E01001520,1258,854,404,152,88,164
2011,Enfield 019B,E01001522,1278,941,337,94,86,157
2011,Enfield 019C,E01001523,1215,920,295,130,62,103
2011,Enfield 019D,E01001524,1124,738,386,105,121,160
2011,Enfield 019E,E01001526,1165,822,343,165,87,91
2011,Enfield 020A,E01001419,1481,1000,481,184,159,138
2011,Enfield 020B,E01001420,1142,761,381,106,104,171
2011,Enfield 020C,E01001421,1181,804,377,109,100,168
2011,Enfield 020D,E01001519,1941,1495,446,117,157,172
2011,Enfield 020E,E01001525,1352,960,392,142,116,134
2011,Enfield 021A,E01001398,1036,792,244,114,58,72
2011,Enfield 021B,E01001399,1080,805,275,144,72,59
2011,Enfield 021C,E01001400,1109,772,337,202,65,70
2011,Enfield 021D,E01001402,1408,1002,406,174,66,166
2011,Enfield 021E,E01001403,1131,785,346,162,68,116
2011,Enfield 021F,E01001455,1143,828,315,148,67,100
2011,Enfield 022A,E01001456,997,729,268,140,67,61
2011,Enfield 022B,E01001564,1203,918,285,99,67,119
2011,Enfield 022C,E01001567,1119,819,300,159,57,84
2011,Enfield 022D,E01001568,1185,815,370,167,83,120
2011,Enfield 022E,E01001569,1344,1034,310,121,71,118
2011,Enfield 023A,E01001479,1188,782,406,116,121,169
2011,Enfield 023B,E01001482,1296,810,486,121,116,249
2011,Enfield 023C,E01001487,1309,846,463,119,114,230
2011,Enfield 023D,E01001489,1249,805,444,125,118,201
2011,Enfield 023E,E01001491,1378,922,456,103,124,229
2011,Enfield 024A,E01001459,1208,818,390,110,105,175
2011,Enfield 024B,E01001460,1164,752,412,84,78,250
2011,Enfield 024C,E01001462,979,637,342,89,82,171
2011,Enfield 024D,E01001480,1133,766,367,113,98,156
2011,Enfield 024E,E01001488,1292,870,422,94,112,216
2011,Enfield 025A,E01001483,871,571,300,63,48,189
2011,Enfield 025B,E01001485,1229,765,464,115,123,226
2011,Enfield 025C,E01001486,1434,848,586,129,147,310
2011,Enfield 025E,E01001492,1354,868,486,119,141,226
2011,Enfield 025F,E01033146,1083,682,401,46,123,232
2011,Enfield 025G,E01033151,997,573,424,70,110,244
2011,Enfield 026A,E01001404,1068,738,330,133,86,111
2011,Enfield 026B,E01001493,1314,852,462,158,84,220
2011,Enfield 026C,E01001494,1130,754,376,176,79,121
2011,Enfield 026D,E01001496,1267,864,403,159,109,135
2011,Enfield 026E,E01001570,1324,980,344,139,85,120
2011,Enfield 027A,E01001423,1236,756,480,128,118,234
2011,Enfield 027B,E01001425,1255,771,484,73,132,279
2011,Enfield 027C,E01001428,1145,679,466,93,114,259
2011,Enfield 027D,E01001461,1204,720,484,84,125,275
2011,Enfield 027E,E01001464,926,545,381,91,101,189
2011,Enfield 028A,E01001521,1311,962,349,120,109,120
2011,Enfield 028B,E01001531,1113,819,294,111,76,107
2011,Enfield 028C,E01001532,1340,990,350,144,97,109
2011,Enfield 028D,E01001533,1101,772,329,153,79,97
2011,Enfield 028E,E01001535,1091,769,322,133,83,106
2011,Enfield 029A,E01001495,1372,1087,285,108,70,107
2011,Enfield 029B,E01001498,1518,1142,376,125,110,141
2011,Enfield 029C,E01001563,1240,945,295,110,83,102
2011,Enfield 029D,E01001565,1221,880,341,143,81,117
2011,Enfield 029E,E01001566,1308,988,320,97,68,155
2011,Enfield 030A,E01001424,842,528,314,55,98,161
2011,Enfield 030B,E01001426,1282,831,451,92,118,241
2011,Enfield 030C,E01001427,1228,741,487,98,116,273
2011,Enfield 030D,E01001429,1651,977,674,174,117,383
2011,Enfield 030E,E01001430,1196,704,492,86,124,282
2011,Enfield 031A,E01001463,1136,739,397,141,99,157
2011,Enfield 031B,E01001465,1101,739,362,122,101,139
2011,Enfield 031C,E01001466,1221,828,393,77,107,209
2011,Enfield 031D,E01001467,1314,886,428,82,142,204
2011,Enfield 031E,E01001497,1059,702,357,122,89,146
2011,Enfield 031F,E01001499,1218,832,386,147,99,140
2011,Enfield 032A,E01001392,1434,1088,346,151,93,102
2011,Enfield 032B,E01001528,1085,707,378,72,113,193
2011,Enfield 032C,E01001529,1166,789,377,86,88,203
2011,Enfield 032D,E01001530,968,694,274,105,87,82
2011,Enfield 032E,E01001534,1224,855,369,139,108,122
2011,Enfield 033A,E01001431,1095,672,423,61,100,262
2011,Enfield 033B,E01001432,1344,867,477,96,127,254
2011,Enfield 033C,E01001555,1273,864,409,101,100,208
2011,Enfield 033D,E01001557,1096,717,379,98,102,179
2011,Enfield 033E,E01001558,1059,643,416,56,139,221
2011,Enfield 033F,E01001559,1444,922,522,112,140,270
2011,Enfield 035A,E01001394,1257,881,376,134,75,167
2011,Enfield 035B,E01001395,1138,766,372,91,85,196
2011,Enfield 035C,E01001397,1462,1079,383,108,77,198
2011,Enfield 035D,E01001500,1127,793,334,132,82,120
2011,Enfield 035E,E01001556,1155,809,346,126,80,140
2011,Enfield 035F,E01001560,1164,774,390,110,105,175
2011,Enfield 036A,E01001390,1590,1276,314,116,97,101
2011,Enfield 036B,E01001391,1269,949,320,80,83,157
2011,Enfield 036C,E01001393,1722,1357,365,109,113,143
2011,Enfield 036D,E01001396,1078,759,319,107,93,119
2011,Enfield 036E,E01001501,1411,1054,357,119,64,174
2011,Enfield 036F,E01001527,1191,860,331,129,85,117
2011,Enfield 037A,E01001458,1252,731,521,103,106,312
2011,Enfield 037B,E01001553,1098,656,442,95,93,254
2011,Enfield 037C,E01001554,1242,757,485,68,104,313
2011,Enfield 037D,E01001562,1240,762,478,68,118,292
2011,Enfield 037E,E01032574,1388,910,478,105,137,236
2011,Greenwich 001A,E01001690,1378,977,401,118,77,206
2011,Greenwich 001B,E01001692,969,655,314,56,79,179
2011,Greenwich 001C,E01001693,1072,743,329,77,65,187
2011,Greenwich 001D,E01001694,1215,846,369,74,91,204
2011,Greenwich 002A,E01001687,878,597,281,91,50,140
2011,Greenwich 002B,E01001688,1681,1279,402,58,87,257
2011,Greenwich 002E,E01033739,1047,810,237,11,77,149
2011,Greenwich 002F,E01033740,1077,839,238,43,73,122
2011,Greenwich 002G,E01033741,1901,1054,847,37,81,729
2011,Greenwich 002H,E01033743,1262,948,314,44,105,165
2011,Greenwich 002I,E01033745,1204,884,320,45,112,163
2011,Greenwich 003A,E01001575,1097,721,376,74,104,198
2011,Greenwich 003B,E01001576,1097,692,405,75,107,223
2011,Greenwich 003C,E01001577,1202,794,408,87,100,221
2011,Greenwich 003D,E01001578,1498,1088,410,91,95,224
2011,Greenwich 003E,E01001579,1113,773,340,94,88,158
2011,Greenwich 004B,E01001709,866,594,272,67,72,133
2011,Greenwich 004C,E01001711,1114,865,249,47,89,113
2011,Greenwich 004D,E01001712,1483,1009,474,108,117,249
2011,Greenwich 004E,E01033731,876,780,96,12,37,47
2011,Greenwich 004F,E01033734,1019,843,176,8,77,91
2011,Greenwich 004G,E01033735,867,654,213,43,79,91
2011,Greenwich 004H,E01033736,1001,893,108,14,44,50
2011,Greenwich 004I,E01033737,1049,725,324,61,81,182
2011,Greenwich 005A,E01001705,1360,886,474,77,117,280
2011,Greenwich 005B,E01001706,1010,610,400,89,99,212
2011,Greenwich 005C,E01001708,1179,866,313,120,67,126
2011,Greenwich 005D,E01001710,1129,703,426,87,111,228
2011,Greenwich 005E,E01001713,1105,699,406,62,118,226
2011,Greenwich 006A,E01001672,1494,1052,442,83,113,246
2011,Greenwich 006B,E01001673,1430,923,507,135,132,240
2011,Greenwich 006C,E01001674,1388,945,443,125,123,195
2011,Greenwich 006D,E01001675,1524,1093,431,97,128,206
2011,Greenwich 006E,E01001677,1432,1043,389,82,124,183
2011,Greenwich 007B,E01001631,1453,993,460,65,129,266
2011,Greenwich 007C,E01001632,1800,1291,509,82,147,280
2011,Greenwich 007D,E01001635,1279,910,369,89,107,173
2011,Greenwich 007E,E01001636,1320,921,399,86,80,233
2011,Greenwich 007F,E01033742,1089,867,222,20,61,141
2011,Greenwich 007G,E01033744,1277,899,378,75,99,204
2011,Greenwich 008A,E01001571,1195,882,313,91,89,133
2011,Greenwich 008B,E01001572,1204,901,303,108,58,137
2011,Greenwich 008C,E01001573,1092,796,296,96,76,124
2011,Greenwich 008D,E01001574,1191,760,431,100,77,254
2011,Greenwich 009A,E01001629,1585,1104,481,110,118,253
2011,Greenwich 009B,E01001633,1160,790,370,80,94,196
2011,Greenwich 009C,E01001634,1157,762,395,84,79,232
2011,Greenwich 009D,E01001637,1312,909,403,103,116,184
2011,Greenwich 011A,E01001695,1205,788,417,114,93,210
2011,Greenwich 011B,E01001696,950,616,334,50,97,187
2011,Greenwich 011C,E01001697,1507,1065,442,82,139,221
2011,Greenwich 011D,E01001700,1447,1044,403,61,128,214
2011,Greenwich 011E,E01001703,1284,881,403,48,107,248
2011,Greenwich 011F,E01001704,1229,863,366,104,88,174
2011,Greenwich 012A,E01001588,1182,779,403,145,61,197
2011,Greenwich 012B,E01001589,1241,872,369,96,99,174
2011,Greenwich 012C,E01001591,1446,975,471,124,107,240
2011,Greenwich 012D,E01001595,1335,893,442,129,118,195
2011,Greenwich 014A,E01001590,1384,1027,357,98,125,134
2011,Greenwich 014B,E01001592,1327,1043,284,111,65,108
2011,Greenwich 014C,E01001593,1254,970,284,120,47,117
2011,Greenwich 014D,E01001594,1342,907,435,98,111,226
2011,Greenwich 015A,E01001698,1240,833,407,55,133,219
2011,Greenwich 015B,E01001699,1416,1096,320,34,85,201
2011,Greenwich 015C,E01001701,1016,687,329,60,74,195
2011,Greenwich 015D,E01001702,1066,636,430,71,138,221
2011,Greenwich 016A,E01001581,1316,950,366,151,78,137
2011,Greenwich 016B,E01001585,1136,849,287,112,60,115
2011,Greenwich 016C,E01001586,1068,747,321,125,64,132
2011,Greenwich 016D,E01001587,1484,1125,359,137,80,142
2011,Greenwich 017A,E01001678,1213,851,362,150,88,124
2011,Greenwich 017B,E01001683,1119,782,337,86,68,183
2011,Greenwich 017C,E01001684,1067,744,323,121,65,137
2011,Greenwich 017D,E01001685,1142,792,350,111,72,167
2011,Greenwich 019A,E01001646,2131,1533,598,117,226,255
2011,Greenwich 019B,E01001650,1275,833,442,143,86,213
2011,Greenwich 019C,E01001651,1225,826,399,124,85,190
2011,Greenwich 019D,E01001652,1156,856,300,108,76,116
2011,Greenwich 020A,E01001679,996,765,231,85,61,85
2011,Greenwich 020B,E01001680,1152,831,321,180,62,79
2011,Greenwich 020C,E01001681,926,682,244,84,50,110
2011,Greenwich 020D,E01001682,977,695,282,141,49,92
2011,Greenwich 020E,E01001686,1318,927,391,111,95,185
2011,Greenwich 021A,E01001580,1379,1109,270,107,61,102
2011,Greenwich 021B,E01001582,1028,707,321,113,44,164
2011,Greenwich 021C,E01001583,1262,995,267,108,63,96
2011,Greenwich 021D,E01001584,1120,858,262,130,39,93
2011,Greenwich 022A,E01001645,1227,866,361,118,67,176
2011,Greenwich 022B,E01001647,1079,703,376,136,78,162
2011,Greenwich 022C,E01001648,1324,961,363,118,79,166
2011,Greenwich 022D,E01001649,1145,783,362,123,57,182
2011,Greenwich 023A,E01001605,1174,863,311,176,56,79
2011,Greenwich 023B,E01001606,1212,955,257,128,58,71
2011,Greenwich 023C,E01001610,1248,904,344,179,64,101
2011,Greenwich 023D,E01001611,1188,847,341,171,45,125
2011,Greenwich 025A,E01001620,1135,703,432,118,88,226
2011,Greenwich 025B,E01001621,1126,774,352,132,75,145
2011,Greenwich 025C,E01001623,1266,903,363,110,74,179
2011,Greenwich 025D,E01001624,1156,786,370,167,55,148
2011,Greenwich 025E,E01001625,1153,753,400,125,75,200
2011,Greenwich 027A,E01001604,1075,813,262,116,54,92
2011,Greenwich 027B,E01001607,1082,780,302,164,41,97
2011,Greenwich 027C,E01001608,1043,731,312,164,63,85
2011,Greenwich 027D,E01001609,1152,796,356,148,47,161
2011,Greenwich 028A,E01001613,1165,835,330,162,53,115
2011,Greenwich 028B,E01001614,1065,738,327,179,66,82
2011,Greenwich 028C,E01001615,1147,874,273,106,52,115
2011,Greenwich 028D,E01001617,1164,810,354,199,49,106
2011,Greenwich 029A,E01001653,1092,740,352,117,50,185
2011,Greenwich 029B,E01001654,1052,675,377,128,54,195
2011,Greenwich 029C,E01001655,1069,716,353,100,51,202
2011,Greenwich 029D,E01001660,1133,735,398,141,84,173
2011,Greenwich 029E,E01001661,1088,697,391,162,69,160
2011,Greenwich 030C,E01001618,1116,767,349,155,57,137
2011,Greenwich 030D,E01001619,1403,1080,323,147,50,126
2011,Greenwich 030E,E01033729,2400,1187,1213,144,808,261
2011,Greenwich 031A,E01001597,1157,784,373,152,64,157
2011,Greenwich 031B,E01001598,1216,852,364,186,84,94
2011,Greenwich 031C,E01001602,1322,871,451,167,72,212
2011,Greenwich 031D,E01001603,1159,748,411,150,44,217
2011,Greenwich 032A,E01001596,1140,826,314,173,47,94
2011,Greenwich 032B,E01001599,1232,881,351,165,71,115
2011,Greenwich 032C,E01001600,1192,871,321,137,60,124
2011,Greenwich 032D,E01001601,1116,809,307,142,76,89
2011,Greenwich 033A,E01001669,1349,942,407,120,94,193
2011,Greenwich 033B,E01001671,1136,825,311,118,65,128
2011,Greenwich 033C,E01001676,1232,884,348,62,103,183
2011,Greenwich 033D,E01032567,1222,847,375,153,92,130
2011,Greenwich 034A,E01001656,897,632,265,107,44,114
2011,Greenwich 034B,E01001657,1120,785,335,131,68,136
2011,Greenwich 034C,E01001658,1113,794,319,139,53,127
2011,Greenwich 034D,E01001659,1082,707,375,160,94,121
2011,Greenwich 034E,E01033726,1698,1101,597,165,149,283
2011,Greenwich 035A,E01001640,1808,1209,599,79,283,237
2011,Greenwich 035B,E01033727,2102,1192,910,74,648,188
2011,Greenwich 035C,E01033728,1069,911,158,11,91,56
2011,Greenwich 035D,E01033730,1013,839,174,29,43,102
2011,Greenwich 036A,E01001666,1158,876,282,74,85,123
2011,Greenwich 036B,E01001667,1163,760,403,111,103,189
2011,Greenwich 036C,E01001668,1675,1199,476,146,113,217
2011,Greenwich 036D,E01033732,842,681,161,14,62,85
2011,Greenwich 036E,E01033733,965,831,134,16,47,71
2011,Greenwich 037A,E01001662,1334,1070,264,81,82,101
2011,Greenwich 037B,E01001664,1498,1124,374,138,105,131
2011,Greenwich 037C,E01001665,1511,1181,330,80,118,132
2011,Greenwich 037D,E01033738,997,808,189,60,72,57
2011,Greenwich 038A,E01001638,1388,992,396,85,127,184
2011,Greenwich 038B,E01001641,1368,1033,335,85,129,121
2011,Greenwich 038C,E01001642,1336,1038,298,122,49,127
2011,Greenwich 038D,E01001644,1812,1468,344,70,115,159
2011,Greenwich 038E,E01033746,1129,827,302,135,50,117
2011,Harrow 001A,E01002112,1361,955,406,150,101,155
2011,Harrow 001B,E01002114,1302,921,381,176,58,147
2011,Harrow 001C,E01002225,1056,699,357,187,56,114
2011,Harrow 001D,E01002226,1570,1112,458,205,97,156
2011,Harrow 002A,E01002113,1106,791,315,119,85,111
2011,Harrow 002B,E01002115,1111,778,333,132,68,133
2011,Harrow 002C,E01002116,1200,830,370,142,96,132
2011,Harrow 002D,E01002117,1478,1043,435,133,147,155
2011,Harrow 002E,E01002118,1258,905,353,144,68,141
2011,Harrow 003A,E01002227,1300,755,545,194,140,211
2011,Harrow 003B,E01002228,1492,1039,453,149,106,198
2011,Harrow 003C,E01002229,1214,827,387,160,63,164
2011,Harrow 003D,E01002230,1339,941,398,186,79,133
2011,Harrow 004A,E01002144,1139,805,334,154,84,96
2011,Harrow 004B,E01002146,1050,774,276,147,55,74
2011,Harrow 004C,E01002147,982,672,310,172,71,67
2011,Harrow 004D,E01002149,994,729,265,152,49,64
2011,Harrow 005A,E01002140,1237,863,374,153,96,125
2011,Harrow 005B,E01002141,1284,892,392,181,88,123
2011,Harrow 005C,E01002142,1316,952,364,154,90,120
2011,Harrow 005D,E01002143,1120,800,320,87,93,140
2011,Harrow 005E,E01002145,1087,708,379,175,64,140
2011,Harrow 006A,E01002139,998,636,362,85,102,175
2011,Harrow 006B,E01002148,1069,747,322,133,86,103
2011,Harrow 006C,E01002150,1305,953,352,141,68,143
2011,Harrow 006D,E01002151,1008,637,371,106,76,189
2011,Harrow 006E,E01002152,1172,882,290,147,59,84
2011,Harrow 007A,E01002119,1266,888,378,114,106,158
2011,Harrow 007B,E01002120,952,610,342,105,71,166
2011,Harrow 007C,E01002121,1305,918,387,149,73,165
2011,Harrow 007D,E01002122,1271,917,354,113,101,140
2011,Harrow 007E,E01002123,1322,949,373,111,112,150
2011,Harrow 008A,E01002106,1529,1085,444,168,112,164
2011,Harrow 008B,E01002108,1303,928,375,139,114,122
2011,Harrow 008C,E01002109,1330,979,351,132,97,122
2011,Harrow 008D,E01002110,1293,903,390,141,113,136
2011,Harrow 008E,E01002111,1562,1107,455,148,147,160
2011,Harrow 009A,E01002185,1103,731,372,97,97,178
2011,Harrow 009B,E01002186,1221,850,371,146,45,180
2011,Harrow 009C,E01002187,1338,902,436,208,79,149
2011,Harrow 009D,E01002190,1204,831,373,202,64,107
2011,Harrow 010A,E01002124,1256,876,380,99,91,190
2011,Harrow 010B,E01002125,1303,938,365,126,102,137
2011,Harrow 010C,E01002198,1361,980,381,103,107,171
2011,Harrow 010D,E01002200,1278,880,398,131,114,153
2011,Harrow 010E,E01002203,1268,873,395,128,102,165
2011,Harrow 011A,E01002232,1386,968,418,137,122,159
2011,Harrow 011B,E01002233,1482,1005,477,105,144,228
2011,Harrow 011C,E01002234,1265,893,372,97,107,168
2011,Harrow 011D,E01002235,1279,846,433,131,100,202
2011,Harrow 011E,E01002236,1346,965,381,106,104,171
2011,Harrow 012A,E01002107,1287,930,357,140,104,113
2011,Harrow 012B,E01002197,990,694,296,127,65,104
2011,Harrow 012C,E01002199,1131,784,347,123,92,132
2011,Harrow 012D,E01002201,1316,926,390,139,119,132
2011,Harrow 012E,E01002202,1476,981,495,119,117,259
2011,Harrow 013A,E01002179,1692,1203,489,123,125,241
2011,Harrow 013B,E01002180,1533,1064,469,114,124,231
2011,Harrow 013C,E01002183,1557,1101,456,158,126,172
2011,Harrow 013D,E01002184,1373,980,393,138,92,163
2011,Harrow 013E,E01002231,1367,925,442,135,118,189
2011,Harrow 015A,E01002154,1492,1084,408,177,98,133
2011,Harrow 015B,E01002156,1142,819,323,161,75,87
2011,Harrow 015C,E01002162,1343,974,369,102,102,165
2011,Harrow 015D,E01002163,1218,851,367,157,95,115
2011,Harrow 016A,E01002188,1121,801,320,164,77,79
2011,Harrow 016B,E01002189,1204,872,332,171,69,92
2011,Harrow 016C,E01002192,1038,741,297,166,49,82
2011,Harrow 016D,E01002193,1254,949,305,119,57,129
2011,Harrow 017A,E01002165,1317,963,354,108,93,153
2011,Harrow 017B,E01002166,1261,894,367,144,85,138
2011,Harrow 017C,E01002167,1226,874,352,102,102,148
2011,Harrow 017D,E01002168,1082,724,358,82,102,174
2011,Harrow 017E,E01002169,1248,841,407,135,116,156
2011,Harrow 019A,E01002153,1271,854,417,219,84,114
2011,Harrow 019B,E01002155,1183,844,339,155,85,99
2011,Harrow 019C,E01002157,1299,935,364,140,119,105
2011,Harrow 019D,E01002158,1076,806,270,125,81,64
2011,Harrow 020A,E01002128,1614,1240,374,95,107,172
2011,Harrow 020B,E01002130,1786,1341,445,74,140,231
2011,Harrow 020C,E01002181,1413,1080,333,112,73,148
2011,Harrow 020D,E01002182,1558,1116,442,132,126,184
2011,Harrow 021A,E01002159,1407,991,416,157,112,147
2011,Harrow 021B,E01002160,1489,1120,369,98,123,148
2011,Harrow 021C,E01002161,1486,1079,407,147,101,159
2011,Harrow 021D,E01002164,1315,989,326,118,80,128
2011,Harrow 022A,E01002191,1414,1018,396,157,108,131
2011,Harrow 022B,E01002194,1223,865,358,194,71,93
2011,Harrow 022C,E01002195,1152,807,345,156,93,96
2011,Harrow 022D,E01002196,1288,943,345,189,84,72
2011,Harrow 023A,E01002126,2165,1594,571,168,175,228
2011,Harrow 023B,E01002127,1325,965,360,136,114,110
2011,Harrow 023C,E01002129,1606,1165,441,113,98,230
2011,Harrow 023D,E01002131,1231,833,398,111,117,170
2011,Harrow 024A,E01002237,1283,961,322,71,117,134
2011,Harrow 024B,E01002238,1317,970,347,104,114,129
2011,Harrow 024C,E01002240,1268,884,384,127,94,163
2011,Harrow 024D,E01002242,1383,1003,380,172,100,108
2011,Harrow 025A,E01002208,959,654,305,185,54,66
2011,Harrow 025B,E01002209,1217,867,350,132,94,124
2011,Harrow 025C,E01002239,1202,852,350,181,63,106
2011,Harrow 025D,E01002241,1197,812,385,131,86,168
2011,Harrow 027A,E01002133,1488,976,512,145,135,232
2011,Harrow 027B,E01002136,1250,881,369,131,85,153
2011,Harrow 027C,E01002138,1130,817,313,77,102,134
2011,Harrow 027D,E01002213,2085,1533,552,135,130,287
2011,Harrow 028A,E01002211,1132,733,399,83,116,200
2011,Harrow 028B,E01002212,1256,869,387,118,87,182
2011,Harrow 028C,E01002216,1178,835,343,111,78,154
2011,Harrow 028D,E01002217,1052,654,398,69,105,224
2011,Harrow 029A,E01002132,1563,1212,351,91,110,150
2011,Harrow 029B,E01002134,1101,815,286,86,66,134
2011,Harrow 029C,E01002135,1321,953,368,119,65,184
2011,Harrow 029D,E01002137,1160,656,504,49,406,49
2011,Harrow 030A,E01002218,1150,824,326,135,62,129
2011,Harrow 030B,E01002219,1282,900,382,110,101,171
2011,Harrow 030C,E01002221,1188,822,366,115,123,128
2011,Harrow 030D,E01002222,1156,819,337,118,101,118
2011,Harrow 031A,E01002214,1298,871,427,99,130,198
2011,Harrow 031B,E01002215,1087,702,385,120,90,175
2011,Harrow 031C,E01002220,1185,872,313,103,96,114
2011,Harrow 031D,E01002223,1352,971,381,127,102,152
2011,Harrow 031E,E01002224,1087,744,343,70,106,167
2011,Harrow 032A,E01002204,1275,900,375,106,97,172
2011,Harrow 032B,E01002206,1008,704,304,79,96,129
2011,Harrow 032C,E01002207,1239,868,371,143,103,125
2011,Harrow 032D,E01002210,1183,842,341,119,92,130
2011,Harrow 032E,E01032576,1222,866,356,146,95,115
2011,Harrow 033A,E01002170,996,670,326,111,98,117
2011,Harrow 033B,E01002171,1282,902,380,146,97,137
2011,Harrow 033C,E01002172,1156,849,307,106,78,123
2011,Harrow 033D,E01002173,1359,964,395,166,107,122
2011,Harrow 033E,E01002174,1192,855,337,130,87,120
2011,Harrow 033F,E01002175,1118,820,298,109,86,103
2011,Harrow 033G,E01002176,1360,974,386,135,110,141
2011,Harrow 033H,E01002177,1069,732,337,127,98,112
2011,Harrow 033I,E01002178,1225,871,354,152,93,109
2011,Havering 001A,E01002276,1348,924,424,141,66,217
2011,Havering 001B,E01002278,1065,722,343,113,56,174
2011,Havering 001C,E01002312,939,597,342,191,31,120
2011,Havering 001D,E01002313,1056,680,376,145,60,171
2011,Havering 002A,E01002277,1111,770,341,117,59,165
2011,Havering 002B,E01002279,1094,777,317,111,67,139
2011,Havering 002C,E01002281,1141,735,406,110,43,253
2011,Havering 002D,E01002283,1002,676,326,124,50,152
2011,Havering 002E,E01002299,1238,901,337,119,75,143
2011,Havering 003A,E01002301,1184,821,363,209,54,100
2011,Havering 003B,E01002303,1419,967,452,186,80,186
2011,Havering 003C,E01002304,1025,635,390,188,62,140
2011,Havering 003D,E01002306,1083,776,307,115,44,148
2011,Havering 003E,E01002307,1184,836,348,136,48,164
2011,Havering 004A,E01002280,1058,694,364,84,87,193
2011,Havering 004B,E01002282,1094,731,363,72,69,222
2011,Havering 004C,E01002284,1258,881,377,113,74,190
2011,Havering 004D,E01002297,1107,742,365,104,59,202
2011,Havering 004E,E01002314,1104,777,327,110,72,145
2011,Havering 004F,E01002316,1092,686,406,148,43,215
2011,Havering 005A,E01002302,1131,789,342,171,46,125
2011,Havering 005B,E01002305,1102,752,350,188,52,110
2011,Havering 005C,E01002308,1158,787,371,164,43,164
2011,Havering 005D,E01002326,1072,741,331,153,57,121
2011,Havering 005E,E01002331,1104,783,321,171,40,110
2011,Havering 006A,E01002309,1093,723,370,176,56,138
2011,Havering 006B,E01002310,1176,750,426,151,58,217
2011,Havering 006C,E01002311,1176,785,391,165,68,158
2011,Havering 006D,E01002315,1094,752,342,125,64,153
2011,Havering 007A,E01002293,1221,941,280,115,50,115
2011,Havering 007B,E01002294,1094,754,340,205,42,93
2011,Havering 007C,E01002296,1236,869,367,226,58,83
2011,Havering 007D,E01002298,1118,812,306,180,42,84
2011,Havering 007E,E01002300,1146,778,368,233,48,87
2011,Havering 008A,E01002333,942,669,273,160,36,77
2011,Havering 008B,E01002334,1252,863,389,245,52,92
2011,Havering 008C,E01002336,1083,751,332,200,42,90
2011,Havering 008D,E01002339,1155,807,348,199,64,85
2011,Havering 008E,E01002341,976,677,299,189,33,77
2011,Havering 009A,E01002327,1069,752,317,169,43,105
2011,Havering 009B,E01002328,1239,897,342,164,63,115
2011,Havering 009C,E01002332,1168,833,335,202,35,98
2011,Havering 009D,E01002335,1063,759,304,147,42,115
2011,Havering 009E,E01002338,980,722,258,132,29,97
2011,Havering 009F,E01002340,993,740,253,126,47,80
2011,Havering 010A,E01002268,947,694,253,110,53,90
2011,Havering 010B,E01002269,1251,909,342,193,59,90
2011,Havering 010C,E01002295,1186,839,347,180,58,109
2011,Havering 010D,E01002377,1189,894,295,143,53,99
2011,Havering 010E,E01002378,1237,914,323,155,77,91
2011,Havering 010F,E01002383,1158,861,297,161,55,81
2011,Havering 011A,E01002244,1268,965,303,115,54,134
2011,Havering 011B,E01002245,1075,790,285,123,52,110
2011,Havering 011C,E01002325,1161,781,380,176,55,149
2011,Havering 011D,E01002329,1148,823,325,149,56,120
2011,Havering 011E,E01002330,1249,908,341,165,41,135
2011,Havering 012A,E01002337,914,613,301,162,49,90
2011,Havering 012B,E01002354,958,700,258,150,37,71
2011,Havering 012C,E01002376,1074,793,281,159,42,80
2011,Havering 012D,E01002379,1097,797,300,160,56,84
2011,Havering 012E,E01002380,1597,1231,366,166,43,157
2011,Havering 012F,E01002381,1129,811,318,168,49,101
2011,Havering 013A,E01002243,1333,939,394,126,65,203
2011,Havering 013B,E01002353,1481,1050,431,236,71,124
2011,Havering 013C,E01002356,1597,1198,399,109,68,222
2011,Havering 013E,E01032741,893,726,167,38,31,98
2011,Havering 013F,E01032742,948,706,242,109,21,112
2011,Havering 014A,E01002272,995,717,278,163,37,78
2011,Havering 014B,E01002274,1199,839,360,222,56,82
2011,Havering 014C,E01002317,1134,833,301,167,64,70
2011,Havering 014D,E01002318,1207,847,360,222,57,81
2011,Havering 014E,E01002355,1071,794,277,168,31,78
2011,Havering 014F,E01002382,1331,995,336,177,49,110
2011,Havering 015A,E01002270,1226,855,371,181,85,105
2011,Havering 015B,E01002271,1125,731,394,214,74,106
2011,Havering 015C,E01002273,1010,666,344,182,63,99
2011,Havering 015D,E01002275,1024,691,333,192,47,94
2011,Havering 016A,E01002319,1180,859,321,150,67,104
2011,Havering 016B,E01002350,1150,802,348,138,42,168
2011,Havering 016C,E01002351,1191,925,266,127,40,99
2011,Havering 016D,E01002352,1223,943,280,110,47,123
2011,Havering 016E,E01002358,1407,1103,304,110,52,142
2011,Havering 017A,E01002246,1176,856,320,165,52,103
2011,Havering 017B,E01002247,1320,1010,310,120,58,132
2011,Havering 017C,E01002248,983,691,292,125,46,121
2011,Havering 017D,E01002249,1419,1099,320,109,72,139
2011,Havering 017E,E01002250,1185,894,291,112,76,103
2011,Havering 017F,E01002251,994,707,287,107,57,123
2011,Havering 018A,E01002252,1058,738,320,204,37,79
2011,Havering 018B,E01002256,1020,745,275,158,36,81
2011,Havering 018C,E01002258,1128,779,349,217,47,85
2011,Havering 018D,E01002259,1045,753,292,164,44,84
2011,Havering 018E,E01002391,1072,749,323,180,61,82
2011,Havering 019A,E01002253,1069,739,330,192,60,78
2011,Havering 019B,E01002254,1106,758,348,210,55,83
2011,Havering 019C,E01002257,1170,768,402,199,69,134
2011,Havering 019D,E01002384,1089,780,309,190,49,70
2011,Havering 020A,E01002359,938,691,247,131,48,68
2011,Havering 020B,E01002360,963,652,311,202,42,67
2011,Havering 020C,E01002361,1264,944,320,168,39,113
2011,Havering 020D,E01002363,1144,795,349,185,53,111
2011,Havering 020E,E01002367,1165,873,292,154,55,83
2011,Havering 021A,E01002320,1127,870,257,119,53,85
2011,Havering 021B,E01002321,1219,880,339,170,55,114
2011,Havering 021C,E01002322,1515,1167,348,164,83,101
2011,Havering 021D,E01002323,1190,904,286,129,57,100
2011,Havering 021E,E01002324,1080,728,352,167,52,133
2011,Havering 022A,E01002255,1069,785,284,165,45,74
2011,Havering 022B,E01002289,1147,825,322,163,66,93
2011,Havering 022C,E01002292,1072,747,325,158,58,109
2011,Havering 022D,E01002362,1116,813,303,166,62,75
2011,Havering 022E,E01002386,1344,1024,320,176,47,97
2011,Havering 023A,E01002287,1165,849,316,185,47,84
2011,Havering 023B,E01002291,1238,880,358,221,43,94
2011,Havering 023C,E01002364,1017,706,311,213,30,68
2011,Havering 023D,E01002365,955,699,256,128,57,71
2011,Havering 023E,E01002366,1081,811,270,136,52,82
2011,Havering 024A,E01002385,1142,819,323,173,65,85
2011,Havering 024B,E01002387,1127,798,329,187,56,86
2011,Havering 024C,E01002388,1180,838,342,209,64,69
2011,Havering 024D,E01002389,1104,726,378,261,37,80
2011,Havering 024E,E01002390,1054,720,334,201,50,83
2011,Havering 025A,E01002265,1127,832,295,174,43,78
2011,Havering 025B,E01002285,929,651,278,189,28,61
2011,Havering 025C,E01002286,1201,854,347,208,53,86
2011,Havering 025D,E01002288,1188,903,285,150,41,94
2011,Havering 025E,E01002290,1084,737,347,218,55,74
2011,Havering 026A,E01002260,1164,799,365,199,64,102
2011,Havering 026B,E01002261,1184,885,299,158,45,96
2011,Havering 026C,E01002262,1143,829,314,148,69,97
2011,Havering 026D,E01002263,1245,907,338,203,46,89
2011,Havering 026E,E01002264,991,662,329,144,30,155
2011,Havering 027A,E01002266,990,703,287,176,33,78
2011,Havering 027B,E01002267,1131,751,380,201,59,120
2011,Havering 027C,E01002372,1150,829,321,171,64,86
2011,Havering 027D,E01002373,1119,801,318,169,47,102
2011,Havering 027E,E01002374,1099,801,298,138,66,94
2011,Havering 028A,E01002368,1141,786,355,131,53,171
2011,Havering 028B,E01002369,1369,936,433,204,71,158
2011,Havering 028C,E01002370,1425,1028,397,168,64,165
2011,Havering 028D,E01002371,1156,788,368,198,43,127
2011,Havering 028E,E01002375,1132,767,365,159,51,155
2011,Havering 029A,E01002343,1253,858,395,232,51,112
2011,Havering 029B,E01002344,1118,749,369,220,43,106
2011,Havering 029C,E01002348,1140,769,371,254,45,72
2011,Havering 029D,E01002349,1140,817,323,177,51,95
2011,Havering 030A,E01002342,1121,814,307,120,65,122
2011,Havering 030B,E01002345,1175,867,308,79,54,175
2011,Havering 030C,E01002346,1128,826,302,112,58,132
2011,Havering 030D,E01002347,1029,727,302,153,52,97
2011,Hillingdon 001A,E01002473,1191,794,397,170,95,132
2011,Hillingdon 001B,E01002475,1075,742,333,165,38,130
2011,Hillingdon 001C,E01002476,1160,795,365,188,77,100
2011,Hillingdon 001D,E01002477,933,637,296,143,51,102
2011,Hillingdon 001E,E01002482,1138,789,349,181,76,92
2011,Hillingdon 002A,E01002472,1166,794,372,158,115,99
2011,Hillingdon 002B,E01002474,1090,790,300,154,56,90
2011,Hillingdon 002C,E01002478,1122,833,289,153,52,84
2011,Hillingdon 002D,E01002483,1264,917,347,177,57,113
2011,Hillingdon 002E,E01002484,1057,772,285,122,45,118
2011,Hillingdon 002F,E01002485,1261,944,317,125,62,130
2011,Hillingdon 003A,E01002438,928,701,227,115,34,78
2011,Hillingdon 003B,E01002439,1125,844,281,141,43,97
2011,Hillingdon 003C,E01002440,1015,726,289,142,46,101
2011,Hillingdon 003D,E01002441,1137,822,315,148,51,116
2011,Hillingdon 003E,E01002442,1118,830,288,126,38,124
2011,Hillingdon 004A,E01002433,1345,950,395,172,88,135
2011,Hillingdon 004B,E01002436,1157,851,306,152,56,98
2011,Hillingdon 004C,E01002479,1202,870,332,133,77,122
2011,Hillingdon 004D,E01002480,1275,928,347,188,75,84
2011,Hillingdon 004E,E01002481,1175,829,346,153,62,131
2011,Hillingdon 005A,E01002533,1061,783,278,99,58,121
2011,Hillingdon 005B,E01002534,1030,730,300,159,52,89
2011,Hillingdon 005C,E01002538,1194,871,323,184,44,95
2011,Hillingdon 005D,E01002539,1079,781,298,201,43,54
2011,Hillingdon 006A,E01002418,1234,903,331,157,66,108
2011,Hillingdon 006B,E01002419,1107,834,273,141,51,81
2011,Hillingdon 006C,E01002431,1004,722,282,161,53,68
2011,Hillingdon 006D,E01002432,1153,878,275,151,52,72
2011,Hillingdon 006E,E01002437,1024,686,338,219,59,60
2011,Hillingdon 007A,E01002430,1097,784,313,191,54,68
2011,Hillingdon 007B,E01002434,954,683,271,171,45,55
2011,Hillingdon 007C,E01002435,1051,750,301,186,44,71
2011,Hillingdon 007D,E01002470,1212,921,291,151,40,100
2011,Hillingdon 007E,E01002535,1340,1028,312,174,53,85
2011,Hillingdon 008A,E01002416,1267,959,308,140,70,98
2011,Hillingdon 008B,E01002417,1135,831,304,174,49,81
2011,Hillingdon 008C,E01002420,1153,872,281,121,54,106
2011,Hillingdon 008D,E01002421,1196,880,316,168,50,98
2011,Hillingdon 008E,E01002471,1189,924,265,137,44,84
2011,Hillingdon 009A,E01002465,1108,878,230,110,43,77
2011,Hillingdon 009B,E01002467,999,719,280,169,43,68
2011,Hillingdon 009C,E01002494,1252,973,279,102,68,109
2011,Hillingdon 009D,E01002536,1021,836,185,87,34,64
2011,Hillingdon 009E,E01002537,1072,836,236,122,46,68
2011,Hillingdon 010A,E01002415,1256,963,293,155,58,80
2011,Hillingdon 010B,E01002466,1177,927,250,130,39,81
2011,Hillingdon 010C,E01002468,1250,1002,248,113,41,94
2011,Hillingdon 010D,E01002469,1247,957,290,149,55,86
2011,Hillingdon 010E,E01002495,1753,1443,310,108,57,145
2011,Hillingdon 011A,E01002458,1020,704,316,196,59,61
2011,Hillingdon 011B,E01002459,1132,767,365,236,55,74
2011,Hillingdon 011C,E01002460,926,676,250,154,40,56
2011,Hillingdon 011D,E01002462,992,749,243,126,53,64
2011,Hillingdon 011E,E01002464,1100,844,256,141,44,71
2011,Hillingdon 013A,E01002461,1075,754,321,139,83,99
2011,Hillingdon 013B,E01002463,1122,805,317,163,74,80
2011,Hillingdon 013C,E01002512,1282,918,364,190,91,83
2011,Hillingdon 013D,E01002513,1024,717,307,165,55,87
2011,Hillingdon 013E,E01002516,1081,779,302,169,52,81
2011,Hillingdon 014A,E01002450,1012,789,223,75,63,85
2011,Hillingdon 014B,E01002451,1082,829,253,110,64,79
2011,Hillingdon 014C,E01002452,1136,879,257,89,76,92
2011,Hillingdon 014D,E01002453,1233,925,308,123,69,116
2011,Hillingdon 014E,E01002454,1203,860,343,122,71,150
2011,Hillingdon 015A,E01002414,3058,1423,1635,85,1483,67
2011,Hillingdon 015C,E01002514,1440,1088,352,140,109,103
2011,Hillingdon 015D,E01002515,1201,900,301,106,74,121
2011,Hillingdon 015F,E01033725,1868,1255,613,179,234,200
2011,Hillingdon 016B,E01002520,1200,850,350,85,134,131
2011,Hillingdon 016C,E01002521,1307,896,411,151,105,155
2011,Hillingdon 016D,E01002523,1286,829,457,92,246,119
2011,Hillingdon 016F,E01033724,4362,2163,2199,160,1829,210
2011,Hillingdon 017A,E01002410,1308,936,372,151,105,116
2011,Hillingdon 017B,E01002412,1787,1239,548,141,261,146
2011,Hillingdon 017C,E01002456,1109,798,311,135,71,105
2011,Hillingdon 017D,E01002509,1047,764,283,124,81,78
2011,Hillingdon 017E,E01002511,1122,763,359,162,76,121
2011,Hillingdon 018A,E01002422,1010,718,292,106,77,109
2011,Hillingdon 018B,E01002423,1196,878,318,148,67,103
2011,Hillingdon 018C,E01002424,1136,805,331,117,93,121
2011,Hillingdon 018D,E01002425,1333,864,469,122,183,164
2011,Hillingdon 018E,E01002427,1084,820,264,118,51,95
2011,Hillingdon 018F,E01002428,1054,786,268,119,57,92
2011,Hillingdon 019A,E01002408,1159,804,355,102,115,138
2011,Hillingdon 019B,E01002409,1248,837,411,144,117,150
2011,Hillingdon 019C,E01002429,989,694,295,88,84,123
2011,Hillingdon 019D,E01002455,1259,864,395,150,109,136
2011,Hillingdon 019E,E01002457,1138,785,353,65,139,149
2011,Hillingdon 020A,E01002392,1075,734,341,71,73,197
2011,Hillingdon 020B,E01002393,1391,978,413,114,89,210
2011,Hillingdon 020C,E01002540,1211,876,335,81,73,181
2011,Hillingdon 020D,E01002542,1303,900,403,94,84,225
2011,Hillingdon 020E,E01002543,1160,819,341,80,79,182
2011,Hillingdon 021A,E01002394,1101,724,377,104,109,164
2011,Hillingdon 021B,E01002395,1054,732,322,80,110,132
2011,Hillingdon 021C,E01002397,1248,864,384,95,115,174
2011,Hillingdon 021D,E01002398,1312,937,375,112,113,150
2011,Hillingdon 021E,E01002399,1172,809,363,108,98,157
2011,Hillingdon 021F,E01002426,1199,857,342,118,64,160
2011,Hillingdon 022A,E01002411,1290,809,481,123,234,124
2011,Hillingdon 022B,E01002413,1093,779,314,82,98,134
2011,Hillingdon 022C,E01002518,1060,698,362,104,195,63
2011,Hillingdon 022D,E01002519,1171,816,355,148,89,118
2011,Hillingdon 022E,E01002550,1373,1025,348,67,117,164
2011,Hillingdon 022F,E01002554,1955,1445,510,92,174,244
2011,Hillingdon 023A,E01002541,1451,1136,315,125,65,125
2011,Hillingdon 023B,E01002544,1241,878,363,107,94,162
2011,Hillingdon 023C,E01002545,1001,646,355,50,111,194
2011,Hillingdon 023D,E01002546,1140,818,322,67,108,147
2011,Hillingdon 023E,E01002547,1140,761,379,78,110,191
2011,Hillingdon 024A,E01002400,1288,863,425,142,96,187
2011,Hillingdon 024B,E01002401,1224,843,381,99,100,182
2011,Hillingdon 024C,E01002402,1075,728,347,89,107,151
2011,Hillingdon 024D,E01002403,1227,804,423,106,127,190
2011,Hillingdon 024E,E01002404,1259,867,392,102,66,224
2011,Hillingdon 025A,E01002548,1114,755,359,113,53,193
2011,Hillingdon 025B,E01002549,1323,961,362,144,95,123
2011,Hillingdon 025C,E01002551,1378,949,429,108,142,179
2011,Hillingdon 025D,E01002552,1155,810,345,110,95,140
2011,Hillingdon 025E,E01002553,1227,837,390,130,98,162
2011,Hillingdon 026A,E01002396,1241,825,416,109,125,182
2011,Hillingdon 026B,E01002501,1210,849,361,102,109,150
2011,Hillingdon 026C,E01002502,1169,816,353,97,104,152
2011,Hillingdon 026D,E01002505,1213,843,370,81,86,203
2011,Hillingdon 026E,E01002508,1356,872,484,114,142,228
2011,Hillingdon 027A,E01002405,1401,991,410,102,111,197
2011,Hillingdon 027B,E01002406,1501,1032,469,108,136,225
2011,Hillingdon 027C,E01002503,1240,830,410,71,146,193
2011,Hillingdon 027D,E01002504,1466,1025,441,132,97,212
2011,Hillingdon 027E,E01002506,1302,848,454,101,120,233
2011,Hillingdon 027F,E01002507,1211,823,388,103,137,148
2011,Hillingdon 028A,E01002486,1485,1028,457,103,139,215
2011,Hillingdon 028B,E01002487,1304,924,380,128,89,163
2011,Hillingdon 028C,E01002526,1334,939,395,101,108,186
2011,Hillingdon 028D,E01002528,1196,805,391,112,84,195
2011,Hillingdon 028E,E01002532,1643,1181,462,77,143,242
2011,Hillingdon 029A,E01002445,1042,725,317,73,78,166
2011,Hillingdon 029B,E01002525,1218,898,320,157,58,105
2011,Hillingdon 029C,E01002529,1536,1173,363,84,120,159
2011,Hillingdon 029D,E01002530,1034,685,349,93,86,170
2011,Hillingdon 029E,E01002531,1232,885,347,163,60,124
2011,Hillingdon 030A,E01002407,1702,1179,523,122,147,254
2011,Hillingdon 030B,E01002488,1219,867,352,114,85,153
2011,Hillingdon 030C,E01002489,1329,945,384,103,118,163
2011,Hillingdon 030D,E01002490,1499,1091,408,112,92,204
2011,Hillingdon 030E,E01002492,1161,807,354,86,114,154
2011,Hillingdon 031A,E01002444,1517,1038,479,130,56,293
2011,Hillingdon 031B,E01002446,1171,894,277,98,51,128
2011,Hillingdon 031C,E01002447,1331,1055,276,61,73,142
2011,Hillingdon 031D,E01002527,1073,740,333,117,94,122
2011,Hillingdon 032A,E01002443,1208,927,281,76,71,134
2011,Hillingdon 032B,E01002448,1448,1064,384,142,78,164
2011,Hillingdon 032C,E01002449,1395,1071,324,92,66,166
2011,Hillingdon 032D,E01002491,1118,743,375,96,109,170
2011,Hillingdon 032E,E01002493,1218,809,409,86,104,219
2011,Hillingdon 033A,E01002496,1315,1025,290,122,50,118
2011,Hillingdon 033B,E01002497,1318,987,331,135,42,154
2011,Hillingdon 033C,E01002498,1021,750,271,148,44,79
2011,Hillingdon 033D,E01002499,1243,938,305,134,55,116
2011,Hillingdon 033E,E01032577,1225,891,334,158,72,104
2011,Hounslow 001A,E01002569,1383,1097,286,121,62,103
2011,Hounslow 001B,E01002570,1362,1091,271,100,78,93
2011,Hounslow 001C,E01002573,1230,921,309,107,84,118
2011,Hounslow 001D,E01002574,1190,918,272,69,92,111
2011,Hounslow 001E,E01002575,1316,982,334,119,86,129
2011,Hounslow 003A,E01002562,1066,722,344,113,70,161
2011,Hounslow 003B,E01002564,1386,980,406,114,91,201
2011,Hounslow 003C,E01002566,1618,1100,518,122,90,306
2011,Hounslow 003D,E01002568,2029,1425,604,163,139,302
2011,Hounslow 003F,E01033081,1020,803,217,50,51,116
2011,Hounslow 003G,E01033082,954,695,259,134,28,97
2011,Hounslow 004A,E01002620,1295,834,461,114,119,228
2011,Hounslow 004B,E01002625,1289,887,402,125,132,145
2011,Hounslow 004C,E01002626,1263,875,388,119,98,171
2011,Hounslow 004D,E01002627,1219,807,412,95,103,214
2011,Hounslow 004E,E01002631,1195,827,368,87,104,177
2011,Hounslow 005A,E01002633,1164,721,443,101,104,238
2011,Hounslow 005B,E01002634,1164,694,470,91,116,263
2011,Hounslow 005C,E01002637,1230,769,461,105,133,223
2011,Hounslow 005D,E01002638,1277,798,479,93,112,274
2011,Hounslow 006A,E01002563,1288,965,323,144,88,91
2011,Hounslow 006B,E01002565,2421,1606,815,148,547,120
2011,Hounslow 006C,E01002567,1378,1144,234,79,37,118
2011,Hounslow 006D,E01002684,1884,1426,458,127,88,243
2011,Hounslow 006E,E01002686,1323,878,445,114,116,215
2011,Hounslow 007A,E01002571,1013,802,211,81,44,86
2011,Hounslow 007B,E01002572,1202,835,367,104,76,187
2011,Hounslow 007C,E01002577,1261,978,283,104,67,112
2011,Hounslow 007D,E01002578,1103,812,291,112,77,102
2011,Hounslow 007E,E01002689,1199,867,332,127,47,158
2011,Hounslow 007F,E01002690,1128,803,325,91,86,148
2011,Hounslow 008A,E01002576,1283,919,364,106,75,183
2011,Hounslow 008B,E01002579,1339,981,358,173,66,119
2011,Hounslow 008C,E01002580,1068,813,255,99,44,112
2011,Hounslow 008D,E01002581,1492,1226,266,103,56,107
2011,Hounslow 008E,E01002582,1245,982,263,98,55,110
2011,Hounslow 009A,E01002675,1824,1405,419,142,132,145
2011,Hounslow 009B,E01002678,1451,1121,330,137,84,109
2011,Hounslow 009C,E01002679,1365,1034,331,137,97,97
2011,Hounslow 009D,E01002680,1512,1126,386,134,97,155
2011,Hounslow 010A,E01002619,1448,1002,446,134,137,175
2011,Hounslow 010B,E01002622,1317,969,348,108,100,140
2011,Hounslow 010C,E01002632,1351,962,389,119,101,169
2011,Hounslow 010D,E01002635,1325,923,402,132,107,163
2011,Hounslow 010E,E01002636,1520,1050,470,151,118,201
2011,Hounslow 011A,E01002618,1322,890,432,147,135,150
2011,Hounslow 011B,E01002621,1368,953,415,98,118,199
2011,Hounslow 011C,E01002623,1208,818,390,95,90,205
2011,Hounslow 011D,E01002628,1491,1052,439,140,123,176
2011,Hounslow 011E,E01002629,1525,1044,481,152,131,198
2011,Hounslow 012A,E01002630,1294,932,362,117,68,177
2011,Hounslow 012B,E01002639,1335,1003,332,113,88,131
2011,Hounslow 012C,E01002640,1449,1074,375,105,135,135
2011,Hounslow 012D,E01002674,1285,958,327,123,65,139
2011,Hounslow 012E,E01002676,1324,933,391,174,101,116
2011,Hounslow 013A,E01002583,1278,887,391,134,98,159
2011,Hounslow 013B,E01002584,1264,901,363,97,91,175
2011,Hounslow 013C,E01002585,1246,845,401,103,115,183
2011,Hounslow 013D,E01002586,1302,933,369,117,104,148
2011,Hounslow 013E,E01002589,1436,967,469,112,105,252
2011,Hounslow 014A,E01002668,1516,1193,323,117,58,148
2011,Hounslow 014B,E01002669,1290,938,352,83,80,189
2011,Hounslow 014C,E01002681,1558,1137,421,91,129,201
2011,Hounslow 014D,E01002682,1731,1314,417,122,104,191
2011,Hounslow 014E,E01002683,1896,1483,413,114,101,198
2011,Hounslow 015A,E01002642,1532,1125,407,107,107,193
2011,Hounslow 015B,E01002643,1669,1176,493,172,115,206
2011,Hounslow 015C,E01002645,1599,1157,442,138,119,185
2011,Hounslow 015D,E01002658,988,761,227,103,49,75
2011,Hounslow 015E,E01002677,1213,938,275,69,57,149
2011,Hounslow 016A,E01002587,1436,973,463,148,118,197
2011,Hounslow 016B,E01002588,1200,752,448,104,88,256
2011,Hounslow 016C,E01002660,1380,998,382,106,107,169
2011,Hounslow 016D,E01002661,1469,1031,438,138,116,184
2011,Hounslow 016E,E01002665,1202,815,387,110,88,189
2011,Hounslow 017A,E01002624,1143,816,327,102,72,153
2011,Hounslow 017B,E01002646,1421,928,493,92,117,284
2011,Hounslow 017C,E01002662,1634,1218,416,124,126,166
2011,Hounslow 017D,E01002663,1552,1052,500,155,110,235
2011,Hounslow 017E,E01002664,1341,988,353,93,98,162
2011,Hounslow 018A,E01002641,1485,1079,406,128,99,179
2011,Hounslow 018C,E01002648,2029,1496,533,118,136,279
2011,Hounslow 018D,E01002649,1436,1076,360,71,103,186
2011,Hounslow 018E,E01002657,1379,1032,347,139,76,132
2011,Hounslow 018F,E01033083,1297,1052,245,12,58,175
2011,Hounslow 018G,E01033084,1326,1019,307,48,84,175
2011,Hounslow 019A,E01002653,1388,959,429,131,151,147
2011,Hounslow 019B,E01002654,1360,1042,318,127,79,112
2011,Hounslow 019C,E01002655,1411,1049,362,135,93,134
2011,Hounslow 019D,E01002656,968,715,253,104,61,88
2011,Hounslow 019E,E01002659,1013,730,283,115,79,89
2011,Hounslow 020A,E01002667,1195,872,323,103,77,143
2011,Hounslow 020B,E01002670,1308,997,311,100,91,120
2011,Hounslow 020C,E01002671,1242,906,336,135,65,136
2011,Hounslow 020D,E01002672,1197,887,310,72,87,151
2011,Hounslow 020E,E01002673,1102,666,436,74,96,266
2011,Hounslow 021A,E01002647,1544,1083,461,106,114,241
2011,Hounslow 021B,E01002650,1684,1180,504,108,120,276
2011,Hounslow 021C,E01002651,1359,972,387,122,105,160
2011,Hounslow 021D,E01002652,1373,959,414,112,120,182
2011,Hounslow 021E,E01002666,1236,907,329,95,88,146
2011,Hounslow 022A,E01002555,1434,1081,353,138,76,139
2011,Hounslow 022B,E01002556,1190,866,324,131,53,140
2011,Hounslow 022C,E01002590,1361,988,373,135,83,155
2011,Hounslow 022D,E01002592,1448,1012,436,154,82,200
2011,Hounslow 022E,E01002595,1430,1020,410,140,85,185
2011,Hounslow 023A,E01002557,1293,970,323,126,65,132
2011,Hounslow 023B,E01002558,1397,1010,387,127,80,180
2011,Hounslow 023C,E01002559,1657,1244,413,115,80,218
2011,Hounslow 023D,E01002560,1231,868,363,143,75,145
2011,Hounslow 023E,E01002561,957,707,250,32,53,165
2011,Hounslow 024A,E01002591,1256,913,343,122,80,141
2011,Hounslow 024B,E01002593,1559,1109,450,161,83,206
2011,Hounslow 024C,E01002594,1422,1018,404,144,96,164
2011,Hounslow 024D,E01002611,1310,965,345,124,70,151
2011,Hounslow 024E,E01002612,1219,862,357,126,63,168
2011,Hounslow 024F,E01002613,1287,965,322,96,80,146
2011,Hounslow 025B,E01002598,1328,968,360,82,75,203
2011,Hounslow 025C,E01002599,1152,817,335,103,69,163
2011,Hounslow 025D,E01002600,1096,791,305,94,63,148
2011,Hounslow 025E,E01002603,1362,1044,318,62,73,183
2011,Hounslow 025F,E01033000,1208,836,372,92,68,212
2011,Hounslow 025G,E01033030,1319,1054,265,13,49,203
2011,Hounslow 026A,E01002604,1149,750,399,59,107,233
2011,Hounslow 026B,E01002605,1312,930,382,136,68,178
2011,Hounslow 026C,E01002606,1183,775,408,114,69,225
2011,Hounslow 026D,E01002607,1361,997,364,101,86,177
2011,Hounslow 026E,E01002615,1073,707,366,112,68,186
2011,Hounslow 027A,E01002596,1515,1083,432,44,81,307
2011,Hounslow 027B,E01002601,1205,980,225,67,57,101
2011,Hounslow 027C,E01002602,1081,860,221,105,38,78
2011,Hounslow 027D,E01002614,1319,1026,293,91,59,143
2011,Hounslow 027E,E01002616,978,713,265,103,48,114
2011,Hounslow 028A,E01002608,1196,848,348,103,68,177
2011,Hounslow 028B,E01002609,1289,970,319,137,62,120
2011,Hounslow 028C,E01002610,1096,737,359,134,53,172
2011,Hounslow 028D,E01002617,1206,908,298,143,40,115
2011,Hounslow 029A,E01002687,1411,1131,280,109,59,112
2011,Hounslow 029B,E01002691,1212,932,280,84,82,114
2011,Hounslow 029C,E01002692,1469,1141,328,94,75,159
2011,Hounslow 029D,E01002693,1248,953,295,137,51,107
2011,Hounslow 029E,E01032573,1319,1082,237,94,55,88
2011,Kingston upon Thames 001A,E01003006,1032,765,267,114,59,94
2011,Kingston upon Thames 001B,E01003007,1029,763,266,109,69,88
2011,Kingston upon Thames 001C,E01003008,976,732,244,122,51,71
2011,Kingston upon Thames 001D,E01003009,1333,996,337,127,64,146
2011,Kingston upon Thames 001E,E01003010,1082,815,267,103,80,84
2011,Kingston upon Thames 002A,E01002952,1094,667,427,128,151,148
2011,Kingston upon Thames 002B,E01002953,947,654,293,88,98,107
2011,Kingston upon Thames 002C,E01002955,1056,723,333,96,132,105
2011,Kingston upon Thames 002D,E01002956,1219,680,539,118,292,129
2011,Kingston upon Thames 002E,E01002959,1012,635,377,144,101,132
2011,Kingston upon Thames 003A,E01002935,1450,1126,324,62,168,94
2011,Kingston upon Thames 003B,E01002938,1357,1030,327,126,77,124
2011,Kingston upon Thames 003C,E01002951,1137,832,305,109,85,111
2011,Kingston upon Thames 003D,E01002954,930,692,238,85,66,87
2011,Kingston upon Thames 003E,E01002957,1258,804,454,73,222,159
2011,Kingston upon Thames 004A,E01002933,1377,1006,371,122,95,154
2011,Kingston upon Thames 004B,E01002934,1307,1017,290,89,87,114
2011,Kingston upon Thames 004D,E01002937,1223,974,249,79,77,93
2011,Kingston upon Thames 004E,E01003011,1276,969,307,139,70,98
2011,Kingston upon Thames 004F,E01033568,1161,862,299,37,140,122
2011,Kingston upon Thames 004G,E01033569,1335,994,341,56,182,103
2011,Kingston upon Thames 005A,E01002964,1794,1174,620,119,351,150
2011,Kingston upon Thames 005B,E01002969,1287,808,479,107,116,256
2011,Kingston upon Thames 005C,E01002971,1334,1040,294,79,129,86
2011,Kingston upon Thames 005D,E01002972,1488,1103,385,86,201,98
2011,Kingston upon Thames 005E,E01002974,1437,1031,406,111,156,139
2011,Kingston upon Thames 006A,E01002932,1256,877,379,74,106,199
2011,Kingston upon Thames 006B,E01002960,1159,793,366,118,136,112
2011,Kingston upon Thames 006C,E01002962,1103,795,308,103,78,127
2011,Kingston upon Thames 006D,E01002970,1196,874,322,75,112,135
2011,Kingston upon Thames 006E,E01002973,1026,733,293,66,92,135
2011,Kingston upon Thames 007A,E01002929,1211,871,340,159,95,86
2011,Kingston upon Thames 007B,E01002930,1266,951,315,98,79,138
2011,Kingston upon Thames 007C,E01002931,1316,968,348,117,101,130
2011,Kingston upon Thames 007D,E01002963,1281,935,346,128,105,113
2011,Kingston upon Thames 007E,E01002985,1183,853,330,104,97,129
2011,Kingston upon Thames 008A,E01002927,1137,801,336,137,99,100
2011,Kingston upon Thames 008B,E01002928,1156,820,336,107,70,159
2011,Kingston upon Thames 008C,E01002958,1241,985,256,99,52,105
2011,Kingston upon Thames 008D,E01002961,1260,889,371,132,103,136
2011,Kingston upon Thames 008E,E01002986,922,641,281,102,62,117
2011,Kingston upon Thames 009A,E01002965,1927,1348,579,104,334,141
2011,Kingston upon Thames 009B,E01002967,1534,1225,309,126,93,90
2011,Kingston upon Thames 009C,E01002968,2276,1444,832,122,565,145
2011,Kingston upon Thames 009D,E01002990,1437,1193,244,88,91,65
2011,Kingston upon Thames 009E,E01002991,1317,1006,311,99,150,62
2011,Kingston upon Thames 010A,E01002922,1223,890,333,157,77,99
2011,Kingston upon Thames 010B,E01002926,1081,806,275,133,77,65
2011,Kingston upon Thames 010C,E01002966,1461,1104,357,77,162,118
2011,Kingston upon Thames 010D,E01002992,1548,899,649,61,533,55
2011,Kingston upon Thames 011A,E01002921,1302,1017,285,86,101,98
2011,Kingston upon Thames 011B,E01002987,1411,1079,332,86,97,149
2011,Kingston upon Thames 011C,E01002988,1652,1047,605,60,477,68
2011,Kingston upon Thames 011D,E01002989,1535,1306,229,89,54,86
2011,Kingston upon Thames 012A,E01002975,991,683,308,131,67,110
2011,Kingston upon Thames 012B,E01002977,1168,788,380,147,61,172
2011,Kingston upon Thames 012C,E01002980,1049,732,317,141,74,102
2011,Kingston upon Thames 012D,E01002981,1118,753,365,152,97,116
2011,Kingston upon Thames 012E,E01002984,965,647,318,121,60,137
2011,Kingston upon Thames 013A,E01002923,1191,707,484,176,156,152
2011,Kingston upon Thames 013B,E01002925,1249,1056,193,57,61,75
2011,Kingston upon Thames 013C,E01002993,1262,1019,243,99,70,74
2011,Kingston upon Thames 013D,E01002995,1060,791,269,110,54,105
2011,Kingston upon Thames 013E,E01002999,1191,929,262,54,108,100
2011,Kingston upon Thames 014A,E01002915,991,752,239,125,50,64
2011,Kingston upon Thames 014B,E01002916,1077,758,319,159,81,79
2011,Kingston upon Thames 014C,E01002917,1019,720,299,158,68,73
2011,Kingston upon Thames 014D,E01002920,1108,813,295,157,56,82
2011,Kingston upon Thames 014E,E01002924,1060,760,300,172,53,75
2011,Kingston upon Thames 015A,E01002976,1185,890,295,154,58,83
2011,Kingston upon Thames 015B,E01002978,1337,982,355,185,66,104
2011,Kingston upon Thames 015C,E01002979,1168,864,304,160,52,92
2011,Kingston upon Thames 015D,E01002982,1007,683,324,167,64,93
2011,Kingston upon Thames 015E,E01002983,1210,863,347,166,89,92
2011,Kingston upon Thames 016A,E01002994,1079,825,254,129,33,92
2011,Kingston upon Thames 016B,E01002996,1106,889,217,93,52,72
2011,Kingston upon Thames 016C,E01002997,1114,868,246,90,51,105
2011,Kingston upon Thames 016D,E01002998,1113,820,293,106,70,117
2011,Kingston upon Thames 016E,E01003002,1320,999,321,122,66,133
2011,Kingston upon Thames 017A,E01002918,1223,912,311,105,79,127
2011,Kingston upon Thames 017B,E01002919,1256,912,344,127,82,135
2011,Kingston upon Thames 017C,E01003000,1153,833,320,127,77,116
2011,Kingston upon Thames 017D,E01003001,1340,1013,327,125,88,114
2011,Kingston upon Thames 017E,E01003003,1176,894,282,84,74,124
2011,Kingston upon Thames 018A,E01002939,1140,868,272,99,59,114
2011,Kingston upon Thames 018B,E01002941,1090,787,303,171,48,84
2011,Kingston upon Thames 018C,E01002942,996,750,246,134,37,75
2011,Kingston upon Thames 018D,E01003004,1137,877,260,127,54,79
2011,Kingston upon Thames 018E,E01003005,1090,831,259,133,40,86
2011,Kingston upon Thames 019A,E01002944,979,749,230,105,44,81
2011,Kingston upon Thames 019B,E01002945,1154,938,216,112,28,76
2011,Kingston upon Thames 019C,E01002946,1144,875,269,153,34,82
2011,Kingston upon Thames 019D,E01002947,1188,930,258,140,47,71
2011,Kingston upon Thames 020A,E01002940,1104,830,274,128,43,103
2011,Kingston upon Thames 020B,E01002943,1036,738,298,127,58,113
2011,Kingston upon Thames 020C,E01002948,1492,1113,379,152,70,157
2011,Kingston upon Thames 020D,E01002949,1341,1007,334,148,71,115
2011,Kingston upon Thames 020E,E01002950,1148,858,290,118,38,134
2011,Merton 001A,E01003472,957,738,219,90,39,90
2011,Merton 001B,E01003473,1040,817,223,72,62,89
2011,Merton 001C,E01003474,1007,700,307,91,90,126
2011,Merton 001D,E01003475,2002,1649,353,95,92,166
2011,Merton 001E,E01003478,1182,967,215,74,44,97
2011,Merton 002A,E01003460,1097,740,357,155,59,143
2011,Merton 002B,E01003462,1021,666,355,160,65,130
2011,Merton 002C,E01003464,930,580,350,146,49,155
2011,Merton 002D,E01003465,893,572,321,116,58,147
2011,Merton 003A,E01003400,1228,1023,205,66,60,79
2011,Merton 003B,E01003454,1033,838,195,63,48,84
2011,Merton 003C,E01003456,1276,1015,261,65,72,124
2011,Merton 003D,E01003476,1045,791,254,55,83,116
2011,Merton 003E,E01003477,1164,907,257,70,71,116
2011,Merton 004A,E01003401,1027,777,250,95,52,103
2011,Merton 004B,E01003402,1183,876,307,104,67,136
2011,Merton 004C,E01003403,1159,889,270,107,54,109
2011,Merton 004D,E01003404,1334,1064,270,110,64,96
2011,Merton 004E,E01003461,1223,940,283,115,60,108
2011,Merton 005A,E01003367,2014,1533,481,110,236,135
2011,Merton 005B,E01003369,1410,1165,245,71,80,94
2011,Merton 005C,E01003370,1668,1384,284,66,99,119
2011,Merton 005D,E01003371,1274,1012,262,80,107,75
2011,Merton 005E,E01003455,1301,1115,186,40,46,100
2011,Merton 006A,E01003359,1356,1055,301,108,65,128
2011,Merton 006B,E01003360,1359,1171,188,74,36,78
2011,Merton 006C,E01003457,1191,961,230,90,42,98
2011,Merton 006D,E01003458,1281,1052,229,94,39,96
2011,Merton 006E,E01003459,1639,1316,323,89,61,173
2011,Merton 007A,E01003394,1494,1104,390,119,91,180
2011,Merton 007B,E01003395,1113,794,319,134,81,104
2011,Merton 007C,E01003396,1249,915,334,109,101,124
2011,Merton 007D,E01003397,1189,854,335,109,93,133
2011,Merton 007E,E01003398,1291,921,370,119,121,130
2011,Merton 008A,E01003368,1254,928,326,97,71,158
2011,Merton 008B,E01003372,1175,848,327,76,87,164
2011,Merton 008C,E01003393,1234,962,272,53,78,141
2011,Merton 008D,E01003406,1200,880,320,57,103,160
2011,Merton 008E,E01003407,1449,1182,267,66,67,134
2011,Merton 009A,E01003355,1302,1124,178,61,37,80
2011,Merton 009B,E01003356,1354,1076,278,87,67,124
2011,Merton 009C,E01003358,1521,1266,255,70,80,105
2011,Merton 009D,E01003383,1274,1074,200,61,57,82
2011,Merton 009E,E01003384,1206,980,226,79,71,76
2011,Merton 010A,E01003442,1190,867,323,131,57,135
2011,Merton 010B,E01003443,1118,831,287,127,59,101
2011,Merton 010C,E01003444,1125,859,266,111,48,107
2011,Merton 010D,E01003445,1241,926,315,148,63,104
2011,Merton 010E,E01003463,904,607,297,117,54,126
2011,Merton 011A,E01003380,1264,1047,217,106,51,60
2011,Merton 011B,E01003382,1187,972,215,103,30,82
2011,Merton 011C,E01003385,1193,933,260,83,67,110
2011,Merton 011D,E01003399,1132,921,211,86,47,78
2011,Merton 011E,E01003423,1167,910,257,104,67,86
2011,Merton 012A,E01003357,1358,986,372,72,98,202
2011,Merton 012B,E01003376,1188,829,359,105,79,175
2011,Merton 012C,E01003377,1109,742,367,63,106,198
2011,Merton 012D,E01003408,1527,1237,290,98,65,127
2011,Merton 012E,E01003410,1230,947,283,75,60,148
2011,Merton 013A,E01003386,1551,1113,438,98,127,213
2011,Merton 013B,E01003388,1062,705,357,138,85,134
2011,Merton 013C,E01003389,1288,935,353,93,98,162
2011,Merton 013D,E01003392,1009,756,253,69,68,116
2011,Merton 013E,E01003409,1221,849,372,92,105,175
2011,Merton 014A,E01003387,1162,825,337,99,81,157
2011,Merton 014B,E01003391,943,626,317,70,69,178
2011,Merton 014C,E01003411,1261,956,305,92,72,141
2011,Merton 014D,E01003412,1198,881,317,81,97,139
2011,Merton 014E,E01003435,968,701,267,111,77,79
2011,Merton 015A,E01003361,1252,922,330,125,94,111
2011,Merton 015B,E01003424,1068,745,323,179,59,85
2011,Merton 015C,E01003425,1044,749,295,154,67,74
2011,Merton 015D,E01003426,1253,895,358,158,90,110
2011,Merton 015E,E01003428,1084,826,258,105,64,89
2011,Merton 016A,E01003366,1178,897,281,106,60,115
2011,Merton 016B,E01003381,1187,990,197,95,41,61
2011,Merton 016C,E01003446,1365,1113,252,85,63,104
2011,Merton 016D,E01003447,1152,857,295,98,56,141
2011,Merton 016E,E01003471,1122,851,271,124,46,101
2011,Merton 017A,E01003413,1388,1054,334,100,84,150
2011,Merton 017B,E01003414,1185,818,367,124,110,133
2011,Merton 017C,E01003415,1183,841,342,126,99,117
2011,Merton 017D,E01003416,1145,796,349,166,84,99
2011,Merton 017E,E01003434,1095,816,279,87,91,101
2011,Merton 018A,E01003373,1016,652,364,84,77,203
2011,Merton 018B,E01003378,1442,1102,340,91,101,148
2011,Merton 018C,E01003379,1221,826,395,114,82,199
2011,Merton 018D,E01003390,1151,811,340,58,86,196
2011,Merton 018E,E01003405,1254,870,384,114,89,181
2011,Merton 019A,E01003429,1052,765,287,93,81,113
2011,Merton 019B,E01003430,1010,716,294,80,71,143
2011,Merton 019C,E01003431,1066,737,329,92,84,153
2011,Merton 019D,E01003432,1035,718,317,66,101,150
2011,Merton 019E,E01003433,1102,781,321,116,86,119
2011,Merton 020A,E01003466,1167,853,314,162,67,85
2011,Merton 020B,E01003467,1181,876,305,146,70,89
2011,Merton 020C,E01003468,1228,968,260,126,60,74
2011,Merton 020D,E01003469,1188,918,270,71,74,125
2011,Merton 020E,E01003470,1302,955,347,108,110,129
2011,Merton 021A,E01003362,997,708,289,163,54,72
2011,Merton 021B,E01003363,1170,878,292,150,59,83
2011,Merton 021C,E01003364,1272,916,356,198,66,92
2011,Merton 021D,E01003365,1045,731,314,137,77,100
2011,Merton 021E,E01003421,1206,914,292,128,49,115
2011,Merton 022A,E01003374,1000,660,340,85,57,198
2011,Merton 022B,E01003375,1179,861,318,147,61,110
2011,Merton 022C,E01003437,1370,929,441,186,83,172
2011,Merton 022D,E01003440,1142,809,333,111,74,148
2011,Merton 022E,E01003441,1290,912,378,100,107,171
2011,Merton 023A,E01003427,1357,987,370,109,95,166
2011,Merton 023B,E01003436,1092,781,311,86,66,159
2011,Merton 023C,E01003439,1076,792,284,73,73,138
2011,Merton 023D,E01003448,1213,853,360,108,82,170
2011,Merton 023E,E01003453,1194,827,367,88,80,199
2011,Merton 024A,E01003438,1196,843,353,103,90,160
2011,Merton 024B,E01003449,1262,855,407,145,85,177
2011,Merton 024C,E01003450,1107,811,296,94,64,138
2011,Merton 024D,E01003451,1239,915,324,157,72,95
2011,Merton 024E,E01003452,1405,976,429,132,101,196
2011,Merton 025A,E01003417,1145,876,269,143,49,77
2011,Merton 025B,E01003418,1083,843,240,117,54,69
2011,Merton 025C,E01003419,1260,964,296,129,58,109
2011,Merton 025D,E01003420,979,747,232,104,57,71
2011,Merton 025E,E01003422,1008,750,258,117,55,86
2011,Redbridge 001A,E01003744,997,733,264,162,36,66
2011,Redbridge 001B,E01003745,1043,747,296,136,74,86
2011,Redbridge 001C,E01003746,1042,761,281,171,57,53
2011,Redbridge 001D,E01003747,922,647,275,145,47,83
2011,Redbridge 001E,E01003748,1085,746,339,151,72,116
2011,Redbridge 001F,E01003749,1215,902,313,161,55,97
2011,Redbridge 001G,E01003750,1204,902,302,149,51,102
2011,Redbridge 002A,E01003720,1260,787,473,190,69,214
2011,Redbridge 002B,E01003722,1256,853,403,128,93,182
2011,Redbridge 002C,E01003723,1188,816,372,127,68,177
2011,Redbridge 002D,E01003726,1048,694,354,91,73,190
2011,Redbridge 003A,E01003721,1129,764,365,137,70,158
2011,Redbridge 003B,E01003724,964,695,269,88,58,123
2011,Redbridge 003C,E01003725,1057,756,301,96,48,157
2011,Redbridge 003D,E01003727,1109,720,389,124,70,195
2011,Redbridge 004A,E01003654,1130,806,324,133,70,121
2011,Redbridge 004B,E01003655,1155,865,290,138,50,102
2011,Redbridge 004C,E01003658,1184,827,357,121,74,162
2011,Redbridge 004D,E01003660,1292,1005,287,118,67,102
2011,Redbridge 005A,E01003656,1078,757,321,126,61,134
2011,Redbridge 005B,E01003657,1568,1127,441,228,70,143
2011,Redbridge 005C,E01003659,1200,910,290,115,70,105
2011,Redbridge 006A,E01003698,1028,744,284,130,49,105
2011,Redbridge 006B,E01003699,1042,784,258,114,48,96
2011,Redbridge 006C,E01003700,1641,1131,510,178,127,205
2011,Redbridge 006D,E01003701,1262,875,387,133,94,160
2011,Redbridge 006E,E01003702,1226,888,338,146,69,123
2011,Redbridge 006F,E01003703,1853,1322,531,188,114,229
2011,Redbridge 006G,E01003704,1218,828,390,140,77,173
2011,Redbridge 007A,E01003668,1226,981,245,100,43,102
2011,Redbridge 007B,E01003669,1162,899,263,121,55,87
2011,Redbridge 007C,E01003670,1079,815,264,123,57,84
2011,Redbridge 007D,E01003671,1126,871,255,138,53,64
2011,Redbridge 007E,E01003672,1008,768,240,59,55,126
2011,Redbridge 007F,E01003673,1403,1141,262,110,51,101
2011,Redbridge 007G,E01003674,1693,1389,304,105,74,125
2011,Redbridge 008A,E01003707,981,668,313,120,82,111
2011,Redbridge 008B,E01003708,1012,640,372,96,84,192
2011,Redbridge 008C,E01003709,1150,774,376,177,82,117
2011,Redbridge 008D,E01003710,1114,764,350,127,103,120
2011,Redbridge 009A,E01003759,1087,746,341,190,65,86
2011,Redbridge 009B,E01003760,1308,981,327,118,83,126
2011,Redbridge 009C,E01003761,1154,760,394,84,80,230
2011,Redbridge 009D,E01003762,1231,951,280,114,71,95
2011,Redbridge 009E,E01003763,1317,978,339,137,85,117
2011,Redbridge 009F,E01003764,1495,1184,311,126,71,114
2011,Redbridge 009G,E01003765,1186,980,206,79,49,78
2011,Redbridge 010A,E01003705,1576,1116,460,154,113,193
2011,Redbridge 010B,E01003706,1059,722,337,137,64,136
2011,Redbridge 010C,E01003711,1250,883,367,163,71,133
2011,Redbridge 010D,E01003712,937,585,352,97,88,167
2011,Redbridge 012A,E01003646,1261,844,417,124,139,154
2011,Redbridge 012B,E01003648,1040,695,345,150,84,111
2011,Redbridge 012C,E01003649,1199,825,374,138,115,121
2011,Redbridge 012D,E01003651,1077,776,301,110,89,102
2011,Redbridge 013A,E01003639,1249,858,391,127,82,182
2011,Redbridge 013B,E01003640,1259,893,366,126,98,142
2011,Redbridge 013C,E01003641,1223,901,322,90,97,135
2011,Redbridge 013D,E01003642,1172,773,399,105,120,174
2011,Redbridge 014A,E01003774,1365,1078,287,124,53,110
2011,Redbridge 014B,E01003775,1259,939,320,141,61,118
2011,Redbridge 014C,E01003776,1153,835,318,143,55,120
2011,Redbridge 014D,E01003777,1399,1146,253,101,61,91
2011,Redbridge 014E,E01003778,1432,1157,275,126,66,83
2011,Redbridge 014F,E01003779,1120,809,311,141,49,121
2011,Redbridge 014G,E01003780,1108,773,335,144,83,108
2011,Redbridge 015A,E01003647,1302,907,395,123,112,160
2011,Redbridge 015B,E01003650,1031,689,342,127,71,144
2011,Redbridge 015C,E01003652,1107,771,336,98,121,117
2011,Redbridge 015D,E01003653,1053,724,329,101,85,143
2011,Redbridge 017A,E01003638,1176,793,383,147,108,128
2011,Redbridge 017B,E01003643,1239,849,390,133,100,157
2011,Redbridge 017C,E01003644,1125,743,382,140,97,145
2011,Redbridge 017D,E01003645,1838,1363,475,105,122,248
2011,Redbridge 018A,E01003789,1102,840,262,131,52,79
2011,Redbridge 018B,E01003794,1032,760,272,117,52,103
2011,Redbridge 018C,E01003795,848,635,213,103,49,61
2011,Redbridge 018D,E01003796,1164,848,316,139,76,101
2011,Redbridge 019A,E01003661,1385,974,411,130,126,155
2011,Redbridge 019B,E01003662,1325,962,363,84,83,196
2011,Redbridge 019C,E01003663,1128,757,371,155,88,128
2011,Redbridge 019D,E01003664,1218,885,333,111,71,151
2011,Redbridge 019E,E01003665,1131,810,321,107,94,120
2011,Redbridge 019F,E01003666,1535,1165,370,66,97,207
2011,Redbridge 019H,E01033590,797,585,212,22,62,128
2011,Redbridge 019I,E01033592,1382,1015,367,85,122,160
2011,Redbridge 020A,E01003751,1353,899,454,136,126,192
2011,Redbridge 020B,E01003753,1400,948,452,122,140,190
2011,Redbridge 020C,E01003754,1143,735,408,136,131,141
2011,Redbridge 020D,E01003757,1393,941,452,103,130,219
2011,Redbridge 022A,E01003769,1232,773,459,92,129,238
2011,Redbridge 022B,E01003770,1831,1206,625,126,212,287
2011,Redbridge 022C,E01003771,1332,865,467,111,108,248
2011,Redbridge 022D,E01003773,1180,820,360,102,98,160
2011,Redbridge 023A,E01003752,1905,1370,535,169,148,218
2011,Redbridge 023B,E01003755,1378,902,476,106,170,200
2011,Redbridge 023C,E01003756,1500,983,517,132,172,213
2011,Redbridge 023D,E01003758,1743,1125,618,87,208,323
2011,Redbridge 024A,E01003766,1376,860,516,126,134,256
2011,Redbridge 024B,E01003767,1348,882,466,94,173,199
2011,Redbridge 024C,E01003768,1320,839,481,109,123,249
2011,Redbridge 024D,E01003772,1225,816,409,129,112,168
2011,Redbridge 026A,E01003781,1223,819,404,107,118,179
2011,Redbridge 026B,E01003782,1240,804,436,84,118,234
2011,Redbridge 026C,E01003786,1034,704,330,95,108,127
2011,Redbridge 026D,E01003787,1096,704,392,114,89,189
2011,Redbridge 027A,E01003790,1030,739,291,110,76,105
2011,Redbridge 027B,E01003791,1124,825,299,156,59,84
2011,Redbridge 027C,E01003792,1042,770,272,120,78,74
2011,Redbridge 027D,E01003793,1130,801,329,125,59,145
2011,Redbridge 029A,E01003783,1633,1051,582,89,171,322
2011,Redbridge 029B,E01003784,1266,856,410,109,99,202
2011,Redbridge 029C,E01003785,1361,926,435,98,104,233
2011,Redbridge 029D,E01003788,1331,879,452,75,109,268
2011,Redbridge 030A,E01003683,1420,878,542,105,170,267
2011,Redbridge 030B,E01003684,1180,751,429,85,133,211
2011,Redbridge 030C,E01003685,1301,802,499,102,181,216
2011,Redbridge 030D,E01003686,1343,849,494,98,146,250
2011,Redbridge 030F,E01003688,1316,790,526,110,150,266
2011,Redbridge 030G,E01003689,1079,629,450,91,115,244
2011,Redbridge 030H,E01033589,1265,940,325,19,104,202
2011,Redbridge 030I,E01033591,1364,826,538,80,180,278
2011,Redbridge 031A,E01003737,1251,819,432,165,112,155
2011,Redbridge 031B,E01003738,1497,1018,479,149,125,205
2011,Redbridge 031C,E01003739,1512,1041,471,117,145,209
2011,Redbridge 031D,E01003740,1451,971,480,156,127,197
2011,Redbridge 031E,E01003741,1207,800,407,159,102,146
2011,Redbridge 031F,E01003742,1434,987,447,91,144,212
2011,Redbridge 031G,E01003743,1212,774,438,92,137,209
2011,Redbridge 032A,E01003728,1773,1168,605,98,211,296
2011,Redbridge 032B,E01003729,1190,715,475,88,128,259
2011,Redbridge 032C,E01003730,1129,686,443,68,119,256
2011,Redbridge 032D,E01003732,990,621,369,51,87,231
2011,Redbridge 032E,E01003733,1254,763,491,77,203,211
2011,Redbridge 033A,E01003731,1025,636,389,64,118,207
2011,Redbridge 033B,E01003734,1190,733,457,100,146,211
2011,Redbridge 033C,E01003735,1447,797,650,95,158,397
2011,Redbridge 033D,E01003736,1103,720,383,48,113,222
2011,Redbridge 034A,E01003713,1250,792,458,111,142,205
2011,Redbridge 034B,E01003714,1505,982,523,130,136,257
2011,Redbridge 034C,E01003715,1458,899,559,104,182,273
2011,Redbridge 034D,E01003716,1244,840,404,115,94,195
2011,Redbridge 034E,E01003718,1332,915,417,85,83,249
2011,Redbridge 034F,E01003719,1468,984,484,127,131,226
2011,Redbridge 034G,E01032581,1228,860,368,78,96,194
2011,Redbridge 035A,E01003690,1211,819,392,118,97,177
2011,Redbridge 035B,E01003691,1032,674,358,91,101,166
2011,Redbridge 035C,E01003692,1133,731,402,119,102,181
2011,Redbridge 035D,E01003693,1172,744,428,149,117,162
2011,Redbridge 035E,E01003694,1085,681,404,137,102,165
2011,Redbridge 035F,E01003695,1165,749,416,107,87,222
2011,Redbridge 035G,E01003696,1377,880,497,134,227,136
2011,Redbridge 035H,E01003697,1181,843,338,96,111,131
2011,Redbridge 036A,E01003675,1129,787,342,122,107,113
2011,Redbridge 036B,E01003676,1203,821,382,118,128,136
2011,Redbridge 036C,E01003677,1096,721,375,158,113,104
2011,Redbridge 036D,E01003678,1151,788,363,116,123,124
2011,Redbridge 036E,E01003679,1195,839,356,114,106,136
2011,Redbridge 036F,E01003680,1159,816,343,113,129,101
2011,Redbridge 036G,E01003681,1278,852,426,143,120,163
2011,Redbridge 036H,E01003682,1206,838,368,118,109,141
2011,Richmond upon Thames 001A,E01003797,958,627,331,125,72,134
2011,Richmond upon Thames 001B,E01003798,1105,799,306,126,58,122
2011,Richmond upon Thames 001C,E01003799,1178,882,296,100,60,136
2011,Richmond upon Thames 001D,E01003800,1119,788,331,106,74,151
2011,Richmond upon Thames 001E,E01003801,1010,782,228,90,60,78
2011,Richmond upon Thames 001F,E01003802,1033,749,284,104,60,120
2011,Richmond upon Thames 001G,E01003803,1083,741,342,96,90,156
2011,Richmond upon Thames 002A,E01003846,1213,884,329,121,95,113
2011,Richmond upon Thames 002B,E01003847,1238,960,278,142,53,83
2011,Richmond upon Thames 002C,E01003849,1122,824,298,142,41,115
2011,Richmond upon Thames 002D,E01003851,1171,854,317,146,53,118
2011,Richmond upon Thames 002E,E01003860,1389,1121,268,108,53,107
2011,Richmond upon Thames 002F,E01003864,1121,847,274,128,58,88
2011,Richmond upon Thames 003A,E01003852,1011,762,249,110,48,91
2011,Richmond upon Thames 003B,E01003853,1097,760,337,135,60,142
2011,Richmond upon Thames 003C,E01003854,1058,810,248,96,45,107
2011,Richmond upon Thames 003D,E01003855,1309,981,328,98,76,154
2011,Richmond upon Thames 003E,E01003856,1237,1054,183,75,24,84
2011,Richmond upon Thames 003F,E01003857,1290,1034,256,103,43,110
2011,Richmond upon Thames 003G,E01003858,1205,928,277,109,49,119
2011,Richmond upon Thames 004A,E01003848,1386,1132,254,100,52,102
2011,Richmond upon Thames 004C,E01003861,1405,1168,237,81,55,101
2011,Richmond upon Thames 004D,E01003862,1034,780,254,116,40,98
2011,Richmond upon Thames 004E,E01003863,990,721,269,111,44,114
2011,Richmond upon Thames 004F,E01003865,940,719,221,97,45,79
2011,Richmond upon Thames 004G,E01033570,1182,930,252,49,57,146
2011,Richmond upon Thames 004H,E01033571,1073,783,290,105,71,114
2011,Richmond upon Thames 005A,E01003804,1256,983,273,110,62,101
2011,Richmond upon Thames 005B,E01003807,1366,1116,250,100,50,100
2011,Richmond upon Thames 005C,E01003808,1327,1063,264,113,53,98
2011,Richmond upon Thames 005D,E01003809,1208,890,318,133,63,122
2011,Richmond upon Thames 005E,E01003859,1116,847,269,113,57,99
2011,Richmond upon Thames 006A,E01003873,1249,1003,246,92,45,109
2011,Richmond upon Thames 006B,E01003874,1235,1009,226,89,38,99
2011,Richmond upon Thames 006C,E01003875,1123,777,346,126,72,148
2011,Richmond upon Thames 006D,E01003878,1032,725,307,130,53,124
2011,Richmond upon Thames 007A,E01003866,1121,886,235,86,47,102
2011,Richmond upon Thames 007B,E01003868,1135,929,206,86,35,85
2011,Richmond upon Thames 007C,E01003871,1171,954,217,76,42,99
2011,Richmond upon Thames 007D,E01003872,1102,876,226,92,46,88
2011,Richmond upon Thames 008A,E01003821,1196,949,247,115,38,94
2011,Richmond upon Thames 008B,E01003876,1303,1014,289,131,61,97
2011,Richmond upon Thames 008C,E01003877,1082,809,273,127,43,103
2011,Richmond upon Thames 008D,E01003879,1245,859,386,94,190,102
2011,Richmond upon Thames 009A,E01003892,1470,1115,355,163,47,145
2011,Richmond upon Thames 009B,E01003893,1212,947,265,130,47,88
2011,Richmond upon Thames 009C,E01003894,1265,1035,230,100,48,82
2011,Richmond upon Thames 009D,E01003895,1268,1005,263,116,48,99
2011,Richmond upon Thames 010A,E01003905,1056,827,229,101,53,75
2011,Richmond upon Thames 010B,E01003906,1173,883,290,130,51,109
2011,Richmond upon Thames 010C,E01003907,1221,830,391,148,88,155
2011,Richmond upon Thames 010D,E01003908,1324,993,331,164,85,82
2011,Richmond upon Thames 010E,E01003909,1134,833,301,141,69,91
2011,Richmond upon Thames 011A,E01003867,1106,844,262,91,76,95
2011,Richmond upon Thames 011B,E01003869,1265,1016,249,103,52,94
2011,Richmond upon Thames 011C,E01003870,1353,1082,271,103,64,104
2011,Richmond upon Thames 011D,E01003910,1149,868,281,162,42,77
2011,Richmond upon Thames 012A,E01003805,1099,757,342,150,69,123
2011,Richmond upon Thames 012B,E01003806,1036,718,318,135,91,92
2011,Richmond upon Thames 012C,E01003816,1118,730,388,163,65,160
2011,Richmond upon Thames 012D,E01003817,1418,973,445,155,47,243
2011,Richmond upon Thames 013A,E01003840,1174,869,305,109,70,126
2011,Richmond upon Thames 013B,E01003841,1389,943,446,116,121,209
2011,Richmond upon Thames 013C,E01003842,1215,868,347,137,77,133
2011,Richmond upon Thames 013D,E01003843,1457,1007,450,178,84,188
2011,Richmond upon Thames 013E,E01003844,1070,776,294,154,59,81
2011,Richmond upon Thames 013F,E01003845,1190,820,370,199,63,108
2011,Richmond upon Thames 014A,E01003882,1338,1081,257,100,62,95
2011,Richmond upon Thames 014B,E01003883,1409,1198,211,99,26,86
2011,Richmond upon Thames 014C,E01003896,1342,1093,249,85,86,78
2011,Richmond upon Thames 014D,E01003897,1426,1177,249,80,106,63
2011,Richmond upon Thames 015A,E01003898,1128,961,167,74,32,61
2011,Richmond upon Thames 015B,E01003899,1032,836,196,96,30,70
2011,Richmond upon Thames 015C,E01003900,1119,796,323,116,72,135
2011,Richmond upon Thames 015D,E01003901,1149,930,219,90,54,75
2011,Richmond upon Thames 015E,E01003902,928,717,211,107,43,61
2011,Richmond upon Thames 015F,E01003903,1172,854,318,128,76,114
2011,Richmond upon Thames 015G,E01003904,1119,882,237,102,61,74
2011,Richmond upon Thames 016A,E01003880,1077,842,235,105,52,78
2011,Richmond upon Thames 016B,E01003881,1559,979,580,109,397,74
2011,Richmond upon Thames 016C,E01003884,1209,902,307,126,73,108
2011,Richmond upon Thames 016D,E01003885,1098,869,229,81,55,93
2011,Richmond upon Thames 017A,E01003818,1116,836,280,151,41,88
2011,Richmond upon Thames 017B,E01003819,1219,875,344,108,64,172
2011,Richmond upon Thames 017C,E01003820,1377,1042,335,139,63,133
2011,Richmond upon Thames 018A,E01003811,1127,925,202,93,35,74
2011,Richmond upon Thames 018B,E01003812,1377,1073,304,96,79,129
2011,Richmond upon Thames 018C,E01003890,1146,882,264,122,68,74
2011,Richmond upon Thames 018D,E01003891,1322,995,327,191,59,77
2011,Richmond upon Thames 019A,E01003810,1169,911,258,109,58,91
2011,Richmond upon Thames 019B,E01003813,1150,848,302,135,75,92
2011,Richmond upon Thames 019C,E01003814,1199,916,283,144,52,87
2011,Richmond upon Thames 019D,E01003815,1328,1030,298,119,49,130
2011,Richmond upon Thames 020A,E01003828,1105,788,317,180,57,80
2011,Richmond upon Thames 020B,E01003829,1220,848,372,139,72,161
2011,Richmond upon Thames 020C,E01003830,1273,927,346,158,79,109
2011,Richmond upon Thames 020D,E01003831,1154,864,290,133,42,115
2011,Richmond upon Thames 020E,E01003832,1065,709,356,113,52,191
2011,Richmond upon Thames 020F,E01003833,1029,798,231,105,39,87
2011,Richmond upon Thames 021A,E01003886,1234,999,235,98,66,71
2011,Richmond upon Thames 021B,E01003887,1294,1048,246,117,52,77
2011,Richmond upon Thames 021C,E01003888,1391,1034,357,156,76,125
2011,Richmond upon Thames 021D,E01003889,1294,985,309,169,53,87
2011,Richmond upon Thames 022A,E01003834,1352,941,411,128,182,101
2011,Richmond upon Thames 022B,E01003835,1062,807,255,87,72,96
2011,Richmond upon Thames 022C,E01003836,1034,673,361,128,78,155
2011,Richmond upon Thames 022D,E01003837,1273,883,390,186,64,140
2011,Richmond upon Thames 022E,E01003838,1318,1041,277,106,68,103
2011,Richmond upon Thames 022F,E01003839,1390,1040,350,122,63,165
2011,Richmond upon Thames 023A,E01003822,1022,707,315,157,67,91
2011,Richmond upon Thames 023B,E01003823,1278,981,297,160,57,80
2011,Richmond upon Thames 023C,E01003824,1153,834,319,151,54,114
2011,Richmond upon Thames 023D,E01003825,1266,965,301,153,63,85
2011,Richmond upon Thames 023E,E01003826,1235,865,370,147,62,161
2011,Richmond upon Thames 023F,E01003827,1316,1055,261,116,50,95
2011,Sutton 001A,E01004125,1088,765,323,88,69,166
2011,Sutton 001B,E01004183,1223,916,307,90,71,146
2011,Sutton 001C,E01004184,1071,751,320,90,69,161
2011,Sutton 001D,E01004185,1047,728,319,58,66,195
2011,Sutton 001E,E01004189,1313,954,359,110,66,183
2011,Sutton 002A,E01004123,1550,1155,395,95,105,195
2011,Sutton 002B,E01004124,1294,958,336,101,71,164
2011,Sutton 002C,E01004126,1024,717,307,78,64,165
2011,Sutton 002D,E01004128,1088,806,282,87,51,144
2011,Sutton 002E,E01004129,1243,854,389,135,64,190
2011,Sutton 003A,E01004130,1170,877,293,163,60,70
2011,Sutton 003B,E01004131,1164,867,297,122,81,94
2011,Sutton 003C,E01004134,1069,814,255,105,56,94
2011,Sutton 003D,E01004135,1081,796,285,138,59,88
2011,Sutton 003E,E01004136,1172,860,312,159,50,103
2011,Sutton 004A,E01004164,1136,880,256,145,33,78
2011,Sutton 004B,E01004166,1081,871,210,96,41,73
2011,Sutton 004C,E01004169,820,631,189,60,34,95
2011,Sutton 004D,E01004186,1325,1111,214,74,42,98
2011,Sutton 004E,E01004188,1223,949,274,94,58,122
2011,Sutton 005A,E01004127,1157,850,307,106,59,142
2011,Sutton 005B,E01004163,1147,864,283,147,50,86
2011,Sutton 005C,E01004165,1256,987,269,99,51,119
2011,Sutton 005D,E01004167,947,669,278,113,55,110
2011,Sutton 005E,E01004187,1124,845,279,110,54,115
2011,Sutton 006A,E01004117,1069,835,234,112,58,64
2011,Sutton 006B,E01004121,1153,887,266,131,35,100
2011,Sutton 006C,E01004192,1441,1150,291,116,59,116
2011,Sutton 006D,E01004193,1625,1305,320,99,42,179
2011,Sutton 006E,E01004195,1192,899,293,138,57,98
2011,Sutton 007A,E01004144,1196,895,301,155,54,92
2011,Sutton 007B,E01004145,1543,1175,368,155,83,130
2011,Sutton 007C,E01004146,1184,883,301,136,58,107
2011,Sutton 007D,E01004147,1127,794,333,176,58,99
2011,Sutton 008A,E01004116,1077,772,305,176,49,80
2011,Sutton 008B,E01004122,1003,758,245,140,50,55
2011,Sutton 008C,E01004190,1038,755,283,160,54,69
2011,Sutton 008D,E01004191,1182,876,306,158,49,99
2011,Sutton 008E,E01004194,995,792,203,118,23,62
2011,Sutton 008F,E01004196,1076,786,290,163,49,78
2011,Sutton 009A,E01004115,1239,940,299,136,61,102
2011,Sutton 009B,E01004118,1226,914,312,165,51,96
2011,Sutton 009C,E01004119,1060,843,217,107,58,52
2011,Sutton 009D,E01004132,1073,842,231,114,46,71
2011,Sutton 009E,E01004133,1054,804,250,117,53,80
2011,Sutton 010A,E01004171,1064,794,270,156,52,62
2011,Sutton 010B,E01004172,1172,837,335,127,49,159
2011,Sutton 010C,E01004173,1015,768,247,116,46,85
2011,Sutton 010D,E01004175,1192,906,286,122,59,105
2011,Sutton 010E,E01004176,1073,857,216,87,49,80
2011,Sutton 011A,E01004076,1068,818,250,99,47,104
2011,Sutton 011B,E01004077,1136,823,313,145,61,107
2011,Sutton 011C,E01004078,1182,926,256,90,51,115
2011,Sutton 011D,E01004079,1045,781,264,146,59,59
2011,Sutton 011E,E01004080,982,737,245,124,66,55
2011,Sutton 011F,E01004081,1070,841,229,100,41,88
2011,Sutton 011G,E01004082,1045,799,246,123,56,67
2011,Sutton 012A,E01004137,1156,945,211,84,31,96
2011,Sutton 012B,E01004140,1130,806,324,96,57,171
2011,Sutton 012C,E01004141,1137,844,293,102,58,133
2011,Sutton 012D,E01004142,1546,1172,374,122,69,183
2011,Sutton 012E,E01004149,1241,893,348,212,37,99
2011,Sutton 013A,E01004101,993,728,265,149,52,64
2011,Sutton 013B,E01004103,1238,1012,226,88,41,97
2011,Sutton 013C,E01004138,1195,948,247,90,45,112
2011,Sutton 013D,E01004139,1038,824,214,81,45,88
2011,Sutton 013E,E01004168,1167,905,262,143,51,68
2011,Sutton 014A,E01004143,1074,846,228,102,42,84
2011,Sutton 014B,E01004148,1100,796,304,109,67,128
2011,Sutton 014C,E01004159,1121,851,270,143,52,75
2011,Sutton 014D,E01004160,1188,958,230,97,45,88
2011,Sutton 014E,E01004161,1076,882,194,98,23,73
2011,Sutton 015A,E01004097,1237,984,253,110,58,85
2011,Sutton 015B,E01004098,897,679,218,98,44,76
2011,Sutton 015C,E01004099,1084,862,222,102,34,86
2011,Sutton 015D,E01004100,990,736,254,146,46,62
2011,Sutton 015E,E01004102,1000,768,232,102,37,93
2011,Sutton 016A,E01004110,1343,1027,316,134,57,125
2011,Sutton 016B,E01004111,1027,775,252,122,42,88
2011,Sutton 016C,E01004112,1141,834,307,173,50,84
2011,Sutton 016D,E01004120,1133,844,289,150,61,78
2011,Sutton 016E,E01004157,927,685,242,118,53,71
2011,Sutton 017A,E01004087,1106,776,330,200,51,79
2011,Sutton 017B,E01004170,1336,1042,294,151,53,90
2011,Sutton 017C,E01004174,1060,814,246,96,51,99
2011,Sutton 017D,E01004178,1497,1139,358,166,60,132
2011,Sutton 017E,E01004179,1164,886,278,136,59,83
2011,Sutton 018A,E01004152,1137,868,269,119,40,110
2011,Sutton 018B,E01004155,1212,990,222,95,32,95
2011,Sutton 018C,E01004156,1295,1011,284,116,42,126
2011,Sutton 018D,E01004158,1124,883,241,102,46,93
2011,Sutton 018E,E01004162,1157,884,273,115,53,105
2011,Sutton 019A,E01004083,1022,660,362,115,66,181
2011,Sutton 019B,E01004086,1186,860,326,148,69,109
2011,Sutton 019C,E01004088,1250,818,432,104,87,241
2011,Sutton 019D,E01004089,880,598,282,69,52,161
2011,Sutton 019E,E01004182,1077,790,287,93,49,145
2011,Sutton 020A,E01004104,1084,785,299,181,48,70
2011,Sutton 020B,E01004107,1103,825,278,117,46,115
2011,Sutton 020C,E01004177,1123,796,327,146,45,136
2011,Sutton 020D,E01004180,1248,894,354,202,60,92
2011,Sutton 020E,E01004181,1234,908,326,149,43,134
2011,Sutton 021A,E01004090,831,536,295,86,46,163
2011,Sutton 021B,E01004096,1102,847,255,107,38,110
2011,Sutton 021C,E01004150,1137,863,274,124,34,116
2011,Sutton 021D,E01004151,1313,1030,283,98,40,145
2011,Sutton 021E,E01004153,1297,977,320,128,44,148
2011,Sutton 022A,E01004091,971,687,284,178,50,56
2011,Sutton 022B,E01004092,1098,769,329,178,73,78
2011,Sutton 022C,E01004105,1332,1019,313,161,68,84
2011,Sutton 022D,E01004106,1155,818,337,184,77,76
2011,Sutton 022E,E01004154,1056,744,312,184,60,68
2011,Sutton 024A,E01004084,1091,766,325,183,56,86
2011,Sutton 024B,E01004085,1184,857,327,176,66,85
2011,Sutton 024C,E01004108,1160,880,280,120,63,97
2011,Sutton 024D,E01004109,1170,838,332,154,53,125
2011,Sutton 025A,E01004093,1105,827,278,167,44,67
2011,Sutton 025B,E01004094,1199,966,233,105,52,76
2011,Sutton 025C,E01004095,1159,857,302,188,35,79
2011,Sutton 025D,E01004114,1212,799,413,232,69,112
2011,Sutton 025E,E01032623,1254,817,437,247,75,115
2011,Waltham Forest 001A,E01004349,1018,668,350,166,73,111
2011,Waltham Forest 001B,E01004350,1098,691,407,253,37,117
2011,Waltham Forest 001C,E01004351,1130,803,327,177,57,93
2011,Waltham Forest 001D,E01004356,1175,785,390,161,98,131
2011,Waltham Forest 001E,E01004357,1105,752,353,166,72,115
2011,Waltham Forest 002A,E01004352,1380,1025,355,186,77,92
2011,Waltham Forest 002B,E01004353,1336,939,397,215,67,115
2011,Waltham Forest 002C,E01004354,1293,953,340,162,51,127
2011,Waltham Forest 002D,E01004358,1200,844,356,166,63,127
2011,Waltham Forest 002E,E01004359,1246,893,353,152,89,112
2011,Waltham Forest 003A,E01004384,1248,839,409,132,78,199
2011,Waltham Forest 003B,E01004385,963,667,296,112,57,127
2011,Waltham Forest 003C,E01004386,1224,875,349,193,68,88
2011,Waltham Forest 003D,E01004389,1148,758,390,156,59,175
2011,Waltham Forest 003E,E01004390,1112,750,362,122,63,177
2011,Waltham Forest 004A,E01004355,1164,812,352,130,80,142
2011,Waltham Forest 004B,E01004360,980,672,308,165,60,83
2011,Waltham Forest 004C,E01004413,1088,729,359,155,54,150
2011,Waltham Forest 004D,E01004415,1138,765,373,143,94,136
2011,Waltham Forest 004E,E01004416,1243,895,348,150,68,130
2011,Waltham Forest 005A,E01004361,999,734,265,139,46,80
2011,Waltham Forest 005B,E01004414,1140,798,342,139,74,129
2011,Waltham Forest 005C,E01004417,1179,849,330,138,71,121
2011,Waltham Forest 005D,E01004451,1284,938,346,160,76,110
2011,Waltham Forest 005E,E01004452,1165,817,348,132,69,147
2011,Waltham Forest 006A,E01004450,1160,869,291,128,63,100
2011,Waltham Forest 006B,E01004453,1203,864,339,100,91,148
2011,Waltham Forest 006C,E01004454,1200,818,382,136,85,161
2011,Waltham Forest 006D,E01004455,1124,726,398,125,87,186
2011,Waltham Forest 006E,E01004456,1134,696,438,100,116,222
2011,Waltham Forest 007A,E01004379,1060,813,247,119,62,66
2011,Waltham Forest 007B,E01004380,1094,796,298,120,67,111
2011,Waltham Forest 007C,E01004381,1326,1024,302,111,90,101
2011,Waltham Forest 007D,E01004383,1156,833,323,140,73,110
2011,Waltham Forest 007E,E01004387,1122,843,279,128,73,78
2011,Waltham Forest 007F,E01004388,1110,807,303,118,55,130
2011,Waltham Forest 008A,E01004343,1310,1002,308,118,87,103
2011,Waltham Forest 008B,E01004344,1277,904,373,84,101,188
2011,Waltham Forest 008C,E01004382,892,579,313,75,82,156
2011,Waltham Forest 008D,E01004418,1194,843,351,125,80,146
2011,Waltham Forest 008E,E01004419,1191,845,346,128,89,129
2011,Waltham Forest 009A,E01004398,1412,869,543,144,134,265
2011,Waltham Forest 009B,E01004399,1209,729,480,94,133,253
2011,Waltham Forest 009C,E01004400,1267,877,390,102,103,185
2011,Waltham Forest 009D,E01004402,1267,853,414,87,104,223
2011,Waltham Forest 009E,E01004403,1267,844,423,95,107,221
2011,Waltham Forest 010A,E01004345,1372,987,385,96,122,167
2011,Waltham Forest 010B,E01004348,1981,1481,500,95,165,240
2011,Waltham Forest 010C,E01004377,1269,921,348,118,95,135
2011,Waltham Forest 010D,E01004378,1354,957,397,123,107,167
2011,Waltham Forest 011A,E01004342,1559,981,578,100,263,215
2011,Waltham Forest 011B,E01004346,1165,844,321,95,82,144
2011,Waltham Forest 011C,E01004347,1478,1150,328,108,72,148
2011,Waltham Forest 011D,E01004460,1414,986,428,85,139,204
2011,Waltham Forest 011E,E01004462,1362,978,384,88,99,197
2011,Waltham Forest 012A,E01004396,1340,971,369,92,86,191
2011,Waltham Forest 012B,E01004457,1430,1059,371,89,92,190
2011,Waltham Forest 012C,E01004458,1400,992,408,107,109,192
2011,Waltham Forest 012D,E01004459,1028,587,441,74,128,239
2011,Waltham Forest 012E,E01004463,1525,1217,308,71,62,175
2011,Waltham Forest 013A,E01004407,1102,704,398,47,107,244
2011,Waltham Forest 013B,E01004410,1345,942,403,128,94,181
2011,Waltham Forest 013C,E01004464,1105,731,374,56,94,224
2011,Waltham Forest 013D,E01004469,1140,710,430,84,108,238
2011,Waltham Forest 013E,E01004470,1112,774,338,70,93,175
2011,Waltham Forest 013F,E01004471,1218,805,413,111,96,206
2011,Waltham Forest 014A,E01004391,1429,1076,353,90,89,174
2011,Waltham Forest 014B,E01004393,1922,1382,540,105,247,188
2011,Waltham Forest 014C,E01004401,1577,1178,399,87,128,184
2011,Waltham Forest 014D,E01004404,1511,1129,382,65,107,210
2011,Waltham Forest 014E,E01004461,1609,1256,353,87,94,172
2011,Waltham Forest 015A,E01004412,1322,1006,316,81,87,148
2011,Waltham Forest 015B,E01004465,1096,800,296,84,80,132
2011,Waltham Forest 015C,E01004466,1246,967,279,95,54,130
2011,Waltham Forest 015D,E01004467,1530,1104,426,82,112,232
2011,Waltham Forest 015E,E01004468,1206,910,296,125,75,96
2011,Waltham Forest 016A,E01004406,1424,1072,352,66,96,190
2011,Waltham Forest 016B,E01004408,1289,951,338,75,94,169
2011,Waltham Forest 016C,E01004409,1273,903,370,111,88,171
2011,Waltham Forest 016D,E01004411,1402,1018,384,82,121,181
2011,Waltham Forest 016E,E01004443,1385,929,456,90,132,234
2011,Waltham Forest 016F,E01004447,1447,1042,405,78,128,199
2011,Waltham Forest 017A,E01004392,1793,1321,472,98,151,223
2011,Waltham Forest 017B,E01004394,1350,913,437,95,98,244
2011,Waltham Forest 017C,E01004397,1870,1416,454,84,160,210
2011,Waltham Forest 017D,E01004444,1811,1228,583,95,173,315
2011,Waltham Forest 017E,E01004446,1433,961,472,117,143,212
2011,Waltham Forest 018A,E01004395,1160,874,286,101,57,128
2011,Waltham Forest 018B,E01004421,1493,927,566,133,152,281
2011,Waltham Forest 018C,E01004445,1323,927,396,91,110,195
2011,Waltham Forest 018D,E01004448,1359,986,373,70,71,232
2011,Waltham Forest 018E,E01004449,1261,742,519,133,121,265
2011,Waltham Forest 019A,E01004363,1184,863,321,88,104,129
2011,Waltham Forest 019B,E01004364,1244,798,446,91,151,204
2011,Waltham Forest 019C,E01004366,1440,937,503,158,169,176
2011,Waltham Forest 019D,E01004367,1219,792,427,126,96,205
2011,Waltham Forest 019E,E01004368,1505,1072,433,120,123,190
2011,Waltham Forest 020A,E01004365,1805,1252,553,87,192,274
2011,Waltham Forest 020B,E01004405,1216,847,369,67,94,208
2011,Waltham Forest 020C,E01004420,1655,1125,530,105,150,275
2011,Waltham Forest 020D,E01004423,1392,904,488,125,103,260
2011,Waltham Forest 020G,E01033153,1759,1062,697,119,180,398
2011,Waltham Forest 021A,E01004362,1285,923,362,99,118,145
2011,Waltham Forest 021B,E01004436,1343,932,411,91,134,186
2011,Waltham Forest 021C,E01004437,1490,1082,408,103,126,179
2011,Waltham Forest 021D,E01004439,1275,935,340,83,107,150
2011,Waltham Forest 021E,E01004442,1421,1096,325,62,152,111
2011,Waltham Forest 022A,E01004422,1186,792,394,135,87,172
2011,Waltham Forest 022B,E01004424,1312,862,450,85,133,232
2011,Waltham Forest 022C,E01004425,1499,1119,380,54,94,232
2011,Waltham Forest 022D,E01004426,1267,844,423,111,115,197
2011,Waltham Forest 022E,E01004427,1527,1174,353,51,95,207
2011,Waltham Forest 023A,E01004369,1328,1008,320,54,84,182
2011,Waltham Forest 023B,E01004370,1347,1026,321,81,118,122
2011,Waltham Forest 023C,E01004372,1398,1104,294,72,73,149
2011,Waltham Forest 023D,E01004432,1263,885,378,102,93,183
2011,Waltham Forest 023E,E01004435,1429,1002,427,101,111,215
2011,Waltham Forest 024A,E01004333,1282,899,383,71,112,200
2011,Waltham Forest 024B,E01004334,1056,639,417,95,96,226
2011,Waltham Forest 024C,E01004438,1706,1306,400,73,156,171
2011,Waltham Forest 024D,E01004440,1733,1358,375,82,114,179
2011,Waltham Forest 024E,E01004441,1321,1017,304,93,79,132
2011,Waltham Forest 025A,E01004371,1377,989,388,110,131,147
2011,Waltham Forest 025B,E01004373,1376,985,391,95,125,171
2011,Waltham Forest 025C,E01004374,1470,1121,349,93,101,155
2011,Waltham Forest 025D,E01004375,1447,1054,393,78,112,203
2011,Waltham Forest 025E,E01004376,1637,1233,404,94,113,197
2011,Waltham Forest 026A,E01004336,1438,1065,373,64,139,170
2011,Waltham Forest 026B,E01004428,1208,748,460,94,119,247
2011,Waltham Forest 026C,E01004429,1353,956,397,93,112,192
2011,Waltham Forest 026D,E01004430,1817,1355,462,89,168,205
2011,Waltham Forest 026E,E01004434,1482,988,494,116,129,249
2011,Waltham Forest 027A,E01004335,1238,759,479,72,157,250
2011,Waltham Forest 027B,E01004337,1436,999,437,99,114,224
2011,Waltham Forest 027C,E01004338,1451,1087,364,94,117,153
2011,Waltham Forest 027D,E01004339,1364,1008,356,65,89,202
2011,Waltham Forest 027E,E01004340,1406,940,466,111,122,233
2011,Waltham Forest 027F,E01004341,1295,864,431,112,121,198
2011,Waltham Forest 028A,E01004327,919,628,291,86,83,122
2011,Waltham Forest 028B,E01004328,1439,1075,364,61,152,151
2011,Waltham Forest 028C,E01004329,1486,1029,457,81,219,157
2011,Waltham Forest 028D,E01004330,1434,1010,424,100,170,154
2011,Waltham Forest 028E,E01004331,1388,976,412,71,173,168
2011,Waltham Forest 028F,E01004332,1379,1011,368,69,120,179
2011,Bracknell Forest 001C,E01016252,1094,780,314,210,23,81
2011,Bracknell Forest 001D,E01016253,970,758,212,96,37,79
2011,Bracknell Forest 001E,E01032727,2084,1441,643,422,52,169
2011,Bracknell Forest 002A,E01016184,1632,1338,294,140,50,104
2011,Bracknell Forest 002B,E01016185,1063,864,199,76,59,64
2011,Bracknell Forest 002C,E01016186,1326,1008,318,156,48,114
2011,Bracknell Forest 002D,E01016187,1206,951,255,150,35,70
2011,Bracknell Forest 002E,E01016188,1212,1036,176,73,32,71
2011,Bracknell Forest 003A,E01016190,1074,815,259,143,43,73
2011,Bracknell Forest 003B,E01016238,847,624,223,132,23,68
2011,Bracknell Forest 003C,E01016243,1078,898,180,62,33,85
2011,Bracknell Forest 003D,E01016245,1734,1433,301,123,62,116
2011,Bracknell Forest 003E,E01016246,1135,964,171,74,32,65
2011,Bracknell Forest 003F,E01016247,1251,1085,166,65,30,71
2011,Bracknell Forest 004A,E01016239,1071,842,229,111,35,83
2011,Bracknell Forest 004B,E01016240,1099,858,241,98,33,110
2011,Bracknell Forest 004C,E01016241,1103,852,251,115,31,105
2011,Bracknell Forest 004D,E01016242,1262,968,294,90,39,165
2011,Bracknell Forest 005A,E01016180,982,729,253,123,75,55
2011,Bracknell Forest 005B,E01016181,1002,693,309,127,109,73
2011,Bracknell Forest 005C,E01016182,1061,827,234,138,28,68
2011,Bracknell Forest 005D,E01016183,896,715,181,103,30,48
2011,Bracknell Forest 005E,E01016222,1009,818,191,101,31,59
2011,Bracknell Forest 006B,E01016191,1131,854,277,148,35,94
2011,Bracknell Forest 006C,E01016223,1111,867,244,105,33,106
2011,Bracknell Forest 006D,E01016224,1215,939,276,117,26,133
2011,Bracknell Forest 006E,E01016226,986,764,222,103,29,90
2011,Bracknell Forest 006F,E01032724,966,753,213,61,27,125
2011,Bracknell Forest 006G,E01032728,1040,854,186,73,17,96
2011,Bracknell Forest 007A,E01016225,1566,1232,334,139,54,141
2011,Bracknell Forest 007B,E01016233,1661,1339,322,108,53,161
2011,Bracknell Forest 007C,E01016248,1088,820,268,130,37,101
2011,Bracknell Forest 007D,E01016249,1117,830,287,119,20,148
2011,Bracknell Forest 007E,E01016250,1170,879,291,160,38,93
2011,Bracknell Forest 008A,E01016200,1062,905,157,54,36,67
2011,Bracknell Forest 008B,E01016201,1078,913,165,67,28,70
2011,Bracknell Forest 008C,E01016202,1011,901,110,45,12,53
2011,Bracknell Forest 008D,E01016203,926,723,203,82,27,94
2011,Bracknell Forest 008E,E01016204,925,736,189,52,34,103
2011,Bracknell Forest 009A,E01016209,1125,814,311,192,35,84
2011,Bracknell Forest 009B,E01016210,892,679,213,81,30,102
2011,Bracknell Forest 009D,E01016213,882,702,180,88,30,62
2011,Bracknell Forest 009E,E01016214,1083,802,281,195,27,59
2011,Bracknell Forest 009F,E01016215,891,701,190,67,27,96
2011,Bracknell Forest 009G,E01032725,1123,962,161,34,19,108
2011,Bracknell Forest 009H,E01032726,1028,799,229,106,35,88
2011,Bracknell Forest 010A,E01016205,1028,820,208,83,29,96
2011,Bracknell Forest 010B,E01016217,1063,854,209,94,34,81
2011,Bracknell Forest 010C,E01016218,1039,810,229,126,22,81
2011,Bracknell Forest 010D,E01016231,1380,1095,285,120,49,116
2011,Bracknell Forest 010E,E01016232,1057,804,253,134,31,88
2011,Bracknell Forest 011A,E01016212,942,721,221,78,33,110
2011,Bracknell Forest 011B,E01016216,961,776,185,103,15,67
2011,Bracknell Forest 011C,E01016219,1045,788,257,160,30,67
2011,Bracknell Forest 011D,E01016220,1002,846,156,63,25,68
2011,Bracknell Forest 011E,E01016221,990,819,171,93,17,61
2011,Bracknell Forest 012A,E01016206,1296,925,371,243,39,89
2011,Bracknell Forest 012B,E01016208,1352,1048,304,185,48,71
2011,Bracknell Forest 012C,E01016229,846,654,192,115,26,51
2011,Bracknell Forest 012D,E01016230,1222,635,587,80,473,34
2011,Bracknell Forest 013A,E01016207,1128,832,296,85,35,176
2011,Bracknell Forest 013B,E01016234,899,737,162,95,26,41
2011,Bracknell Forest 013C,E01016235,1051,852,199,124,31,44
2011,Bracknell Forest 013D,E01016236,1061,838,223,87,35,101
2011,Bracknell Forest 013E,E01016237,923,763,160,82,27,51
2011,Bracknell Forest 014A,E01016192,971,746,225,128,20,77
2011,Bracknell Forest 014B,E01016194,911,659,252,170,31,51
2011,Bracknell Forest 014C,E01016195,862,732,130,49,22,59
2011,Bracknell Forest 014D,E01016227,953,745,208,129,34,45
2011,Bracknell Forest 014E,E01016228,1127,843,284,182,25,77
2011,Bracknell Forest 015A,E01016193,974,830,144,68,29,47
2011,Bracknell Forest 015B,E01016196,1968,1694,274,67,53,154
2011,Bracknell Forest 015C,E01016197,982,735,247,111,35,101
2011,Bracknell Forest 015D,E01016198,867,706,161,94,25,42
2011,Bracknell Forest 015E,E01016199,948,765,183,94,29,60
2011,Brighton and Hove 001A,E01016924,1010,753,257,144,51,62
2011,Brighton and Hove 001B,E01016926,1051,741,310,98,59,153
2011,Brighton and Hove 001C,E01016927,1124,842,282,136,62,84
2011,Brighton and Hove 001D,E01016929,1144,857,287,145,59,83
2011,Brighton and Hove 001E,E01016931,1094,795,299,189,43,67
2011,Brighton and Hove 002A,E01016898,1760,1032,728,176,380,172
2011,Brighton and Hove 002B,E01016899,3041,1267,1774,66,1602,106
2011,Brighton and Hove 002C,E01016914,2016,953,1063,63,810,190
2011,Brighton and Hove 002D,E01016915,1128,582,546,88,227,231
2011,Brighton and Hove 003A,E01016923,1081,806,275,152,47,76
2011,Brighton and Hove 003B,E01016928,1114,779,335,205,46,84
2011,Brighton and Hove 003C,E01016998,1011,776,235,143,38,54
2011,Brighton and Hove 003D,E01016999,1038,744,294,158,53,83
2011,Brighton and Hove 003E,E01017000,1175,851,324,193,49,82
2011,Brighton and Hove 004A,E01016925,1114,837,277,98,62,117
2011,Brighton and Hove 004B,E01016930,1364,987,377,230,64,83
2011,Brighton and Hove 004C,E01017001,1039,733,306,177,71,58
2011,Brighton and Hove 004D,E01017003,1166,877,289,104,96,89
2011,Brighton and Hove 005A,E01016916,1052,739,313,200,31,82
2011,Brighton and Hove 005B,E01016917,1047,777,270,160,38,72
2011,Brighton and Hove 005C,E01016918,1020,674,346,159,47,140
2011,Brighton and Hove 005D,E01016919,1039,794,245,82,48,115
2011,Brighton and Hove 005E,E01016920,1131,901,230,101,41,88
2011,Brighton and Hove 006A,E01016882,1010,698,312,154,38,120
2011,Brighton and Hove 006B,E01016883,1024,614,410,300,34,76
2011,Brighton and Hove 006C,E01016884,1101,793,308,123,57,128
2011,Brighton and Hove 006D,E01016885,930,593,337,82,46,209
2011,Brighton and Hove 006E,E01016886,1084,772,312,142,56,114
2011,Brighton and Hove 007A,E01016980,1050,804,246,112,58,76
2011,Brighton and Hove 007B,E01016982,905,665,240,138,34,68
2011,Brighton and Hove 007C,E01016983,1008,671,337,163,89,85
2011,Brighton and Hove 007D,E01016984,1049,739,310,183,48,79
2011,Brighton and Hove 007E,E01016985,1107,841,266,119,58,89
2011,Brighton and Hove 008A,E01016900,1256,653,603,145,196,262
2011,Brighton and Hove 008B,E01016902,1095,719,376,141,122,113
2011,Brighton and Hove 008C,E01016904,1139,665,474,85,113,276
2011,Brighton and Hove 008D,E01016905,1314,775,539,123,192,224
2011,Brighton and Hove 008E,E01016909,1513,906,607,129,339,139
2011,Brighton and Hove 009A,E01016906,1172,739,433,118,113,202
2011,Brighton and Hove 009B,E01016907,1470,793,677,112,416,149
2011,Brighton and Hove 009C,E01016908,1068,618,450,109,112,229
2011,Brighton and Hove 009D,E01016910,1131,712,419,56,193,170
2011,Brighton and Hove 009E,E01016911,1154,755,399,124,157,118
2011,Brighton and Hove 010A,E01016901,1236,941,295,99,136,60
2011,Brighton and Hove 010B,E01016903,1533,1120,413,69,273,71
2011,Brighton and Hove 010C,E01016934,1013,800,213,80,74,59
2011,Brighton and Hove 010D,E01016939,1120,899,221,88,72,61
2011,Brighton and Hove 010E,E01016940,1229,1012,217,54,94,69
2011,Brighton and Hove 011A,E01016981,1150,755,395,189,74,132
2011,Brighton and Hove 011B,E01017002,1245,931,314,144,65,105
2011,Brighton and Hove 011C,E01017004,1262,967,295,124,79,92
2011,Brighton and Hove 011D,E01017005,1251,1034,217,76,53,88
2011,Brighton and Hove 011E,E01017006,1236,1040,196,74,46,76
2011,Brighton and Hove 012A,E01016921,1143,847,296,113,40,143
2011,Brighton and Hove 012B,E01016922,930,672,258,105,45,108
2011,Brighton and Hove 012C,E01016973,1039,788,251,132,37,82
2011,Brighton and Hove 012D,E01016977,1143,810,333,141,51,141
2011,Brighton and Hove 012E,E01016978,1206,858,348,120,38,190
2011,Brighton and Hove 013A,E01016879,1070,747,323,107,74,142
2011,Brighton and Hove 013B,E01016880,905,578,327,81,40,206
2011,Brighton and Hove 013C,E01016881,1032,718,314,126,45,143
2011,Brighton and Hove 013D,E01016887,1013,733,280,170,31,79
2011,Brighton and Hove 013E,E01016888,1008,734,274,148,53,73
2011,Brighton and Hove 013F,E01016976,1208,879,329,177,48,104
2011,Brighton and Hove 014A,E01016932,1240,965,275,97,84,94
2011,Brighton and Hove 014B,E01016933,1108,865,243,76,76,91
2011,Brighton and Hove 014C,E01016935,1160,891,269,125,65,79
2011,Brighton and Hove 014D,E01016936,1313,1038,275,67,111,97
2011,Brighton and Hove 014E,E01016937,1799,1399,400,69,172,159
2011,Brighton and Hove 015A,E01016890,1567,1087,480,52,346,82
2011,Brighton and Hove 015B,E01016966,1531,1025,506,61,340,105
2011,Brighton and Hove 015C,E01016970,1325,990,335,80,170,85
2011,Brighton and Hove 015D,E01016971,1781,1100,681,51,537,93
2011,Brighton and Hove 015E,E01016972,1561,1196,365,55,230,80
2011,Brighton and Hove 016A,E01016979,1181,884,297,104,70,123
2011,Brighton and Hove 016B,E01016990,1204,900,304,90,72,142
2011,Brighton and Hove 016C,E01016991,1334,1051,283,79,55,149
2011,Brighton and Hove 016D,E01016996,1169,929,240,78,56,106
2011,Brighton and Hove 017A,E01017007,1094,756,338,137,58,143
2011,Brighton and Hove 017B,E01017008,1177,810,367,227,42,98
2011,Brighton and Hove 017C,E01017009,1114,784,330,192,26,112
2011,Brighton and Hove 017D,E01017010,1275,864,411,234,56,121
2011,Brighton and Hove 017E,E01017011,975,653,322,109,61,152
2011,Brighton and Hove 017F,E01017012,1276,934,342,180,46,116
2011,Brighton and Hove 018A,E01016892,1329,950,379,66,238,75
2011,Brighton and Hove 018B,E01016893,1549,1179,370,77,224,69
2011,Brighton and Hove 018C,E01016912,1637,1102,535,52,389,94
2011,Brighton and Hove 018D,E01016913,1527,953,574,79,447,48
2011,Brighton and Hove 018E,E01016946,1113,877,236,86,92,58
2011,Brighton and Hove 019A,E01016860,1240,981,259,95,58,106
2011,Brighton and Hove 019B,E01016871,1430,1113,317,146,61,110
2011,Brighton and Hove 019C,E01016872,1542,1309,233,59,59,115
2011,Brighton and Hove 019D,E01016873,1450,1078,372,118,63,191
2011,Brighton and Hove 019E,E01016878,1406,1050,356,133,93,130
2011,Brighton and Hove 020A,E01016870,1212,975,237,74,70,93
2011,Brighton and Hove 020B,E01016874,1339,1049,290,125,59,106
2011,Brighton and Hove 020C,E01016875,1205,959,246,78,67,101
2011,Brighton and Hove 020D,E01016876,1259,1004,255,88,87,80
2011,Brighton and Hove 020E,E01016877,1419,1057,362,164,89,109
2011,Brighton and Hove 021A,E01016974,1208,948,260,98,42,120
2011,Brighton and Hove 021B,E01016975,1088,753,335,109,57,169
2011,Brighton and Hove 021C,E01016992,1095,836,259,130,43,86
2011,Brighton and Hove 021D,E01016994,1234,976,258,94,49,115
2011,Brighton and Hove 021E,E01016997,1113,848,265,121,45,99
2011,Brighton and Hove 022A,E01016889,1553,1084,469,72,309,88
2011,Brighton and Hove 022B,E01016891,1500,1016,484,70,298,116
2011,Brighton and Hove 022C,E01016894,1646,1085,561,78,356,127
2011,Brighton and Hove 022D,E01016896,1477,1121,356,48,239,69
2011,Brighton and Hove 022E,E01016897,1419,1044,375,79,194,102
2011,Brighton and Hove 023A,E01016987,1299,992,307,114,70,123
2011,Brighton and Hove 023B,E01016989,1188,861,327,125,51,151
2011,Brighton and Hove 023C,E01016993,1004,625,379,151,44,184
2011,Brighton and Hove 023D,E01016995,1165,845,320,150,66,104
2011,Brighton and Hove 024A,E01016938,1499,1242,257,73,105,79
2011,Brighton and Hove 024B,E01016950,1442,1201,241,94,78,69
2011,Brighton and Hove 024C,E01016951,1254,982,272,86,80,106
2011,Brighton and Hove 024D,E01016967,1736,1424,312,83,113,116
2011,Brighton and Hove 024E,E01016968,1441,1210,231,38,107,86
2011,Brighton and Hove 025A,E01016864,1054,629,425,169,70,186
2011,Brighton and Hove 025B,E01016865,1091,649,442,91,86,265
2011,Brighton and Hove 025C,E01016866,1000,590,410,88,63,259
2011,Brighton and Hove 025D,E01016867,1049,641,408,108,63,237
2011,Brighton and Hove 025E,E01016868,1114,607,507,147,74,286
2011,Brighton and Hove 025F,E01016895,1087,667,420,110,98,212
2011,Brighton and Hove 026A,E01016849,1350,1119,231,104,51,76
2011,Brighton and Hove 026B,E01016852,1423,1155,268,69,100,99
2011,Brighton and Hove 026C,E01016853,1621,1341,280,93,90,97
2011,Brighton and Hove 026D,E01016855,1536,1287,249,68,49,132
2011,Brighton and Hove 026E,E01016856,1308,1058,250,98,53,99
2011,Brighton and Hove 027A,E01016952,1504,1117,387,47,270,70
2011,Brighton and Hove 027B,E01016953,1393,1097,296,90,125,81
2011,Brighton and Hove 027C,E01016964,1860,1224,636,93,331,212
2011,Brighton and Hove 027E,E01016969,1752,1229,523,114,275,134
2011,Brighton and Hove 027F,E01033328,1256,935,321,67,161,93
2011,Brighton and Hove 027G,E01033329,1758,1034,724,65,542,117
2011,Brighton and Hove 028A,E01016857,1217,950,267,88,67,112
2011,Brighton and Hove 028B,E01016858,1256,1036,220,108,30,82
2011,Brighton and Hove 028C,E01016859,1110,840,270,165,28,77
2011,Brighton and Hove 028D,E01016986,1206,863,343,152,43,148
2011,Brighton and Hove 028E,E01016988,1070,792,278,103,52,123
2011,Brighton and Hove 029A,E01016850,1558,1255,303,78,130,95
2011,Brighton and Hove 029B,E01016851,1514,1306,208,60,71,77
2011,Brighton and Hove 029C,E01016854,1487,1192,295,63,78,154
2011,Brighton and Hove 029D,E01016954,1654,1284,370,82,148,140
2011,Brighton and Hove 029E,E01016955,1579,1228,351,75,168,108
2011,Brighton and Hove 030A,E01016941,1715,1228,487,135,196,156
2011,Brighton and Hove 030B,E01016945,1511,1183,328,68,148,112
2011,Brighton and Hove 030C,E01016947,1309,778,531,139,95,297
2011,Brighton and Hove 030D,E01016948,1384,1022,362,73,153,136
2011,Brighton and Hove 030E,E01016949,1388,866,522,146,147,229
2011,Brighton and Hove 031A,E01016861,1420,1119,301,115,72,114
2011,Brighton and Hove 031B,E01016862,1288,959,329,109,139,81
2011,Brighton and Hove 031C,E01016942,1171,466,705,312,161,232
2011,Brighton and Hove 031D,E01016943,1234,923,311,85,122,104
2011,Brighton and Hove 031E,E01016944,1351,1068,283,86,105,92
2011,Brighton and Hove 032A,E01016863,1247,839,408,168,53,187
2011,Brighton and Hove 032B,E01016869,1392,970,422,169,98,155
2011,Brighton and Hove 032C,E01016957,1433,898,535,183,250,102
2011,Brighton and Hove 032D,E01016963,1535,1178,357,137,110,110
2011,Brighton and Hove 033A,E01016956,1107,771,336,215,42,79
2011,Brighton and Hove 033B,E01016958,1216,834,382,250,42,90
2011,Brighton and Hove 033C,E01016959,1034,708,326,212,45,69
2011,Brighton and Hove 033D,E01016960,1220,833,387,249,48,90
2011,Brighton and Hove 033E,E01016961,1290,934,356,187,49,120
2011,Brighton and Hove 033F,E01016962,1227,816,411,234,98,79
2011,Isle of Wight 001A,E01017300,1611,1113,498,312,54,132
2011,Isle of Wight 001B,E01017303,928,716,212,107,32,73
2011,Isle of Wight 001C,E01017305,996,730,266,105,42,119
2011,Isle of Wight 001D,E01017306,976,734,242,111,39,92
2011,Isle of Wight 001E,E01017309,1225,897,328,157,52,119
2011,Isle of Wight 002A,E01017301,716,430,286,222,20,44
2011,Isle of Wight 002B,E01017302,1205,854,351,208,50,93
2011,Isle of Wight 002C,E01017304,1010,734,276,134,44,98
2011,Isle of Wight 002D,E01017316,1227,802,425,303,37,85
2011,Isle of Wight 002E,E01017329,1680,1078,602,403,63,136
2011,Isle of Wight 003A,E01017307,1433,888,545,384,35,126
2011,Isle of Wight 003B,E01017308,1240,864,376,199,48,129
2011,Isle of Wight 003D,E01033229,1042,650,392,290,25,77
2011,Isle of Wight 003E,E01033237,907,587,320,142,39,139
2011,Isle of Wight 004A,E01017335,1159,780,379,175,55,149
2011,Isle of Wight 004B,E01017336,1269,892,377,143,52,182
2011,Isle of Wight 004C,E01017337,1218,842,376,161,70,145
2011,Isle of Wight 004D,E01017346,1140,805,335,162,29,144
2011,Isle of Wight 005A,E01017286,1118,665,453,351,33,69
2011,Isle of Wight 005B,E01017287,1216,828,388,271,36,81
2011,Isle of Wight 005C,E01017367,1374,820,554,404,56,94
2011,Isle of Wight 005D,E01017368,1084,696,388,244,30,114
2011,Isle of Wight 006A,E01017282,1017,705,312,162,42,108
2011,Isle of Wight 006B,E01017283,1128,793,335,223,29,83
2011,Isle of Wight 006C,E01017338,976,560,416,241,43,132
2011,Isle of Wight 006D,E01017341,1058,665,393,210,40,143
2011,Isle of Wight 006E,E01017342,1231,802,429,229,57,143
2011,Isle of Wight 007A,E01017339,1206,833,373,169,72,132
2011,Isle of Wight 007B,E01017340,1243,868,375,146,58,171
2011,Isle of Wight 007C,E01017343,943,602,341,161,42,138
2011,Isle of Wight 007D,E01017344,1159,763,396,273,34,89
2011,Isle of Wight 007E,E01017345,1364,914,450,131,81,238
2011,Isle of Wight 008A,E01017310,937,642,295,191,40,64
2011,Isle of Wight 008B,E01017311,1159,812,347,202,37,108
2011,Isle of Wight 008C,E01017331,1013,651,362,202,20,140
2011,Isle of Wight 008D,E01017332,896,569,327,131,29,167
2011,Isle of Wight 008E,E01017334,1470,757,713,158,44,511
2011,Isle of Wight 009A,E01017295,932,639,293,132,35,126
2011,Isle of Wight 009B,E01017325,952,683,269,136,31,102
2011,Isle of Wight 009C,E01017326,1129,822,307,135,38,134
2011,Isle of Wight 009D,E01017328,1058,710,348,138,43,167
2011,Isle of Wight 009E,E01017333,2406,1106,1300,175,86,1039
2011,Isle of Wight 010A,E01017284,1154,702,452,341,40,71
2011,Isle of Wight 010B,E01017285,1328,771,557,432,27,98
2011,Isle of Wight 010C,E01017288,867,547,320,228,22,70
2011,Isle of Wight 010D,E01017351,1011,618,393,298,33,62
2011,Isle of Wight 010E,E01017352,788,399,389,320,26,43
2011,Isle of Wight 011A,E01017292,1171,836,335,191,36,108
2011,Isle of Wight 011B,E01017293,1396,1023,373,218,54,101
2011,Isle of Wight 011C,E01017296,952,604,348,241,33,74
2011,Isle of Wight 011D,E01017321,872,558,314,204,27,83
2011,Isle of Wight 011E,E01017322,1072,724,348,136,57,155
2011,Isle of Wight 011F,E01017327,1181,817,364,196,47,121
2011,Isle of Wight 012A,E01017312,1089,684,405,260,29,116
2011,Isle of Wight 012D,E01017315,1020,584,436,253,44,139
2011,Isle of Wight 012E,E01017354,825,498,327,240,19,68
2011,Isle of Wight 012F,E01017361,934,526,408,317,24,67
2011,Isle of Wight 012G,E01017362,1078,658,420,250,50,120
2011,Isle of Wight 012H,E01033239,1616,854,762,589,39,134
2011,Isle of Wight 013A,E01017290,1006,675,331,235,29,67
2011,Isle of Wight 013B,E01017291,801,443,358,257,30,71
2011,Isle of Wight 013C,E01017294,1171,841,330,202,42,86
2011,Isle of Wight 013D,E01017353,933,599,334,251,19,64
2011,Isle of Wight 014A,E01017289,1482,961,521,312,45,164
2011,Isle of Wight 014B,E01017347,1174,732,442,244,50,148
2011,Isle of Wight 014C,E01017348,1010,687,323,158,60,105
2011,Isle of Wight 014D,E01017349,1580,1109,471,255,62,154
2011,Isle of Wight 014E,E01017350,1349,859,490,239,53,198
2011,Isle of Wight 015A,E01017317,1098,734,364,224,39,101
2011,Isle of Wight 015B,E01017320,742,415,327,238,38,51
2011,Isle of Wight 015C,E01017323,880,574,306,235,21,50
2011,Isle of Wight 015D,E01017324,1093,738,355,198,46,111
2011,Isle of Wight 015E,E01017355,1112,743,369,222,47,100
2011,Isle of Wight 015F,E01017358,906,516,390,274,33,83
2011,Isle of Wight 016A,E01017318,856,526,330,152,45,133
2011,Isle of Wight 016B,E01017319,876,494,382,262,31,89
2011,Isle of Wight 016C,E01017356,1090,708,382,183,43,156
2011,Isle of Wight 016D,E01017357,1082,697,385,213,41,131
2011,Isle of Wight 016E,E01017359,1089,638,451,287,39,125
2011,Isle of Wight 016F,E01017360,1270,820,450,232,44,174
2011,Isle of Wight 017A,E01017297,1047,700,347,218,41,88
2011,Isle of Wight 017B,E01017298,1067,631,436,317,42,77
2011,Isle of Wight 017C,E01017299,927,573,354,209,39,106
2011,Isle of Wight 017D,E01017369,1048,696,352,224,30,98
2011,Isle of Wight 018A,E01017363,1167,723,444,217,47,180
2011,Isle of Wight 018B,E01017364,1078,727,351,231,25,95
2011,Isle of Wight 018C,E01017365,1017,520,497,390,22,85
2011,Isle of Wight 018D,E01017366,1064,648,416,193,56,167
2011,Isle of Wight 018E,E01017370,1327,787,540,359,53,128
2011,Medway 001A,E01016070,1256,821,435,262,31,142
2011,Medway 001B,E01016071,1212,847,365,168,33,164
2011,Medway 001C,E01016072,967,681,286,132,32,122
2011,Medway 001D,E01016074,1282,782,500,356,32,112
2011,Medway 002A,E01016142,975,737,238,129,28,81
2011,Medway 002B,E01016144,1142,788,354,214,45,95
2011,Medway 002C,E01016145,994,745,249,125,46,78
2011,Medway 002D,E01016149,1023,718,305,157,38,110
2011,Medway 003A,E01016073,1526,1096,430,260,53,117
2011,Medway 003B,E01016075,1075,736,339,212,31,96
2011,Medway 003C,E01016076,1785,1314,471,259,60,152
2011,Medway 003D,E01016077,1063,720,343,166,39,138
2011,Medway 003E,E01016143,1677,1325,352,150,44,158
2011,Medway 004A,E01016146,1440,963,477,230,63,184
2011,Medway 004B,E01016147,1357,993,364,234,36,94
2011,Medway 004C,E01016148,1452,1081,371,201,48,122
2011,Medway 005A,E01016133,1024,701,323,204,51,68
2011,Medway 005B,E01016134,1064,749,315,153,50,112
2011,Medway 005C,E01016138,1122,805,317,212,45,60
2011,Medway 005D,E01016139,1194,895,299,143,49,107
2011,Medway 006A,E01016135,1115,820,295,128,48,119
2011,Medway 006B,E01016136,1097,762,335,117,60,158
2011,Medway 006C,E01016137,1150,878,272,92,42,138
2011,Medway 006D,E01016140,1087,805,282,98,35,149
2011,Medway 006E,E01016141,1228,923,305,100,50,155
2011,Medway 007A,E01016035,1390,916,474,89,175,210
2011,Medway 007D,E01016112,2152,1694,458,164,138,156
2011,Medway 007E,E01032798,2871,2123,748,176,302,270
2011,Medway 008A,E01016151,1218,861,357,172,55,130
2011,Medway 008B,E01016152,1104,665,439,196,41,202
2011,Medway 008C,E01016153,999,665,334,131,38,165
2011,Medway 008D,E01016155,1121,750,371,175,42,154
2011,Medway 009A,E01016033,810,476,334,90,66,178
2011,Medway 009B,E01016036,2054,1046,1008,104,738,166
2011,Medway 009C,E01016037,1316,941,375,82,175,118
2011,Medway 009D,E01016039,1247,894,353,84,115,154
2011,Medway 010A,E01016030,1274,879,395,116,64,215
2011,Medway 010B,E01016032,889,592,297,64,47,186
2011,Medway 010C,E01016034,1895,1445,450,169,100,181
2011,Medway 010D,E01016038,1064,751,313,104,62,147
2011,Medway 011A,E01016150,1130,759,371,106,47,218
2011,Medway 011B,E01016154,1209,913,296,106,46,144
2011,Medway 011C,E01016156,1220,941,279,116,39,124
2011,Medway 011D,E01016157,1428,1063,365,159,59,147
2011,Medway 011E,E01016158,1554,1185,369,170,51,148
2011,Medway 012A,E01016031,1270,826,444,122,87,235
2011,Medway 012B,E01016041,1257,936,321,83,83,155
2011,Medway 012C,E01016045,1234,942,292,84,78,130
2011,Medway 012D,E01016049,1424,1001,423,92,105,226
2011,Medway 013A,E01016040,1281,900,381,128,74,179
2011,Medway 013B,E01016042,1064,791,273,87,52,134
2011,Medway 013C,E01016043,1043,722,321,145,46,130
2011,Medway 013D,E01016177,1127,820,307,107,58,142
2011,Medway 013E,E01016178,1046,781,265,110,46,109
2011,Medway 014A,E01016117,1342,902,440,107,104,229
2011,Medway 014B,E01016129,1486,1101,385,121,63,201
2011,Medway 014C,E01016130,1452,1081,371,158,93,120
2011,Medway 014D,E01016131,1234,906,328,168,68,92
2011,Medway 015A,E01016016,1158,782,376,99,83,194
2011,Medway 015B,E01016017,1306,876,430,112,123,195
2011,Medway 015C,E01016019,1308,930,378,76,92,210
2011,Medway 015D,E01016110,1801,1175,626,100,383,143
2011,Medway 015E,E01016111,895,572,323,77,44,202
2011,Medway 016A,E01016044,1258,921,337,102,72,163
2011,Medway 016B,E01016046,1133,840,293,94,54,145
2011,Medway 016C,E01016047,1262,946,316,89,82,145
2011,Medway 016D,E01016048,1250,931,319,124,60,135
2011,Medway 017A,E01016113,1098,773,325,180,42,103
2011,Medway 017B,E01016114,1196,891,305,94,71,140
2011,Medway 017C,E01016115,1384,989,395,154,70,171
2011,Medway 017D,E01016118,1344,986,358,148,83,127
2011,Medway 018A,E01016160,1021,671,350,129,46,175
2011,Medway 018B,E01016161,1071,675,396,185,39,172
2011,Medway 018C,E01016162,1198,902,296,155,40,101
2011,Medway 018D,E01016163,959,681,278,120,47,111
2011,Medway 018E,E01016164,1037,699,338,167,45,126
2011,Medway 018F,E01016165,928,656,272,154,35,83
2011,Medway 019A,E01016159,940,617,323,120,42,161
2011,Medway 019B,E01016174,1056,797,259,104,56,99
2011,Medway 019C,E01016175,1381,985,396,252,47,97
2011,Medway 019D,E01016179,1028,768,260,126,48,86
2011,Medway 020A,E01016061,1255,938,317,84,64,169
2011,Medway 020B,E01016063,1180,768,412,126,55,231
2011,Medway 020C,E01016064,1092,748,344,106,61,177
2011,Medway 020D,E01016069,1334,949,385,85,68,232
2011,Medway 021A,E01016020,900,621,279,90,63,126
2011,Medway 021B,E01016021,1139,826,313,140,48,125
2011,Medway 021C,E01016022,1061,743,318,86,99,133
2011,Medway 021D,E01016125,1308,989,319,137,54,128
2011,Medway 022A,E01016018,1385,1040,345,78,61,206
2011,Medway 022B,E01016023,1096,664,432,90,78,264
2011,Medway 022C,E01016024,1371,972,399,98,87,214
2011,Medway 022D,E01016062,1093,722,371,122,69,180
2011,Medway 023A,E01016093,1114,753,361,271,24,66
2011,Medway 023B,E01016096,990,665,325,209,34,82
2011,Medway 023C,E01016166,1078,746,332,211,32,89
2011,Medway 023D,E01016167,1039,748,291,182,28,81
2011,Medway 024A,E01016116,1272,931,341,167,47,127
2011,Medway 024B,E01016127,1115,822,293,148,42,103
2011,Medway 024C,E01016128,1608,763,845,141,108,596
2011,Medway 024D,E01016132,1228,917,311,185,57,69
2011,Medway 025A,E01016094,1093,806,287,196,37,54
2011,Medway 025B,E01016095,940,697,243,127,37,79
2011,Medway 025C,E01016097,1073,754,319,157,41,121
2011,Medway 025D,E01016098,983,683,300,124,39,137
2011,Medway 025E,E01016102,1081,710,371,160,50,161
2011,Medway 026A,E01016119,1095,761,334,194,59,81
2011,Medway 026B,E01016120,988,655,333,180,35,118
2011,Medway 026C,E01016124,1224,877,347,184,52,111
2011,Medway 026D,E01016126,1218,916,302,154,54,94
2011,Medway 027A,E01016025,1035,641,394,176,52,166
2011,Medway 027B,E01016065,1071,758,313,173,21,119
2011,Medway 027C,E01016066,1123,774,349,138,54,157
2011,Medway 027D,E01016067,1170,852,318,117,58,143
2011,Medway 027E,E01016068,1141,727,414,134,53,227
2011,Medway 028A,E01016026,921,718,203,102,31,70
2011,Medway 028B,E01016027,1165,823,342,234,36,72
2011,Medway 028C,E01016028,1018,680,338,245,25,68
2011,Medway 028D,E01016029,967,709,258,124,48,86
2011,Medway 029A,E01016087,1245,894,351,219,32,100
2011,Medway 029B,E01016088,1109,767,342,173,36,133
2011,Medway 029C,E01016089,1119,771,348,197,54,97
2011,Medway 029D,E01016090,1080,780,300,199,43,58
2011,Medway 030A,E01016085,1196,798,398,305,32,61
2011,Medway 030B,E01016086,960,666,294,178,45,71
2011,Medway 030C,E01016091,1136,716,420,302,40,78
2011,Medway 030D,E01016176,1155,883,272,152,55,65
2011,Medway 031A,E01016058,1133,860,273,150,29,94
2011,Medway 031B,E01016059,956,662,294,112,42,140
2011,Medway 031C,E01016079,1039,798,241,106,41,94
2011,Medway 031D,E01016083,933,619,314,99,42,173
2011,Medway 031E,E01016084,1069,767,302,82,60,160
2011,Medway 032A,E01016101,1098,840,258,124,43,91
2011,Medway 032B,E01016103,1127,855,272,168,28,76
2011,Medway 032C,E01016104,1090,858,232,127,36,69
2011,Medway 032D,E01016107,1171,909,262,134,48,80
2011,Medway 033A,E01016121,1096,743,353,241,31,81
2011,Medway 033B,E01016122,1093,759,334,193,50,91
2011,Medway 033C,E01016123,1164,859,305,171,40,94
2011,Medway 033D,E01016173,1133,788,345,139,43,163
2011,Medway 034A,E01016078,1156,999,157,43,22,92
2011,Medway 034B,E01016080,1095,854,241,111,32,98
2011,Medway 034C,E01016081,1181,969,212,71,56,85
2011,Medway 034D,E01016082,1185,894,291,142,47,102
2011,Medway 035A,E01016050,1305,953,352,232,46,74
2011,Medway 035B,E01016051,1142,854,288,152,50,86
2011,Medway 035C,E01016052,1244,843,401,269,43,89
2011,Medway 035D,E01016053,1103,731,372,263,33,76
2011,Medway 035E,E01016054,1150,854,296,196,24,76
2011,Medway 036A,E01016092,1147,832,315,203,36,76
2011,Medway 036B,E01016099,1129,857,272,143,33,96
2011,Medway 036C,E01016100,1157,802,355,180,40,135
2011,Medway 036D,E01016105,1014,696,318,213,41,64
2011,Medway 036E,E01016106,1029,708,321,218,39,64
2011,Medway 037A,E01016168,1145,732,413,206,43,164
2011,Medway 037B,E01016169,1324,981,343,201,56,86
2011,Medway 037C,E01016171,1093,723,370,166,45,159
2011,Medway 037D,E01016172,1052,798,254,162,29,63
2011,Medway 038A,E01016055,1147,786,361,193,50,118
2011,Medway 038B,E01016056,1047,858,189,76,26,87
2011,Medway 038C,E01016057,1267,982,285,109,43,133
2011,Medway 038D,E01016060,1260,873,387,253,47,87
2011,Medway 038E,E01016170,1196,901,295,142,50,103
2011,Milton Keynes 001A,E01016796,1099,820,279,193,29,57
2011,Milton Keynes 001B,E01016797,1236,900,336,199,48,89
2011,Milton Keynes 001C,E01016798,1381,1107,274,148,54,72
2011,Milton Keynes 001D,E01016799,1331,1013,318,178,42,98
2011,Milton Keynes 001E,E01016800,1213,886,327,202,37,88
2011,Milton Keynes 002A,E01016759,1018,765,253,148,24,81
2011,Milton Keynes 002B,E01016760,1733,1402,331,187,45,99
2011,Milton Keynes 002C,E01016761,1045,770,275,202,27,46
2011,Milton Keynes 002D,E01016801,990,681,309,205,28,76
2011,Milton Keynes 002E,E01016802,1042,738,304,193,28,83
2011,Milton Keynes 002F,E01016803,979,742,237,152,23,62
2011,Milton Keynes 003A,E01016786,1051,771,280,212,18,50
2011,Milton Keynes 003B,E01016787,1117,788,329,181,41,107
2011,Milton Keynes 003C,E01016788,1230,975,255,150,51,54
2011,Milton Keynes 003D,E01016789,1005,845,160,63,35,62
2011,Milton Keynes 003E,E01016790,1001,737,264,184,28,52
2011,Milton Keynes 004A,E01016791,1075,818,257,162,34,61
2011,Milton Keynes 004B,E01016792,982,816,166,71,38,57
2011,Milton Keynes 004C,E01016793,1453,1126,327,179,47,101
2011,Milton Keynes 004D,E01016794,1135,896,239,141,36,62
2011,Milton Keynes 004E,E01016795,1204,975,229,116,31,82
2011,Milton Keynes 005A,E01016762,970,684,286,153,44,89
2011,Milton Keynes 005B,E01016764,1122,857,265,166,35,64
2011,Milton Keynes 005C,E01016766,1025,732,293,149,32,112
2011,Milton Keynes 005D,E01016767,1038,833,205,129,31,45
2011,Milton Keynes 005E,E01016771,958,676,282,124,42,116
2011,Milton Keynes 006A,E01016806,1338,961,377,107,68,202
2011,Milton Keynes 006B,E01016807,1273,961,312,120,56,136
2011,Milton Keynes 006C,E01016809,1038,779,259,120,49,90
2011,Milton Keynes 006D,E01016835,1166,833,333,122,50,161
2011,Milton Keynes 007A,E01016763,1037,767,270,160,41,69
2011,Milton Keynes 007B,E01016769,1036,852,184,102,26,56
2011,Milton Keynes 007C,E01016770,1294,997,297,118,59,120
2011,Milton Keynes 007D,E01016773,1296,901,395,244,48,103
2011,Milton Keynes 008A,E01016836,1224,939,285,94,47,144
2011,Milton Keynes 008B,E01016837,1353,1034,319,87,74,158
2011,Milton Keynes 008C,E01016838,1096,783,313,130,37,146
2011,Milton Keynes 008D,E01016841,1586,1295,291,96,44,151
2011,Milton Keynes 009A,E01016721,1203,900,303,103,70,130
2011,Milton Keynes 009B,E01016765,1156,786,370,210,43,117
2011,Milton Keynes 009C,E01016772,975,715,260,98,35,127
2011,Milton Keynes 009D,E01016804,1166,878,288,115,42,131
2011,Milton Keynes 010A,E01016812,1188,862,326,211,26,89
2011,Milton Keynes 010B,E01016817,1166,823,343,192,40,111
2011,Milton Keynes 010C,E01016818,1266,954,312,194,25,93
2011,Milton Keynes 010D,E01016840,1927,1489,438,216,36,186
2011,Milton Keynes 011A,E01016719,1128,846,282,147,40,95
2011,Milton Keynes 011B,E01016722,1260,978,282,143,53,86
2011,Milton Keynes 011C,E01016805,1102,823,279,185,28,66
2011,Milton Keynes 011D,E01016808,1033,801,232,109,43,80
2011,Milton Keynes 012A,E01016810,933,606,327,109,45,173
2011,Milton Keynes 012B,E01016811,966,670,296,57,40,199
2011,Milton Keynes 012C,E01016819,796,520,276,115,47,114
2011,Milton Keynes 012D,E01016839,1088,778,310,63,58,189
2011,Milton Keynes 013A,E01016717,1158,867,291,130,41,120
2011,Milton Keynes 013B,E01016720,1032,719,313,114,52,147
2011,Milton Keynes 013C,E01016723,1322,995,327,145,59,123
2011,Milton Keynes 013D,E01016724,1316,1029,287,90,59,138
2011,Milton Keynes 014A,E01016718,1184,867,317,59,89,169
2011,Milton Keynes 014B,E01016729,1588,1163,425,92,110,223
2011,Milton Keynes 014D,E01016768,1673,1334,339,100,86,153
2011,Milton Keynes 014E,E01033499,1196,967,229,55,40,134
2011,Milton Keynes 014F,E01033500,1249,1122,127,16,40,71
2011,Milton Keynes 015A,E01016776,1149,911,238,102,53,83
2011,Milton Keynes 015B,E01016813,1112,931,181,56,33,92
2011,Milton Keynes 015C,E01016815,978,776,202,95,43,64
2011,Milton Keynes 015D,E01016816,1122,806,316,202,42,72
2011,Milton Keynes 016A,E01016731,1146,851,295,148,40,107
2011,Milton Keynes 016B,E01016732,1100,818,282,128,38,116
2011,Milton Keynes 016D,E01016784,1260,926,334,164,54,116
2011,Milton Keynes 016E,E01033501,1447,1222,225,23,99,103
2011,Milton Keynes 016F,E01033506,1440,1164,276,84,81,111
2011,Milton Keynes 017A,E01016783,1360,1153,207,45,51,111
2011,Milton Keynes 017C,E01016820,1206,905,301,92,60,149
2011,Milton Keynes 017D,E01016821,978,786,192,74,38,80
2011,Milton Keynes 017E,E01016823,1320,1137,183,41,62,80
2011,Milton Keynes 017F,E01033503,1126,914,212,112,35,65
2011,Milton Keynes 017G,E01033508,1238,1072,166,26,39,101
2011,Milton Keynes 017H,E01033509,1176,998,178,8,51,119
2011,Milton Keynes 017I,E01033511,1138,974,164,20,61,83
2011,Milton Keynes 017J,E01033512,1199,968,231,80,44,107
2011,Milton Keynes 018A,E01016726,1246,927,319,38,88,193
2011,Milton Keynes 018B,E01016733,1300,930,370,55,97,218
2011,Milton Keynes 018C,E01016845,1316,873,443,98,64,281
2011,Milton Keynes 018D,E01016846,1205,877,328,134,48,146
2011,Milton Keynes 018E,E01016848,1096,697,399,140,24,235
2011,Milton Keynes 019B,E01016780,1283,1060,223,73,53,97
2011,Milton Keynes 019C,E01016781,1111,879,232,102,56,74
2011,Milton Keynes 019D,E01016814,1241,847,394,307,29,58
2011,Milton Keynes 019E,E01033505,1395,944,451,46,40,365
2011,Milton Keynes 019F,E01033522,1069,850,219,18,64,137
2011,Milton Keynes 019G,E01033523,1031,881,150,13,52,85
2011,Milton Keynes 019H,E01033525,1195,984,211,39,60,112
2011,Milton Keynes 020A,E01016774,1283,975,308,159,50,99
2011,Milton Keynes 020B,E01016775,1280,949,331,139,72,120
2011,Milton Keynes 020C,E01016777,1210,951,259,103,25,131
2011,Milton Keynes 020D,E01016778,1286,1044,242,85,48,109
2011,Milton Keynes 021A,E01016725,1207,909,298,58,55,185
2011,Milton Keynes 021B,E01016727,1313,963,350,105,78,167
2011,Milton Keynes 021C,E01016728,1482,1181,301,58,71,172
2011,Milton Keynes 021D,E01016847,1427,1000,427,126,62,239
2011,Milton Keynes 022A,E01016822,1132,893,239,66,46,127
2011,Milton Keynes 022B,E01016824,1164,955,209,58,47,104
2011,Milton Keynes 022C,E01016825,1105,887,218,75,48,95
2011,Milton Keynes 022D,E01016827,1274,1074,200,62,37,101
2011,Milton Keynes 022E,E01016828,1380,1108,272,146,49,77
2011,Milton Keynes 023B,E01016842,1061,678,383,81,64,238
2011,Milton Keynes 023C,E01016843,981,647,334,55,54,225
2011,Milton Keynes 023D,E01016844,1109,635,474,154,49,271
2011,Milton Keynes 023E,E01033497,807,591,216,122,30,64
2011,Milton Keynes 023F,E01033498,1022,762,260,86,43,131
2011,Milton Keynes 024A,E01016734,881,640,241,156,25,60
2011,Milton Keynes 024B,E01016735,1542,1218,324,180,56,88
2011,Milton Keynes 024C,E01016736,943,685,258,174,41,43
2011,Milton Keynes 024D,E01016826,1147,932,215,72,58,85
2011,Milton Keynes 025B,E01016752,1217,974,243,73,52,118
2011,Milton Keynes 025C,E01016753,1618,1338,280,56,64,160
2011,Milton Keynes 025D,E01016755,1327,1043,284,116,55,113
2011,Milton Keynes 025E,E01033514,965,846,119,24,29,66
2011,Milton Keynes 025F,E01033515,1343,1094,249,54,82,113
2011,Milton Keynes 025G,E01033517,1095,965,130,22,38,70
2011,Milton Keynes 026A,E01016754,1230,924,306,166,42,98
2011,Milton Keynes 026B,E01016756,1625,1243,382,138,61,183
2011,Milton Keynes 026C,E01016757,1189,952,237,113,43,81
2011,Milton Keynes 026D,E01016758,1309,1059,250,113,43,94
2011,Milton Keynes 027A,E01016737,1198,908,290,148,46,96
2011,Milton Keynes 027B,E01016738,1238,874,364,171,44,149
2011,Milton Keynes 027C,E01016739,1189,909,280,153,47,80
2011,Milton Keynes 027D,E01016740,1000,694,306,199,25,82
2011,Milton Keynes 027E,E01016741,1212,852,360,180,38,142
2011,Milton Keynes 028A,E01016748,1457,1237,220,57,50,113
2011,Milton Keynes 028C,E01016750,1213,976,237,129,42,66
2011,Milton Keynes 028D,E01016751,1165,931,234,78,47,109
2011,Milton Keynes 028E,E01033519,1303,1109,194,51,44,99
2011,Milton Keynes 028F,E01033520,1274,1060,214,93,41,80
2011,Milton Keynes 029A,E01016829,1119,775,344,171,37,136
2011,Milton Keynes 029B,E01016831,1199,868,331,214,43,74
2011,Milton Keynes 029C,E01016832,938,690,248,145,37,66
2011,Milton Keynes 029D,E01016833,970,663,307,212,31,64
2011,Milton Keynes 029E,E01016834,1043,757,286,127,38,121
2011,Milton Keynes 030A,E01016710,1182,809,373,221,33,119
2011,Milton Keynes 030B,E01016714,1267,832,435,165,63,207
2011,Milton Keynes 030C,E01016716,1367,942,425,235,33,157
2011,Milton Keynes 030D,E01016745,1192,846,346,202,38,106
2011,Milton Keynes 031A,E01016711,1699,1278,421,235,55,131
2011,Milton Keynes 031B,E01016713,1244,922,322,212,34,76
2011,Milton Keynes 031C,E01016715,1147,816,331,149,40,142
2011,Milton Keynes 031D,E01016830,872,714,158,88,24,46
2011,Milton Keynes 032A,E01016742,1049,666,383,98,50,235
2011,Milton Keynes 032B,E01016743,1408,970,438,117,66,255
2011,Milton Keynes 032C,E01016744,1067,717,350,96,68,186
2011,Milton Keynes 032D,E01016746,1195,779,416,195,39,182
2011,Portsmouth 001A,E01017112,1304,880,424,123,70,231
2011,Portsmouth 001B,E01017115,947,671,276,115,42,119
2011,Portsmouth 001C,E01017117,1119,780,339,130,53,156
2011,Portsmouth 001D,E01017119,1200,857,343,121,45,177
2011,Portsmouth 001E,E01017120,1036,673,363,136,41,186
2011,Portsmouth 002A,E01017051,1346,942,404,146,62,196
2011,Portsmouth 002B,E01017052,1006,700,306,136,37,133
2011,Portsmouth 002C,E01017053,936,585,351,113,57,181
2011,Portsmouth 002D,E01017118,1095,727,368,114,71,183
2011,Portsmouth 003A,E01017050,1103,762,341,230,41,70
2011,Portsmouth 003B,E01017061,1220,844,376,273,41,62
2011,Portsmouth 003C,E01017063,1132,812,320,213,40,67
2011,Portsmouth 003D,E01017064,1103,752,351,231,36,84
2011,Portsmouth 004A,E01017054,1006,738,268,133,30,105
2011,Portsmouth 004B,E01017113,1100,813,287,172,31,84
2011,Portsmouth 004C,E01017114,1112,814,298,216,25,57
2011,Portsmouth 004D,E01017116,1037,747,290,94,38,158
2011,Portsmouth 006A,E01017055,1097,806,291,171,33,87
2011,Portsmouth 006B,E01017056,954,738,216,109,48,59
2011,Portsmouth 006C,E01017057,1112,874,238,152,38,48
2011,Portsmouth 006D,E01017058,1242,934,308,116,68,124
2011,Portsmouth 006E,E01017060,1037,762,275,172,37,66
2011,Portsmouth 007A,E01017086,955,751,204,114,36,54
2011,Portsmouth 007B,E01017089,1148,849,299,98,56,145
2011,Portsmouth 007C,E01017090,1131,893,238,89,47,102
2011,Portsmouth 007D,E01017091,1049,730,319,169,32,118
2011,Portsmouth 007E,E01017092,1073,774,299,166,44,89
2011,Portsmouth 008A,E01017014,1154,889,265,150,46,69
2011,Portsmouth 008B,E01017046,1389,1119,270,182,32,56
2011,Portsmouth 008C,E01017047,1173,923,250,135,33,82
2011,Portsmouth 008D,E01017048,1130,889,241,122,59,60
2011,Portsmouth 008E,E01017085,1076,772,304,192,28,84
2011,Portsmouth 009A,E01017084,1072,823,249,114,49,86
2011,Portsmouth 009B,E01017087,1139,852,287,110,61,116
2011,Portsmouth 009C,E01017088,1260,945,315,146,45,124
2011,Portsmouth 009D,E01017105,1036,782,254,115,41,98
2011,Portsmouth 009E,E01017107,1153,878,275,98,59,118
2011,Portsmouth 010A,E01017104,841,629,212,85,37,90
2011,Portsmouth 010B,E01017106,1084,806,278,113,36,129
2011,Portsmouth 010C,E01017108,1129,826,303,130,35,138
2011,Portsmouth 010D,E01017109,968,701,267,107,41,119
2011,Portsmouth 011A,E01017041,1028,789,239,131,41,67
2011,Portsmouth 011B,E01017043,1008,799,209,74,55,80
2011,Portsmouth 011C,E01017044,1158,930,228,80,46,102
2011,Portsmouth 011D,E01017049,1127,859,268,150,43,75
2011,Portsmouth 011E,E01017110,1101,849,252,102,42,108
2011,Portsmouth 011F,E01017111,1078,837,241,102,33,106
2011,Portsmouth 012A,E01017013,1127,903,224,81,40,103
2011,Portsmouth 012B,E01017042,1025,786,239,93,36,110
2011,Portsmouth 012C,E01017045,992,767,225,96,41,88
2011,Portsmouth 012D,E01017075,1155,904,251,64,62,125
2011,Portsmouth 012E,E01017082,1265,964,301,91,54,156
2011,Portsmouth 012F,E01017083,1282,1029,253,94,58,101
2011,Portsmouth 013A,E01017036,1084,715,369,110,63,196
2011,Portsmouth 013B,E01017037,1028,575,453,140,67,246
2011,Portsmouth 013C,E01017038,1096,546,550,210,59,281
2011,Portsmouth 013D,E01017102,1156,798,358,119,67,172
2011,Portsmouth 013E,E01017103,857,506,351,79,67,205
2011,Portsmouth 014A,E01017015,1042,772,270,149,35,86
2011,Portsmouth 014B,E01017016,1122,870,252,123,42,87
2011,Portsmouth 014C,E01017017,1099,839,260,146,36,78
2011,Portsmouth 014D,E01017018,1132,843,289,158,45,86
2011,Portsmouth 014E,E01017019,1513,1085,428,145,61,222
2011,Portsmouth 014F,E01017020,1643,1184,459,215,62,182
2011,Portsmouth 015A,E01017076,1251,966,285,98,74,113
2011,Portsmouth 015B,E01017077,1261,836,425,151,68,206
2011,Portsmouth 015C,E01017078,1153,894,259,91,50,118
2011,Portsmouth 015D,E01017079,1253,835,418,79,199,140
2011,Portsmouth 015E,E01017080,1609,1044,565,105,268,192
2011,Portsmouth 015F,E01017081,1274,938,336,80,138,118
2011,Portsmouth 016A,E01017031,1398,843,555,180,99,276
2011,Portsmouth 016B,E01017032,2348,989,1359,65,1112,182
2011,Portsmouth 016D,E01017034,1627,1223,404,87,132,185
2011,Portsmouth 016E,E01017039,1230,681,549,148,162,239
2011,Portsmouth 016F,E01017040,1033,556,477,129,103,245
2011,Portsmouth 016G,E01033381,1209,745,464,67,289,108
2011,Portsmouth 016H,E01033383,977,572,405,105,135,165
2011,Portsmouth 017A,E01017021,1054,666,388,259,31,98
2011,Portsmouth 017B,E01017093,1358,737,621,153,374,94
2011,Portsmouth 017C,E01017096,1031,783,248,160,29,59
2011,Portsmouth 017D,E01017099,1213,860,353,150,104,99
2011,Portsmouth 017E,E01017100,1037,753,284,130,42,112
2011,Portsmouth 017F,E01017101,1139,860,279,127,56,96
2011,Portsmouth 018A,E01017035,1012,515,497,157,93,247
2011,Portsmouth 018B,E01017128,1492,863,629,60,476,93
2011,Portsmouth 018C,E01017129,1711,861,850,72,675,103
2011,Portsmouth 018D,E01017130,1351,695,656,158,230,268
2011,Portsmouth 018E,E01017132,1861,870,991,136,535,320
2011,Portsmouth 018F,E01017133,1423,792,631,138,335,158
2011,Portsmouth 019A,E01017023,1306,918,388,104,218,66
2011,Portsmouth 019B,E01017025,1734,1120,614,116,410,88
2011,Portsmouth 019C,E01017026,1561,950,611,126,407,78
2011,Portsmouth 019D,E01017029,1398,975,423,100,241,82
2011,Portsmouth 019E,E01017030,1623,1007,616,76,465,75
2011,Portsmouth 020A,E01017022,1212,780,432,84,272,76
2011,Portsmouth 020B,E01017024,1587,1009,578,70,434,74
2011,Portsmouth 020C,E01017027,1562,873,689,97,521,71
2011,Portsmouth 020D,E01017028,1936,1043,893,60,736,97
2011,Portsmouth 020E,E01017124,1406,971,435,105,210,120
2011,Portsmouth 021A,E01017094,1161,855,306,112,88,106
2011,Portsmouth 021B,E01017095,1389,1087,302,128,54,120
2011,Portsmouth 021C,E01017097,1242,897,345,97,150,98
2011,Portsmouth 021D,E01017098,1081,735,346,102,93,151
2011,Portsmouth 022A,E01017122,1425,1007,418,126,178,114
2011,Portsmouth 022B,E01017125,1298,813,485,145,218,122
2011,Portsmouth 022C,E01017127,1663,1206,457,84,261,112
2011,Portsmouth 022D,E01017135,1366,874,492,155,233,104
2011,Portsmouth 023A,E01017067,1089,718,371,210,43,118
2011,Portsmouth 023B,E01017068,1396,1036,360,201,40,119
2011,Portsmouth 023C,E01017069,1305,960,345,161,55,129
2011,Portsmouth 023D,E01017070,1164,765,399,164,137,98
2011,Portsmouth 023E,E01017074,1311,991,320,124,43,153
2011,Portsmouth 024A,E01017073,1377,974,403,135,139,129
2011,Portsmouth 024B,E01017123,1636,1197,439,185,148,106
2011,Portsmouth 024C,E01017131,1539,843,696,120,457,119
2011,Portsmouth 024E,E01033380,1306,768,538,128,354,56
2011,Portsmouth 024F,E01033384,1105,766,339,220,80,39
2011,Portsmouth 025A,E01017071,1327,924,403,88,225,90
2011,Portsmouth 025B,E01017072,1149,778,371,126,152,93
2011,Portsmouth 025C,E01017121,1337,954,383,128,159,96
2011,Portsmouth 025D,E01017126,1473,1036,437,104,235,98
2011,Portsmouth 026A,E01017059,1041,732,309,201,33,75
2011,Portsmouth 026B,E01017062,1138,885,253,143,38,72
2011,Portsmouth 026C,E01017066,1335,1013,322,194,43,85
2011,Portsmouth 026D,E01032604,1100,806,294,178,45,71
2011,Reading 001A,E01016407,1045,757,288,188,27,73
2011,Reading 001B,E01016408,1123,861,262,155,32,75
2011,Reading 001C,E01016410,1247,934,313,181,37,95
2011,Reading 001D,E01016411,1068,734,334,246,25,63
2011,Reading 001E,E01016412,1148,874,274,147,45,82
2011,Reading 002A,E01016386,1032,705,327,218,45,64
2011,Reading 002B,E01016387,1084,796,288,177,43,68
2011,Reading 002C,E01016425,1205,908,297,147,50,100
2011,Reading 002D,E01016426,978,701,277,151,50,76
2011,Reading 002E,E01016430,990,781,209,107,39,63
2011,Reading 003A,E01016364,1038,816,222,120,35,67
2011,Reading 003B,E01016409,1148,866,282,175,34,73
2011,Reading 003C,E01016427,1088,795,293,159,68,66
2011,Reading 003D,E01016428,1252,955,297,188,35,74
2011,Reading 003E,E01016429,1159,900,259,144,44,71
2011,Reading 004A,E01016362,1169,966,203,93,22,88
2011,Reading 004B,E01016363,1280,987,293,53,47,193
2011,Reading 004C,E01016365,1279,1089,190,93,30,67
2011,Reading 004D,E01016366,1176,929,247,114,44,89
2011,Reading 004E,E01016367,1174,899,275,107,41,127
2011,Reading 005A,E01016380,1230,949,281,163,36,82
2011,Reading 005B,E01016383,1128,936,192,98,19,75
2011,Reading 005C,E01016384,1225,934,291,193,33,65
2011,Reading 005D,E01016431,1147,883,264,143,38,83
2011,Reading 005E,E01016432,1027,760,267,154,35,78
2011,Reading 006A,E01016381,1004,754,250,87,29,134
2011,Reading 006B,E01016382,1230,918,312,101,42,169
2011,Reading 006C,E01016385,1127,907,220,87,36,97
2011,Reading 006D,E01016396,898,632,266,94,36,136
2011,Reading 006E,E01016397,936,651,285,117,44,124
2011,Reading 007A,E01016355,1487,1262,225,67,48,110
2011,Reading 007B,E01016358,1363,1112,251,55,46,150
2011,Reading 007C,E01016359,1502,1204,298,90,51,157
2011,Reading 007D,E01016360,1536,1188,348,65,80,203
2011,Reading 007E,E01016361,1305,1051,254,69,43,142
2011,Reading 008A,E01016356,1147,910,237,49,41,147
2011,Reading 008B,E01016357,1309,1094,215,60,43,112
2011,Reading 008C,E01016395,927,697,230,119,27,84
2011,Reading 008D,E01016398,1287,1086,201,51,38,112
2011,Reading 008E,E01016399,1075,845,230,103,36,91
2011,Reading 008F,E01016400,1161,922,239,90,35,114
2011,Reading 009A,E01016394,853,550,303,126,29,148
2011,Reading 009B,E01016433,1004,755,249,158,24,67
2011,Reading 009C,E01016434,1262,930,332,172,47,113
2011,Reading 009D,E01016435,957,643,314,175,35,104
2011,Reading 009E,E01016436,1080,781,299,132,35,132
2011,Reading 010B,E01016402,1586,938,648,52,489,107
2011,Reading 010C,E01016404,1547,1214,333,69,105,159
2011,Reading 010D,E01016405,1598,1188,410,52,166,192
2011,Reading 010E,E01016406,1329,934,395,50,255,90
2011,Reading 010F,E01033417,963,802,161,51,60,50
2011,Reading 010G,E01033421,1404,1026,378,79,96,203
2011,Reading 011B,E01016353,1446,1129,317,68,70,179
2011,Reading 011D,E01016378,1784,1377,407,51,162,194
2011,Reading 011E,E01016391,1425,1129,296,82,48,166
2011,Reading 011F,E01033415,1366,1036,330,30,69,231
2011,Reading 011G,E01033418,1007,826,181,17,59,105
2011,Reading 011H,E01033420,966,782,184,46,61,77
2011,Reading 011I,E01033422,960,797,163,45,36,82
2011,Reading 011J,E01033423,1019,866,153,27,46,80
2011,Reading 012A,E01016401,1163,820,343,95,174,74
2011,Reading 012B,E01016403,1448,1055,393,115,182,96
2011,Reading 012C,E01016416,1461,961,500,31,403,66
2011,Reading 012D,E01016417,1463,837,626,56,481,89
2011,Reading 012E,E01016418,1403,871,532,51,426,55
2011,Reading 013A,E01016388,1077,824,253,131,33,89
2011,Reading 013B,E01016389,1170,874,296,74,69,153
2011,Reading 013C,E01016390,1220,990,230,79,28,123
2011,Reading 013D,E01016392,1570,1252,318,126,39,153
2011,Reading 013E,E01016393,1143,852,291,120,37,134
2011,Reading 014A,E01016374,1343,1152,191,54,42,95
2011,Reading 014B,E01016375,1000,745,255,49,95,111
2011,Reading 014C,E01016376,1279,932,347,81,162,104
2011,Reading 014D,E01016379,1481,1178,303,55,142,106
2011,Reading 014E,E01016413,1536,854,682,66,551,65
2011,Reading 014F,E01016414,1318,941,377,49,242,86
2011,Reading 015A,E01016419,1278,987,291,135,32,124
2011,Reading 015B,E01016420,903,650,253,56,40,157
2011,Reading 015C,E01016421,947,636,311,164,27,120
2011,Reading 015D,E01016422,899,576,323,168,31,124
2011,Reading 015E,E01016423,977,715,262,103,28,131
2011,Reading 015F,E01016424,995,737,258,153,31,74
2011,Reading 016A,E01016370,2749,1034,1715,90,1550,75
2011,Reading 016B,E01016371,1216,823,393,129,173,91
2011,Reading 016C,E01016373,1041,747,294,56,84,154
2011,Reading 016D,E01016415,1097,712,385,121,87,177
2011,Reading 017A,E01016368,951,655,296,90,48,158
2011,Reading 017B,E01016372,878,600,278,77,42,159
2011,Reading 017C,E01016377,1234,919,315,75,99,141
2011,Reading 017D,E01016438,907,630,277,110,45,122
2011,Reading 017E,E01016442,2056,1621,435,91,84,260
2011,Reading 017F,E01016443,1006,704,302,91,48,163
2011,Reading 018A,E01016369,1143,824,319,147,41,131
2011,Reading 018B,E01016437,1009,756,253,90,37,126
2011,Reading 018C,E01016439,1119,800,319,127,48,144
2011,Reading 018D,E01016440,1057,763,294,109,40,145
2011,Reading 018E,E01016441,981,651,330,87,55,188
2011,Slough 001A,E01016450,1037,727,310,61,60,189
2011,Slough 001B,E01016451,1012,705,307,65,51,191
2011,Slough 001C,E01016452,1151,812,339,95,72,172
2011,Slough 001D,E01016453,1044,780,264,89,45,130
2011,Slough 001E,E01016454,1049,792,257,83,36,138
2011,Slough 001F,E01016455,944,734,210,33,50,127
2011,Slough 002A,E01016483,1301,940,361,92,73,196
2011,Slough 002B,E01016484,1162,817,345,119,68,158
2011,Slough 002C,E01016485,1230,860,370,96,94,180
2011,Slough 002D,E01016486,1123,800,323,93,66,164
2011,Slough 002E,E01016487,1273,895,378,96,101,181
2011,Slough 002F,E01016488,1282,947,335,97,60,178
2011,Slough 003A,E01016493,921,739,182,80,33,69
2011,Slough 003B,E01016494,1429,1171,258,76,40,142
2011,Slough 003C,E01016495,1108,889,219,113,33,73
2011,Slough 003D,E01016496,871,670,201,77,29,95
2011,Slough 003E,E01016497,1007,741,266,121,59,86
2011,Slough 003F,E01016498,1220,951,269,74,54,141
2011,Slough 003G,E01016499,965,716,249,52,68,129
2011,Slough 004A,E01016444,1178,787,391,71,91,229
2011,Slough 004B,E01016445,1231,835,396,60,94,242
2011,Slough 004C,E01016446,1132,723,409,94,99,216
2011,Slough 004D,E01016447,1289,894,395,94,82,219
2011,Slough 004E,E01016448,1687,1131,556,140,112,304
2011,Slough 004F,E01016449,1463,948,515,93,125,297
2011,Slough 005A,E01016516,1177,805,372,85,88,199
2011,Slough 005B,E01016517,1099,729,370,84,89,197
2011,Slough 005C,E01016518,1292,944,348,88,77,183
2011,Slough 005D,E01016519,1716,1268,448,120,128,200
2011,Slough 005E,E01016520,1124,731,393,103,91,199
2011,Slough 005F,E01016521,1224,883,341,101,76,164
2011,Slough 006A,E01016467,1056,826,230,81,41,108
2011,Slough 006B,E01016468,1250,1020,230,93,48,89
2011,Slough 006C,E01016469,1211,947,264,104,40,120
2011,Slough 006D,E01016470,1198,957,241,101,44,96
2011,Slough 006E,E01016471,976,759,217,79,42,96
2011,Slough 006F,E01016472,1167,812,355,132,72,151
2011,Slough 007A,E01016456,1558,1062,496,88,122,286
2011,Slough 007B,E01016457,1381,949,432,126,110,196
2011,Slough 007C,E01016458,1173,749,424,87,104,233
2011,Slough 007D,E01016459,1624,1189,435,72,102,261
2011,Slough 007E,E01016460,1369,956,413,144,91,178
2011,Slough 007F,E01016461,1896,1428,468,93,109,266
2011,Slough 008A,E01016473,1479,1196,283,63,70,150
2011,Slough 008B,E01016474,1400,1023,377,122,56,199
2011,Slough 008C,E01016475,1490,1058,432,116,99,217
2011,Slough 008D,E01016476,1227,1000,227,40,42,145
2011,Slough 008E,E01016477,1727,1429,298,60,66,172
2011,Slough 008F,E01016478,1375,1065,310,89,67,154
2011,Slough 009A,E01016462,1832,1361,471,71,112,288
2011,Slough 009B,E01016463,1369,874,495,119,114,262
2011,Slough 009C,E01016464,1387,907,480,86,117,277
2011,Slough 009D,E01016465,1931,1425,506,93,119,294
2011,Slough 009F,E01032729,1144,798,346,88,72,186
2011,Slough 009G,E01032730,1119,865,254,31,64,159
2011,Slough 010A,E01016506,1390,1157,233,49,58,126
2011,Slough 010B,E01016507,1136,827,309,147,63,99
2011,Slough 010C,E01016508,1223,913,310,127,57,126
2011,Slough 010D,E01016509,1157,916,241,96,47,98
2011,Slough 010E,E01016510,1139,807,332,153,88,91
2011,Slough 011A,E01016511,1370,1015,355,103,69,183
2011,Slough 011B,E01016512,1411,1109,302,73,46,183
2011,Slough 011C,E01016513,1379,1005,374,135,98,141
2011,Slough 011D,E01016514,1354,1050,304,106,53,145
2011,Slough 011E,E01016515,1496,1088,408,180,100,128
2011,Slough 012A,E01016500,1295,975,320,111,80,129
2011,Slough 012B,E01016501,1068,774,294,74,63,157
2011,Slough 012C,E01016502,967,715,252,68,78,106
2011,Slough 012D,E01016503,1115,828,287,80,73,134
2011,Slough 012E,E01016504,1060,790,270,109,86,75
2011,Slough 012F,E01016505,1161,854,307,84,75,148
2011,Slough 013B,E01016490,1372,921,451,152,75,224
2011,Slough 013C,E01016491,1224,882,342,165,55,122
2011,Slough 013D,E01016492,1171,860,311,120,68,123
2011,Slough 013E,E01032731,1043,795,248,48,55,145
2011,Slough 013F,E01032732,1148,834,314,112,45,157
2011,Slough 014A,E01016479,1146,900,246,44,69,133
2011,Slough 014B,E01016480,1026,758,268,94,45,129
2011,Slough 014C,E01016481,1143,908,235,68,34,133
2011,Slough 014D,E01016482,1384,1119,265,96,66,103
2011,Southampton 001A,E01017144,965,520,445,94,286,65
2011,Southampton 001B,E01017145,1064,720,344,186,99,59
2011,Southampton 001C,E01017146,1822,940,882,161,629,92
2011,Southampton 001D,E01017148,1929,769,1160,109,999,52
2011,Southampton 001E,E01017149,1103,625,478,72,305,101
2011,Southampton 002A,E01017180,1152,883,269,157,42,70
2011,Southampton 002B,E01017181,1031,704,327,169,29,129
2011,Southampton 002C,E01017183,1216,915,301,189,39,73
2011,Southampton 002D,E01017185,1219,914,305,137,18,150
2011,Southampton 002E,E01017187,1182,871,311,131,42,138
2011,Southampton 003A,E01017264,2306,810,1496,71,1304,121
2011,Southampton 003B,E01017265,1171,790,381,141,61,179
2011,Southampton 003C,E01017270,1060,619,441,163,194,84
2011,Southampton 003D,E01017271,815,578,237,131,39,67
2011,Southampton 004A,E01017182,985,598,387,242,23,122
2011,Southampton 004B,E01017184,1066,733,333,191,23,119
2011,Southampton 004C,E01017186,1230,932,298,77,49,172
2011,Southampton 004D,E01017188,1203,843,360,116,55,189
2011,Southampton 005A,E01017266,1093,630,463,79,254,130
2011,Southampton 005B,E01017267,1029,562,467,65,312,90
2011,Southampton 005E,E01017272,982,665,317,91,68,158
2011,Southampton 005F,E01032756,2509,1094,1415,114,1116,185
2011,Southampton 006A,E01017147,1069,798,271,118,76,77
2011,Southampton 006B,E01017150,1042,702,340,186,102,52
2011,Southampton 006C,E01017151,1151,789,362,211,43,108
2011,Southampton 006D,E01017152,1168,876,292,123,59,110
2011,Southampton 007A,E01017238,985,669,316,127,31,158
2011,Southampton 007B,E01017241,954,599,355,196,29,130
2011,Southampton 007C,E01017242,1125,877,248,125,30,93
2011,Southampton 007D,E01017243,1289,957,332,173,48,111
2011,Southampton 007E,E01017244,921,656,265,111,35,119
2011,Southampton 008A,E01017174,941,678,263,188,15,60
2011,Southampton 008B,E01017175,1116,870,246,119,34,93
2011,Southampton 008C,E01017176,1177,867,310,153,52,105
2011,Southampton 008D,E01017179,1047,727,320,132,48,140
2011,Southampton 009A,E01017226,1088,721,367,157,135,75
2011,Southampton 009D,E01017231,1486,774,712,61,594,57
2011,Southampton 009E,E01017232,988,586,402,102,257,43
2011,Southampton 009F,E01032753,1990,1048,942,166,691,85
2011,Southampton 010A,E01017246,1483,1168,315,122,51,142
2011,Southampton 010B,E01017250,983,607,376,168,36,172
2011,Southampton 010C,E01017251,1144,843,301,116,47,138
2011,Southampton 010D,E01017253,1197,847,350,134,48,168
2011,Southampton 011A,E01017247,1174,869,305,156,65,84
2011,Southampton 011B,E01017248,1090,831,259,140,55,64
2011,Southampton 011C,E01017249,994,725,269,144,53,72
2011,Southampton 011D,E01017252,1132,852,280,147,64,69
2011,Southampton 011E,E01017254,1205,906,299,102,65,132
2011,Southampton 012A,E01017236,949,655,294,104,28,162
2011,Southampton 012B,E01017237,1038,684,354,107,44,203
2011,Southampton 012C,E01017239,1097,830,267,86,40,141
2011,Southampton 012D,E01017240,854,549,305,102,25,178
2011,Southampton 012E,E01017245,975,618,357,102,29,226
2011,Southampton 013A,E01017227,1171,545,626,27,537,62
2011,Southampton 013B,E01017228,1227,862,365,109,112,144
2011,Southampton 013C,E01017233,1238,877,361,107,131,123
2011,Southampton 013D,E01017234,1553,875,678,82,470,126
2011,Southampton 013E,E01017235,1372,729,643,39,505,99
2011,Southampton 014A,E01017171,1425,1092,333,140,55,138
2011,Southampton 014B,E01017172,1410,1154,256,108,46,102
2011,Southampton 014C,E01017173,1054,823,231,122,29,80
2011,Southampton 014D,E01017177,1164,889,275,151,44,80
2011,Southampton 014E,E01017178,1132,916,216,99,38,79
2011,Southampton 015A,E01017207,1064,683,381,116,42,223
2011,Southampton 015B,E01017209,1063,824,239,89,43,107
2011,Southampton 015C,E01017211,1245,910,335,180,46,109
2011,Southampton 015D,E01017212,1011,776,235,113,42,80
2011,Southampton 015E,E01017213,1221,1006,215,108,38,69
2011,Southampton 016A,E01017200,1284,969,315,199,33,83
2011,Southampton 016B,E01017201,944,607,337,156,33,148
2011,Southampton 016C,E01017202,1156,811,345,120,40,185
2011,Southampton 016D,E01017203,1149,875,274,141,34,99
2011,Southampton 016E,E01017204,1137,869,268,159,33,76
2011,Southampton 017A,E01017157,1439,689,750,59,638,53
2011,Southampton 017B,E01017158,1665,964,701,91,505,105
2011,Southampton 017C,E01017159,1506,766,740,33,625,82
2011,Southampton 017D,E01017160,1305,949,356,49,233,74
2011,Southampton 018A,E01017198,1015,716,299,185,18,96
2011,Southampton 018B,E01017199,1121,765,356,195,36,125
2011,Southampton 018C,E01017205,906,600,306,94,47,165
2011,Southampton 018D,E01017206,1176,843,333,162,45,126
2011,Southampton 019A,E01017208,970,677,293,81,41,171
2011,Southampton 019B,E01017210,1012,662,350,103,54,193
2011,Southampton 019C,E01017214,1069,789,280,111,46,123
2011,Southampton 019D,E01017215,1263,983,280,139,37,104
2011,Southampton 019E,E01017216,1104,831,273,87,33,153
2011,Southampton 020A,E01017189,1293,993,300,65,127,108
2011,Southampton 020B,E01017190,1472,1058,414,96,267,51
2011,Southampton 020C,E01017191,1433,1153,280,47,97,136
2011,Southampton 020D,E01017196,1730,1299,431,114,218,99
2011,Southampton 020E,E01017197,1138,899,239,93,56,90
2011,Southampton 021A,E01017192,1574,1221,353,117,78,158
2011,Southampton 021B,E01017193,1326,1030,296,141,47,108
2011,Southampton 021C,E01017194,1484,1144,340,92,84,164
2011,Southampton 021D,E01017195,1577,1239,338,119,67,152
2011,Southampton 022A,E01017153,1187,789,398,48,98,252
2011,Southampton 022B,E01017154,1531,954,577,67,124,386
2011,Southampton 022C,E01017155,1250,822,428,53,136,239
2011,Southampton 022D,E01017156,1259,792,467,76,119,272
2011,Southampton 022F,E01032738,1207,827,380,16,272,92
2011,Southampton 022G,E01032750,1333,727,606,44,395,167
2011,Southampton 023A,E01017136,1479,933,546,46,455,45
2011,Southampton 023B,E01017137,1656,975,681,10,633,38
2011,Southampton 023C,E01017138,2025,1290,735,89,582,64
2011,Southampton 023D,E01017140,1223,807,416,115,151,150
2011,Southampton 024A,E01017217,1118,774,344,184,44,116
2011,Southampton 024B,E01017223,1241,956,285,148,35,102
2011,Southampton 024C,E01017224,1012,804,208,122,26,60
2011,Southampton 024D,E01017225,1092,796,296,149,25,122
2011,Southampton 025A,E01017162,1011,682,329,198,22,109
2011,Southampton 025B,E01017163,1033,675,358,84,26,248
2011,Southampton 025C,E01017164,1125,780,345,202,25,118
2011,Southampton 025D,E01017165,997,681,316,139,35,142
2011,Southampton 025E,E01017166,1007,651,356,113,42,201
2011,Southampton 026A,E01017256,1490,1101,389,227,34,128
2011,Southampton 026B,E01017257,1187,921,266,125,30,111
2011,Southampton 026C,E01017259,1078,819,259,171,24,64
2011,Southampton 026D,E01017260,1001,690,311,220,16,75
2011,Southampton 026E,E01017262,978,734,244,116,38,90
2011,Southampton 027A,E01017167,1039,676,363,90,29,244
2011,Southampton 027B,E01017168,1220,829,391,161,26,204
2011,Southampton 027C,E01017169,1054,692,362,161,36,165
2011,Southampton 027D,E01017170,1107,811,296,146,31,119
2011,Southampton 028A,E01017218,974,689,285,96,52,137
2011,Southampton 028B,E01017219,1297,929,368,178,30,160
2011,Southampton 028C,E01017220,1371,1009,362,164,54,144
2011,Southampton 028D,E01017221,1232,949,283,119,48,116
2011,Southampton 028E,E01017222,1141,908,233,96,39,98
2011,Southampton 029A,E01017139,1976,1195,781,138,410,233
2011,Southampton 029C,E01017142,2227,1567,660,78,500,82
2011,Southampton 029E,E01032745,2021,1152,869,33,685,151
2011,Southampton 029F,E01032746,1088,862,226,14,173,39
2011,Southampton 029G,E01032748,1002,809,193,54,97,42
2011,Southampton 029H,E01032751,1001,739,262,44,97,121
2011,Southampton 029I,E01032755,748,432,316,46,41,229
2011,Southampton 030A,E01017255,1160,895,265,167,19,79
2011,Southampton 030B,E01017258,1148,876,272,123,37,112
2011,Southampton 030C,E01017261,1266,971,295,171,30,94
2011,Southampton 030D,E01017263,1038,772,266,125,31,110
2011,Southampton 031A,E01017273,1000,742,258,135,35,88
2011,Southampton 031B,E01017275,1230,945,285,136,47,102
2011,Southampton 031C,E01017276,1302,978,324,96,54,174
2011,Southampton 031D,E01017278,1017,830,187,81,28,78
2011,Southampton 031E,E01017279,1223,921,302,155,35,112
2011,Southampton 032A,E01017274,1015,649,366,142,41,183
2011,Southampton 032B,E01017277,1090,807,283,125,41,117
2011,Southampton 032C,E01017280,977,627,350,138,31,181
2011,Southampton 032D,E01017281,1135,697,438,99,28,311
2011,West Berkshire 001A,E01016277,1031,678,353,181,106,66
2011,West Berkshire 001B,E01016286,1142,894,248,123,35,90
2011,West Berkshire 001C,E01016287,1083,819,264,115,35,114
2011,West Berkshire 001D,E01016288,1197,902,295,144,35,116
2011,West Berkshire 002A,E01016303,1078,815,263,169,24,70
2011,West Berkshire 002B,E01016304,1182,897,285,154,25,106
2011,West Berkshire 002C,E01016305,962,745,217,136,16,65
2011,West Berkshire 002D,E01016306,979,725,254,142,16,96
2011,West Berkshire 003A,E01016256,1292,944,348,202,42,104
2011,West Berkshire 003B,E01016257,928,683,245,121,27,97
2011,West Berkshire 003C,E01016313,1167,874,293,182,35,76
2011,West Berkshire 003D,E01016314,947,584,363,156,134,73
2011,West Berkshire 004A,E01016315,1185,858,327,215,25,87
2011,West Berkshire 004B,E01016316,1515,1172,343,197,40,106
2011,West Berkshire 004C,E01016317,1063,729,334,187,42,105
2011,West Berkshire 004D,E01016318,1133,883,250,159,24,67
2011,West Berkshire 005A,E01016258,1160,817,343,249,24,70
2011,West Berkshire 005B,E01016261,1241,1026,215,108,44,63
2011,West Berkshire 005C,E01016349,884,660,224,162,21,41
2011,West Berkshire 005D,E01016350,1101,825,276,189,29,58
2011,West Berkshire 006A,E01016259,1177,911,266,151,33,82
2011,West Berkshire 006B,E01016260,1238,937,301,189,38,74
2011,West Berkshire 006C,E01016262,965,686,279,210,31,38
2011,West Berkshire 006D,E01016272,1195,936,259,144,48,67
2011,West Berkshire 006E,E01016273,1018,763,255,92,40,123
2011,West Berkshire 007A,E01016263,1534,1206,328,176,48,104
2011,West Berkshire 007B,E01016278,936,775,161,63,33,65
2011,West Berkshire 007C,E01016283,1333,836,497,187,234,76
2011,West Berkshire 007D,E01016284,1023,777,246,138,32,76
2011,West Berkshire 007E,E01016285,1135,886,249,126,35,88
2011,West Berkshire 008A,E01016271,1100,829,271,151,32,88
2011,West Berkshire 008B,E01016274,1079,799,280,158,30,92
2011,West Berkshire 008C,E01016275,1107,923,184,82,25,77
2011,West Berkshire 008D,E01016276,1111,923,188,81,32,75
2011,West Berkshire 009A,E01016327,889,689,200,109,26,65
2011,West Berkshire 009B,E01016328,1256,932,324,174,38,112
2011,West Berkshire 009C,E01016344,1093,820,273,154,33,86
2011,West Berkshire 009D,E01016345,1013,813,200,107,24,69
2011,West Berkshire 010A,E01016296,1174,932,242,154,18,70
2011,West Berkshire 010B,E01016297,1099,833,266,151,34,81
2011,West Berkshire 010C,E01016298,852,665,187,106,16,65
2011,West Berkshire 010D,E01016299,1105,866,239,148,12,79
2011,West Berkshire 011A,E01016254,1005,763,242,151,20,71
2011,West Berkshire 011B,E01016255,1120,819,301,196,33,72
2011,West Berkshire 011C,E01016264,1040,581,459,88,317,54
2011,West Berkshire 011D,E01016265,1065,765,300,171,41,88
2011,West Berkshire 011E,E01016266,998,694,304,166,45,93
2011,West Berkshire 011F,E01016339,2155,1686,469,185,40,244
2011,West Berkshire 012A,E01016310,1268,994,274,139,32,103
2011,West Berkshire 012B,E01016311,1212,962,250,139,21,90
2011,West Berkshire 012C,E01016323,988,699,289,196,23,70
2011,West Berkshire 012D,E01016324,1015,764,251,143,25,83
2011,West Berkshire 012E,E01016325,1031,747,284,143,23,118
2011,West Berkshire 013A,E01016279,1584,1265,319,117,51,151
2011,West Berkshire 013B,E01016280,1307,1010,297,127,26,144
2011,West Berkshire 013C,E01016281,1058,818,240,135,30,75
2011,West Berkshire 013D,E01016282,1097,916,181,97,24,60
2011,West Berkshire 014A,E01016329,1134,1000,134,65,24,45
2011,West Berkshire 014B,E01016340,1117,870,247,126,34,87
2011,West Berkshire 014C,E01016341,1057,850,207,107,20,80
2011,West Berkshire 014D,E01016342,1517,1265,252,118,43,91
2011,West Berkshire 014E,E01016343,1104,859,245,135,41,69
2011,West Berkshire 015A,E01016267,1057,800,257,170,28,59
2011,West Berkshire 015B,E01016268,1117,832,285,157,36,92
2011,West Berkshire 015C,E01016269,1053,807,246,132,36,78
2011,West Berkshire 015D,E01016270,1053,855,198,76,37,85
2011,West Berkshire 016A,E01016330,1085,895,190,97,21,72
2011,West Berkshire 016B,E01016331,1135,883,252,101,38,113
2011,West Berkshire 016C,E01016332,1060,761,299,186,25,88
2011,West Berkshire 016D,E01016334,1219,986,233,80,37,116
2011,West Berkshire 016E,E01016336,874,597,277,108,35,134
2011,West Berkshire 017A,E01016333,965,813,152,58,32,62
2011,West Berkshire 017B,E01016335,1165,933,232,135,27,70
2011,West Berkshire 017C,E01016337,1525,1215,310,165,35,110
2011,West Berkshire 017D,E01016338,1406,1155,251,119,44,88
2011,West Berkshire 018A,E01016300,1036,789,247,131,30,86
2011,West Berkshire 018B,E01016301,1468,1083,385,200,43,142
2011,West Berkshire 018C,E01016302,1211,905,306,151,39,116
2011,West Berkshire 018D,E01016326,937,686,251,144,15,92
2011,West Berkshire 019A,E01016293,1964,1511,453,198,78,177
2011,West Berkshire 019B,E01016346,1042,815,227,107,12,108
2011,West Berkshire 019C,E01016347,1131,886,245,107,22,116
2011,West Berkshire 019D,E01016348,1600,1333,267,97,21,149
2011,West Berkshire 020A,E01016294,1142,923,219,137,20,62
2011,West Berkshire 020B,E01016295,1061,778,283,83,35,165
2011,West Berkshire 020C,E01016312,1455,1142,313,139,30,144
2011,West Berkshire 020D,E01016319,1140,833,307,196,29,82
2011,West Berkshire 020E,E01016320,1033,765,268,146,29,93
2011,West Berkshire 021A,E01016289,1001,670,331,244,30,57
2011,West Berkshire 021B,E01016290,1126,873,253,172,31,50
2011,West Berkshire 021C,E01016291,1230,954,276,177,24,75
2011,West Berkshire 021D,E01016292,1132,869,263,137,31,95
2011,West Berkshire 021E,E01016321,1114,857,257,115,37,105
2011,West Berkshire 021F,E01016322,903,659,244,151,38,55
2011,West Berkshire 022A,E01016307,1098,795,303,177,31,95
2011,West Berkshire 022B,E01016308,1326,1002,324,194,45,85
2011,West Berkshire 022C,E01016309,1616,1147,469,221,114,134
2011,Windsor and Maidenhead 001A,E01016570,1164,852,312,189,47,76
2011,Windsor and Maidenhead 001B,E01016572,915,654,261,162,32,67
2011,Windsor and Maidenhead 001C,E01016582,1049,766,283,89,48,146
2011,Windsor and Maidenhead 001D,E01016600,820,558,262,160,38,64
2011,Windsor and Maidenhead 002A,E01016530,1020,727,293,157,35,101
2011,Windsor and Maidenhead 002B,E01016531,1036,721,315,196,36,83
2011,Windsor and Maidenhead 002C,E01016532,1427,1091,336,213,37,86
2011,Windsor and Maidenhead 002D,E01016533,1361,1019,342,196,39,107
2011,Windsor and Maidenhead 002E,E01016578,1096,813,283,150,35,98
2011,Windsor and Maidenhead 002F,E01016579,1231,880,351,188,57,106
2011,Windsor and Maidenhead 002G,E01016581,1052,761,291,165,42,84
2011,Windsor and Maidenhead 003A,E01016571,1130,841,289,152,55,82
2011,Windsor and Maidenhead 003B,E01016573,1012,724,288,117,40,131
2011,Windsor and Maidenhead 003C,E01016574,1052,721,331,150,49,132
2011,Windsor and Maidenhead 003D,E01016599,1175,872,303,126,53,124
2011,Windsor and Maidenhead 004A,E01016583,1199,876,323,187,58,78
2011,Windsor and Maidenhead 004B,E01016585,1267,966,301,169,48,84
2011,Windsor and Maidenhead 004C,E01016586,975,695,280,167,51,62
2011,Windsor and Maidenhead 004D,E01016591,1248,875,373,203,67,103
2011,Windsor and Maidenhead 004E,E01016592,1282,966,316,182,53,81
2011,Windsor and Maidenhead 005A,E01016525,1144,920,224,103,46,75
2011,Windsor and Maidenhead 005B,E01016528,1149,868,281,137,56,88
2011,Windsor and Maidenhead 005C,E01016529,1136,785,351,125,49,177
2011,Windsor and Maidenhead 005D,E01016536,1409,1118,291,111,37,143
2011,Windsor and Maidenhead 005E,E01016584,1220,926,294,110,36,148
2011,Windsor and Maidenhead 005G,E01032733,765,612,153,64,12,77
2011,Windsor and Maidenhead 005H,E01032734,1088,906,182,55,25,102
2011,Windsor and Maidenhead 006A,E01016526,1296,1037,259,108,50,101
2011,Windsor and Maidenhead 006B,E01016527,1162,925,237,89,41,107
2011,Windsor and Maidenhead 006C,E01016534,1125,815,310,175,57,78
2011,Windsor and Maidenhead 006D,E01016598,953,692,261,147,52,62
2011,Windsor and Maidenhead 006E,E01016601,1132,851,281,143,50,88
2011,Windsor and Maidenhead 006F,E01016602,1104,789,315,199,45,71
2011,Windsor and Maidenhead 007A,E01016535,917,679,238,124,34,80
2011,Windsor and Maidenhead 007B,E01016537,1073,800,273,99,55,119
2011,Windsor and Maidenhead 007C,E01016538,1176,936,240,122,38,80
2011,Windsor and Maidenhead 007D,E01016593,1190,906,284,117,37,130
2011,Windsor and Maidenhead 007E,E01016594,1052,782,270,117,43,110
2011,Windsor and Maidenhead 008A,E01016559,1081,789,292,184,45,63
2011,Windsor and Maidenhead 008B,E01016560,1057,773,284,128,31,125
2011,Windsor and Maidenhead 008C,E01016561,1376,1079,297,173,52,72
2011,Windsor and Maidenhead 008D,E01016562,1054,797,257,174,30,53
2011,Windsor and Maidenhead 008E,E01016563,1050,805,245,151,48,46
2011,Windsor and Maidenhead 008F,E01016580,1115,826,289,132,37,120
2011,Windsor and Maidenhead 009A,E01016539,1162,831,331,182,48,101
2011,Windsor and Maidenhead 009B,E01016540,1229,933,296,170,52,74
2011,Windsor and Maidenhead 009C,E01016541,1062,804,258,158,38,62
2011,Windsor and Maidenhead 009D,E01016542,851,626,225,129,24,72
2011,Windsor and Maidenhead 009E,E01016543,1189,892,297,185,38,74
2011,Windsor and Maidenhead 010A,E01016544,1396,1169,227,102,28,97
2011,Windsor and Maidenhead 010B,E01016567,1921,1217,704,108,503,93
2011,Windsor and Maidenhead 010C,E01016568,885,693,192,101,32,59
2011,Windsor and Maidenhead 010D,E01016569,777,597,180,101,27,52
2011,Windsor and Maidenhead 011A,E01016564,1150,868,282,135,54,93
2011,Windsor and Maidenhead 011B,E01016565,1132,840,292,155,42,95
2011,Windsor and Maidenhead 011C,E01016566,1290,1021,269,108,42,119
2011,Windsor and Maidenhead 011D,E01016577,1285,1004,281,132,47,102
2011,Windsor and Maidenhead 012A,E01016545,1463,1166,297,155,37,105
2011,Windsor and Maidenhead 012B,E01016547,1305,1113,192,86,29,77
2011,Windsor and Maidenhead 012C,E01016550,1146,953,193,82,27,84
2011,Windsor and Maidenhead 012D,E01016552,1162,920,242,127,35,80
2011,Windsor and Maidenhead 013A,E01016551,1132,852,280,193,33,54
2011,Windsor and Maidenhead 013B,E01016553,1054,730,324,233,32,59
2011,Windsor and Maidenhead 013C,E01016557,1378,1030,348,207,50,91
2011,Windsor and Maidenhead 013D,E01016558,1149,893,256,78,29,149
2011,Windsor and Maidenhead 014A,E01016548,1405,1123,282,125,41,116
2011,Windsor and Maidenhead 014B,E01016549,1348,994,354,174,50,130
2011,Windsor and Maidenhead 014C,E01016554,1046,771,275,123,33,119
2011,Windsor and Maidenhead 014D,E01016555,1057,777,280,123,48,109
2011,Windsor and Maidenhead 014E,E01016556,1260,920,340,174,45,121
2011,Windsor and Maidenhead 015A,E01016546,1213,985,228,122,25,81
2011,Windsor and Maidenhead 015B,E01016595,1206,954,252,108,44,100
2011,Windsor and Maidenhead 015C,E01016596,1302,993,309,167,40,102
2011,Windsor and Maidenhead 015D,E01016597,1298,912,386,221,75,90
2011,Windsor and Maidenhead 016A,E01016575,1280,909,371,224,51,96
2011,Windsor and Maidenhead 016B,E01016576,1260,941,319,172,55,92
2011,Windsor and Maidenhead 016C,E01016587,1133,870,263,162,33,68
2011,Windsor and Maidenhead 016D,E01016588,1312,957,355,218,36,101
2011,Windsor and Maidenhead 016E,E01016589,1122,850,272,164,39,69
2011,Windsor and Maidenhead 017A,E01016522,1433,984,449,228,77,144
2011,Windsor and Maidenhead 017B,E01016523,1173,774,399,132,170,97
2011,Windsor and Maidenhead 017C,E01016524,1443,1061,382,194,62,126
2011,Windsor and Maidenhead 017D,E01016609,1273,978,295,128,47,120
2011,Windsor and Maidenhead 018A,E01016603,1213,841,372,186,46,140
2011,Windsor and Maidenhead 018B,E01016604,1319,851,468,229,67,172
2011,Windsor and Maidenhead 018C,E01016605,1089,810,279,148,35,96
2011,Windsor and Maidenhead 018D,E01016606,1177,832,345,183,59,103
2011,Windsor and Maidenhead 018E,E01016607,1181,688,493,179,198,116
2011,Windsor and Maidenhead 018F,E01016608,1251,929,322,150,49,123
2011,Wokingham 001A,E01016675,746,504,242,130,42,70
2011,Wokingham 001B,E01016676,1076,741,335,206,46,83
2011,Wokingham 001C,E01016677,1065,761,304,174,34,96
2011,Wokingham 001D,E01016678,1011,725,286,175,30,81
2011,Wokingham 002A,E01016619,1110,856,254,155,27,72
2011,Wokingham 002B,E01016620,1087,851,236,124,34,78
2011,Wokingham 002C,E01016692,991,735,256,173,25,58
2011,Wokingham 002D,E01016693,1054,872,182,108,21,53
2011,Wokingham 002E,E01016694,978,761,217,136,17,64
2011,Wokingham 002F,E01016695,1112,813,299,188,40,71
2011,Wokingham 003A,E01016621,1087,838,249,138,34,77
2011,Wokingham 003B,E01016623,1046,774,272,177,24,71
2011,Wokingham 003C,E01016624,1016,739,277,188,32,57
2011,Wokingham 003D,E01016684,1174,886,288,179,39,70
2011,Wokingham 003E,E01016685,1109,767,342,194,60,88
2011,Wokingham 004A,E01016622,918,677,241,161,36,44
2011,Wokingham 004B,E01016657,1024,796,228,118,29,81
2011,Wokingham 004C,E01016658,999,844,155,53,48,54
2011,Wokingham 004D,E01016659,1058,897,161,71,39,51
2011,Wokingham 004E,E01016660,1207,991,216,118,42,56
2011,Wokingham 005A,E01016615,1040,718,322,172,41,109
2011,Wokingham 005B,E01016616,1000,687,313,202,36,75
2011,Wokingham 005C,E01016617,891,617,274,192,29,53
2011,Wokingham 005D,E01016662,1180,854,326,138,32,156
2011,Wokingham 006A,E01016613,1095,764,331,115,84,132
2011,Wokingham 006B,E01016614,1021,723,298,147,58,93
2011,Wokingham 006C,E01016618,941,664,277,139,64,74
2011,Wokingham 006D,E01016664,832,619,213,123,43,47
2011,Wokingham 006E,E01016668,1132,813,319,158,70,91
2011,Wokingham 006F,E01016669,1256,942,314,170,45,99
2011,Wokingham 007A,E01016661,1012,794,218,123,32,63
2011,Wokingham 007B,E01016663,1139,878,261,160,31,70
2011,Wokingham 007C,E01016686,900,739,161,90,22,49
2011,Wokingham 007D,E01016687,940,693,247,161,25,61
2011,Wokingham 007E,E01016688,1344,877,467,126,290,51
2011,Wokingham 007F,E01016689,1023,714,309,223,30,56
2011,Wokingham 008B,E01016652,949,708,241,125,54,62
2011,Wokingham 008C,E01016653,1210,810,400,155,201,44
2011,Wokingham 008D,E01016665,1158,914,244,125,42,77
2011,Wokingham 008E,E01016666,1067,834,233,114,50,69
2011,Wokingham 008G,E01032761,1963,1369,594,294,197,103
2011,Wokingham 009A,E01016647,1361,1102,259,91,68,100
2011,Wokingham 009B,E01016701,1282,973,309,178,45,86
2011,Wokingham 009C,E01016702,1352,1046,306,165,46,95
2011,Wokingham 009D,E01016703,1333,1048,285,133,46,106
2011,Wokingham 009E,E01016704,1420,1065,355,130,52,173
2011,Wokingham 010A,E01016627,1384,1092,292,182,38,72
2011,Wokingham 010B,E01016628,1099,797,302,226,24,52
2011,Wokingham 010C,E01016656,1048,816,232,125,36,71
2011,Wokingham 010D,E01016700,1445,1125,320,167,61,92
2011,Wokingham 011A,E01016644,1066,874,192,82,35,75
2011,Wokingham 011B,E01016645,1192,1045,147,57,26,64
2011,Wokingham 011C,E01016646,1208,986,222,93,47,82
2011,Wokingham 011D,E01016648,1101,949,152,60,27,65
2011,Wokingham 011E,E01016649,1139,941,198,86,32,80
2011,Wokingham 012A,E01016651,1052,808,244,133,42,69
2011,Wokingham 012B,E01016654,1046,809,237,126,43,68
2011,Wokingham 012C,E01016655,1018,845,173,88,32,53
2011,Wokingham 012D,E01016679,1644,1273,371,152,75,144
2011,Wokingham 012E,E01016680,906,670,236,81,58,97
2011,Wokingham 012G,E01032758,1158,952,206,73,40,93
2011,Wokingham 012H,E01032759,1074,838,236,118,25,93
2011,Wokingham 013A,E01016626,1177,906,271,140,34,97
2011,Wokingham 013B,E01016671,1039,733,306,222,21,63
2011,Wokingham 013C,E01016673,1210,849,361,155,41,165
2011,Wokingham 013D,E01016674,1059,768,291,161,27,103
2011,Wokingham 013E,E01016696,1115,908,207,112,32,63
2011,Wokingham 014A,E01016670,1506,1242,264,130,37,97
2011,Wokingham 014B,E01016672,1309,970,339,228,34,77
2011,Wokingham 014E,E01032763,1657,1175,482,329,43,110
2011,Wokingham 015A,E01016612,1592,1213,379,227,53,99
2011,Wokingham 015B,E01016629,997,687,310,224,37,49
2011,Wokingham 015C,E01016630,1134,914,220,96,57,67
2011,Wokingham 015D,E01016635,1020,830,190,85,45,60
2011,Wokingham 016A,E01016625,1148,822,326,227,40,59
2011,Wokingham 016B,E01016631,993,778,215,97,36,82
2011,Wokingham 016C,E01016632,1155,895,260,159,32,69
2011,Wokingham 016D,E01016634,1053,785,268,171,32,65
2011,Wokingham 016E,E01016699,1095,804,291,177,45,69
2011,Wokingham 017A,E01016682,1374,1102,272,148,30,94
2011,Wokingham 017B,E01016683,1389,1084,305,180,35,90
2011,Wokingham 017C,E01016690,1302,1010,292,154,40,98
2011,Wokingham 017D,E01016691,847,611,236,127,26,83
2011,Wokingham 018A,E01016610,2026,1595,431,205,73,153
2011,Wokingham 018B,E01016611,1109,966,143,61,19,63
2011,Wokingham 018C,E01016641,1011,703,308,195,28,85
2011,Wokingham 018D,E01016642,833,576,257,137,30,90
2011,Wokingham 019A,E01016633,1001,730,271,149,49,73
2011,Wokingham 019B,E01016636,1059,764,295,204,31,60
2011,Wokingham 019C,E01016637,807,564,243,145,37,61
2011,Wokingham 019D,E01016638,954,765,189,98,31,60
2011,Wokingham 019E,E01016639,1158,890,268,173,32,63
2011,Wokingham 019F,E01016640,1148,773,375,225,39,111
2011,Wokingham 019G,E01016643,1018,781,237,144,30,63
2011,Wokingham 020A,E01016705,1050,723,327,93,34,200
2011,Wokingham 020B,E01016706,1236,972,264,157,40,67
2011,Wokingham 020C,E01016707,1140,840,300,201,37,62
2011,Wokingham 020D,E01016708,1188,826,362,238,43,81
2011,Wokingham 020E,E01016709,1075,745,330,238,38,54
2011,Aylesbury Vale 001A,E01017648,1357,1061,296,161,61,74
2011,Aylesbury Vale 001B,E01017649,1545,1068,477,164,218,95
2011,Aylesbury Vale 001C,E01017650,1193,951,242,122,45,75
2011,Aylesbury Vale 001F,E01032960,2153,1418,735,248,371,116
2011,Aylesbury Vale 002A,E01017644,1148,930,218,95,52,71
2011,Aylesbury Vale 002B,E01017645,1219,658,561,91,410,60
2011,Aylesbury Vale 002C,E01017646,1265,935,330,171,48,111
2011,Aylesbury Vale 002D,E01017647,1184,871,313,211,43,59
2011,Aylesbury Vale 003A,E01017671,1170,880,290,155,40,95
2011,Aylesbury Vale 003B,E01017672,1099,801,298,179,38,81
2011,Aylesbury Vale 003C,E01017695,932,632,300,216,20,64
2011,Aylesbury Vale 003D,E01017696,928,695,233,147,29,57
2011,Aylesbury Vale 004A,E01017693,818,647,171,109,20,42
2011,Aylesbury Vale 004B,E01017694,1619,1265,354,182,57,115
2011,Aylesbury Vale 004C,E01017713,1069,827,242,137,31,74
2011,Aylesbury Vale 004D,E01017714,1045,831,214,132,24,58
2011,Aylesbury Vale 004E,E01017717,1214,895,319,203,34,82
2011,Aylesbury Vale 004F,E01017718,1166,900,266,142,39,85
2011,Aylesbury Vale 005A,E01017735,972,715,257,148,39,70
2011,Aylesbury Vale 005B,E01017736,1076,813,263,129,36,98
2011,Aylesbury Vale 005C,E01017737,997,720,277,206,30,41
2011,Aylesbury Vale 005D,E01017738,1081,824,257,145,33,79
2011,Aylesbury Vale 006A,E01017669,1119,804,315,171,50,94
2011,Aylesbury Vale 006B,E01017670,1152,871,281,166,33,82
2011,Aylesbury Vale 006C,E01017715,837,630,207,127,31,49
2011,Aylesbury Vale 006D,E01017716,1317,950,367,218,55,94
2011,Aylesbury Vale 007A,E01017641,1233,915,318,221,30,67
2011,Aylesbury Vale 007B,E01017731,947,706,241,126,39,76
2011,Aylesbury Vale 007C,E01017732,1058,789,269,177,36,56
2011,Aylesbury Vale 007D,E01017733,884,659,225,144,27,54
2011,Aylesbury Vale 007E,E01017734,1064,782,282,142,69,71
2011,Aylesbury Vale 008A,E01017703,923,660,263,155,36,72
2011,Aylesbury Vale 008B,E01017704,938,672,266,160,33,73
2011,Aylesbury Vale 008C,E01017719,855,667,188,88,34,66
2011,Aylesbury Vale 008D,E01017720,965,764,201,106,35,60
2011,Aylesbury Vale 008F,E01032958,1122,829,293,170,39,84
2011,Aylesbury Vale 008G,E01032959,1145,927,218,23,42,153
2011,Aylesbury Vale 009A,E01017651,1161,894,267,156,44,67
2011,Aylesbury Vale 009B,E01017652,1070,809,261,154,26,81
2011,Aylesbury Vale 009C,E01017657,1012,682,330,223,37,70
2011,Aylesbury Vale 009D,E01017658,1074,808,266,149,44,73
2011,Aylesbury Vale 009E,E01017701,1555,1212,343,161,62,120
2011,Aylesbury Vale 009F,E01017702,1074,810,264,146,23,95
2011,Aylesbury Vale 010A,E01017642,885,670,215,124,31,60
2011,Aylesbury Vale 010B,E01017643,990,752,238,145,25,68
2011,Aylesbury Vale 010C,E01017673,937,719,218,111,42,65
2011,Aylesbury Vale 010D,E01017674,1512,917,595,95,51,449
2011,Aylesbury Vale 011A,E01017659,1120,798,322,140,43,139
2011,Aylesbury Vale 011B,E01017660,1222,1038,184,78,29,77
2011,Aylesbury Vale 011C,E01017661,1112,833,279,101,48,130
2011,Aylesbury Vale 011D,E01017664,1125,954,171,81,29,61
2011,Aylesbury Vale 012A,E01017705,943,770,173,99,19,55
2011,Aylesbury Vale 012B,E01017706,963,745,218,58,38,122
2011,Aylesbury Vale 012C,E01017707,927,659,268,56,60,152
2011,Aylesbury Vale 012D,E01017708,1090,778,312,102,35,175
2011,Aylesbury Vale 013A,E01017665,1103,794,309,73,53,183
2011,Aylesbury Vale 013B,E01017666,1183,902,281,99,33,149
2011,Aylesbury Vale 013C,E01017667,911,667,244,79,44,121
2011,Aylesbury Vale 013D,E01017668,1123,884,239,113,33,93
2011,Aylesbury Vale 014A,E01017697,1089,921,168,96,22,50
2011,Aylesbury Vale 014B,E01017698,1036,805,231,84,43,104
2011,Aylesbury Vale 014C,E01017699,1164,719,445,61,27,357
2011,Aylesbury Vale 014D,E01017700,1078,811,267,195,27,45
2011,Aylesbury Vale 015B,E01017634,1186,965,221,54,41,126
2011,Aylesbury Vale 015C,E01017662,963,680,283,102,37,144
2011,Aylesbury Vale 015D,E01017663,1112,756,356,104,46,206
2011,Aylesbury Vale 015E,E01032955,928,729,199,97,27,75
2011,Aylesbury Vale 015F,E01032961,822,655,167,64,19,84
2011,Aylesbury Vale 016A,E01017653,1155,938,217,104,31,82
2011,Aylesbury Vale 016B,E01017654,1022,733,289,52,39,198
2011,Aylesbury Vale 016C,E01017655,1461,1235,226,90,43,93
2011,Aylesbury Vale 016E,E01032956,1231,1092,139,55,19,65
2011,Aylesbury Vale 016F,E01032957,1059,914,145,57,30,58
2011,Aylesbury Vale 016G,E01032962,1157,1009,148,58,20,70
2011,Aylesbury Vale 017A,E01017635,994,743,251,167,30,54
2011,Aylesbury Vale 017B,E01017636,1101,787,314,223,32,59
2011,Aylesbury Vale 017C,E01017637,949,760,189,92,36,61
2011,Aylesbury Vale 017D,E01017638,917,628,289,209,35,45
2011,Aylesbury Vale 017E,E01017639,1196,859,337,228,50,59
2011,Aylesbury Vale 017F,E01017640,1085,765,320,194,46,80
2011,Aylesbury Vale 018A,E01017709,1174,812,362,132,55,175
2011,Aylesbury Vale 018B,E01017710,1090,817,273,97,43,133
2011,Aylesbury Vale 018C,E01017711,1082,756,326,106,59,161
2011,Aylesbury Vale 018D,E01017712,1496,1129,367,80,59,228
2011,Aylesbury Vale 019A,E01017687,1529,1174,355,98,80,177
2011,Aylesbury Vale 019B,E01017688,911,756,155,78,18,59
2011,Aylesbury Vale 019C,E01017689,1041,842,199,108,28,63
2011,Aylesbury Vale 019D,E01017690,853,651,202,122,37,43
2011,Aylesbury Vale 019E,E01017691,1063,868,195,118,31,46
2011,Aylesbury Vale 019F,E01017692,1181,928,253,149,26,78
2011,Aylesbury Vale 020A,E01017721,1237,1050,187,91,11,85
2011,Aylesbury Vale 020B,E01017722,1162,974,188,67,37,84
2011,Aylesbury Vale 020C,E01017723,966,716,250,74,35,141
2011,Aylesbury Vale 020D,E01017724,961,731,230,68,40,122
2011,Aylesbury Vale 021A,E01017627,1167,931,236,121,29,86
2011,Aylesbury Vale 021B,E01017628,1203,861,342,200,53,89
2011,Aylesbury Vale 021C,E01017629,1185,856,329,216,42,71
2011,Aylesbury Vale 021D,E01017630,1110,775,335,227,37,71
2011,Aylesbury Vale 021E,E01017631,1154,864,290,180,37,73
2011,Aylesbury Vale 021F,E01017632,1191,869,322,198,43,81
2011,Aylesbury Vale 022A,E01017675,1066,773,293,214,20,59
2011,Aylesbury Vale 022B,E01017676,1039,722,317,235,25,57
2011,Aylesbury Vale 022C,E01017677,992,715,277,193,40,44
2011,Aylesbury Vale 022D,E01017678,1007,780,227,144,29,54
2011,Aylesbury Vale 022E,E01017679,1127,841,286,167,39,80
2011,Aylesbury Vale 022F,E01017680,704,514,190,119,14,57
2011,Aylesbury Vale 023A,E01017681,895,648,247,154,29,64
2011,Aylesbury Vale 023B,E01017682,833,570,263,164,44,55
2011,Aylesbury Vale 023C,E01017683,1285,985,300,175,44,81
2011,Aylesbury Vale 023D,E01017684,797,570,227,157,19,51
2011,Aylesbury Vale 024A,E01017726,765,492,273,196,15,62
2011,Aylesbury Vale 024B,E01017727,1106,785,321,199,47,75
2011,Aylesbury Vale 024C,E01017728,1527,1297,230,53,55,122
2011,Aylesbury Vale 024D,E01017729,1189,882,307,181,50,76
2011,Aylesbury Vale 024E,E01017730,1046,747,299,187,25,87
2011,Chiltern 001A,E01017750,1613,1177,436,252,73,111
2011,Chiltern 001B,E01017752,1605,1164,441,278,51,112
2011,Chiltern 001C,E01017766,1655,1137,518,299,73,146
2011,Chiltern 001D,E01017778,908,620,288,182,40,66
2011,Chiltern 002A,E01017747,970,716,254,105,45,104
2011,Chiltern 002B,E01017748,1274,904,370,126,63,181
2011,Chiltern 002C,E01017749,1194,868,326,216,45,65
2011,Chiltern 002D,E01017789,869,616,253,128,41,84
2011,Chiltern 002E,E01017790,923,647,276,107,47,122
2011,Chiltern 002F,E01017795,1564,1143,421,190,67,164
2011,Chiltern 003A,E01017769,1206,919,287,149,48,90
2011,Chiltern 003B,E01017771,1017,693,324,223,40,61
2011,Chiltern 003C,E01017780,948,706,242,126,37,79
2011,Chiltern 003D,E01017781,858,637,221,62,30,129
2011,Chiltern 004A,E01017770,1081,829,252,102,48,102
2011,Chiltern 004B,E01017791,1051,826,225,95,36,94
2011,Chiltern 004C,E01017792,1330,977,353,202,36,115
2011,Chiltern 004D,E01017793,1130,813,317,152,48,117
2011,Chiltern 005A,E01017768,1539,1106,433,263,58,112
2011,Chiltern 005B,E01017779,824,548,276,166,37,73
2011,Chiltern 005C,E01017785,1259,885,374,245,47,82
2011,Chiltern 005D,E01017786,1118,834,284,160,46,78
2011,Chiltern 005E,E01017787,1129,777,352,222,52,78
2011,Chiltern 005F,E01017788,1207,924,283,155,41,87
2011,Chiltern 006A,E01017741,1051,755,296,162,41,93
2011,Chiltern 006B,E01017742,1104,841,263,138,44,81
2011,Chiltern 006C,E01017743,1155,868,287,122,50,115
2011,Chiltern 006D,E01017763,1121,799,322,197,45,80
2011,Chiltern 006E,E01017764,1194,811,383,218,67,98
2011,Chiltern 006F,E01017765,1167,779,388,218,58,112
2011,Chiltern 007A,E01017739,909,660,249,144,45,60
2011,Chiltern 007B,E01017740,981,745,236,124,29,83
2011,Chiltern 007C,E01017744,1040,791,249,139,40,70
2011,Chiltern 007D,E01017745,1235,913,322,192,39,91
2011,Chiltern 007E,E01017746,1090,831,259,144,40,75
2011,Chiltern 008A,E01017762,1005,676,329,176,55,98
2011,Chiltern 008B,E01017775,1051,734,317,162,57,98
2011,Chiltern 008C,E01017776,1138,830,308,134,51,123
2011,Chiltern 008D,E01017777,1100,756,344,227,44,73
2011,Chiltern 010A,E01017759,1225,873,352,204,43,105
2011,Chiltern 010B,E01017760,1166,784,382,228,47,107
2011,Chiltern 010C,E01017761,1452,1069,383,222,55,106
2011,Chiltern 010D,E01017794,1626,1183,443,238,59,146
2011,Chiltern 011A,E01017754,1100,742,358,204,44,110
2011,Chiltern 011B,E01017755,1099,832,267,149,42,76
2011,Chiltern 011C,E01017756,1041,727,314,192,46,76
2011,Chiltern 011D,E01017757,832,605,227,138,30,59
2011,Chiltern 011E,E01017758,908,590,318,128,50,140
2011,Chiltern 012A,E01017751,1511,1044,467,229,100,138
2011,Chiltern 012B,E01017753,865,644,221,113,35,73
2011,Chiltern 012C,E01017767,1497,1120,377,188,57,132
2011,Chiltern 013A,E01017773,1077,774,303,195,36,72
2011,Chiltern 013B,E01017774,919,627,292,188,38,66
2011,Chiltern 013C,E01017782,1001,641,360,220,43,97
2011,Chiltern 013D,E01017783,1057,778,279,160,41,78
2011,Chiltern 013E,E01017784,1149,795,354,194,62,98
2011,Chiltern 013F,E01032609,905,660,245,146,33,66
2011,South Bucks 001A,E01017796,1222,851,371,157,101,113
2011,South Bucks 001B,E01017797,1044,685,359,171,66,122
2011,South Bucks 001C,E01017798,1198,742,456,254,66,136
2011,South Bucks 001D,E01017799,1350,1024,326,162,47,117
2011,South Bucks 001E,E01017800,1254,995,259,107,36,116
2011,South Bucks 001F,E01017801,1105,788,317,150,62,105
2011,South Bucks 001G,E01017802,1089,798,291,157,34,100
2011,South Bucks 002A,E01017818,1375,1004,371,159,76,136
2011,South Bucks 002B,E01017819,1081,725,356,148,76,132
2011,South Bucks 002C,E01017820,1019,710,309,176,32,101
2011,South Bucks 002D,E01017821,1162,737,425,166,79,180
2011,South Bucks 002E,E01017822,1382,951,431,195,90,146
2011,South Bucks 003A,E01017810,1155,786,369,233,31,105
2011,South Bucks 003B,E01017811,847,564,283,180,38,65
2011,South Bucks 003C,E01017812,1209,915,294,132,52,110
2011,South Bucks 003D,E01017813,1441,1042,399,222,66,111
2011,South Bucks 004A,E01017815,1277,889,388,216,65,107
2011,South Bucks 004B,E01017816,1195,885,310,177,45,88
2011,South Bucks 004C,E01017817,1342,989,353,197,61,95
2011,South Bucks 004D,E01017823,972,710,262,142,33,87
2011,South Bucks 005A,E01017830,1336,1000,336,189,44,103
2011,South Bucks 005B,E01017831,1189,831,358,214,51,93
2011,South Bucks 005C,E01017832,1242,912,330,153,54,123
2011,South Bucks 005D,E01017834,1151,763,388,174,108,106
2011,South Bucks 005E,E01017835,1325,949,376,225,44,107
2011,South Bucks 006A,E01017803,934,640,294,184,32,78
2011,South Bucks 006B,E01017806,1232,894,338,197,64,77
2011,South Bucks 006C,E01017814,1147,856,291,184,37,70
2011,South Bucks 006D,E01017833,1301,984,317,223,27,67
2011,South Bucks 007A,E01017804,1096,793,303,180,51,72
2011,South Bucks 007B,E01017805,1313,1013,300,131,45,124
2011,South Bucks 007C,E01017807,1100,850,250,143,34,73
2011,South Bucks 007D,E01017808,1090,816,274,144,27,103
2011,South Bucks 007E,E01017809,1092,841,251,107,34,110
2011,South Bucks 008A,E01017824,1255,952,303,169,45,89
2011,South Bucks 008B,E01017825,1277,980,297,138,73,86
2011,South Bucks 008C,E01017826,1062,774,288,141,48,99
2011,South Bucks 008D,E01017827,1256,924,332,181,40,111
2011,South Bucks 008E,E01017828,1164,883,281,153,43,85
2011,South Bucks 008F,E01017829,1521,1136,385,183,85,117
2011,Wycombe 001A,E01017929,961,692,269,143,30,96
2011,Wycombe 001B,E01017930,1243,890,353,227,46,80
2011,Wycombe 001C,E01017931,1029,751,278,156,38,84
2011,Wycombe 001D,E01017932,1157,787,370,243,35,92
2011,Wycombe 001E,E01017933,1164,800,364,202,54,108
2011,Wycombe 002A,E01017885,1254,886,368,236,44,88
2011,Wycombe 002B,E01017886,1068,726,342,213,47,82
2011,Wycombe 002C,E01017887,808,575,233,152,27,54
2011,Wycombe 002D,E01017888,1216,888,328,178,61,89
2011,Wycombe 003A,E01017869,974,697,277,182,39,56
2011,Wycombe 003B,E01017870,899,648,251,161,43,47
2011,Wycombe 003C,E01017871,1152,794,358,243,52,63
2011,Wycombe 003D,E01017872,1161,805,356,249,32,75
2011,Wycombe 003E,E01017873,1055,848,207,133,20,54
2011,Wycombe 003F,E01017874,787,587,200,106,37,57
2011,Wycombe 004A,E01017915,988,746,242,139,37,66
2011,Wycombe 004B,E01017916,923,697,226,149,29,48
2011,Wycombe 004C,E01017917,1098,862,236,130,31,75
2011,Wycombe 004D,E01017918,1102,816,286,175,40,71
2011,Wycombe 006A,E01017857,1060,733,327,106,65,156
2011,Wycombe 006B,E01017858,1322,971,351,42,211,98
2011,Wycombe 006C,E01017859,1060,751,309,168,63,78
2011,Wycombe 006D,E01017860,1013,748,265,106,54,105
2011,Wycombe 006E,E01017861,1163,850,313,179,46,88
2011,Wycombe 006F,E01017862,1334,1008,326,176,51,99
2011,Wycombe 006G,E01017863,1244,963,281,164,53,64
2011,Wycombe 007A,E01017842,2249,1726,523,290,75,158
2011,Wycombe 007B,E01017853,1017,823,194,96,37,61
2011,Wycombe 007C,E01017854,928,710,218,123,39,56
2011,Wycombe 007D,E01017878,1924,1414,510,289,61,160
2011,Wycombe 008A,E01017920,900,700,200,97,45,58
2011,Wycombe 008B,E01017921,1395,1036,359,118,146,95
2011,Wycombe 008C,E01017922,1228,908,320,121,75,124
2011,Wycombe 008D,E01017923,1204,889,315,63,131,121
2011,Wycombe 008E,E01017924,1121,815,306,143,76,87
2011,Wycombe 009A,E01017937,1093,811,282,147,58,77
2011,Wycombe 009B,E01017938,987,715,272,159,48,65
2011,Wycombe 009C,E01017940,1177,966,211,118,27,66
2011,Wycombe 009D,E01017942,1083,765,318,188,47,83
2011,Wycombe 010A,E01017850,990,717,273,54,62,157
2011,Wycombe 010B,E01017851,1294,973,321,92,93,136
2011,Wycombe 010C,E01017852,1759,1164,595,141,154,300
2011,Wycombe 010D,E01017919,1063,792,271,96,101,74
2011,Wycombe 011A,E01017925,1516,1173,343,92,106,145
2011,Wycombe 011B,E01017926,1020,752,268,69,44,155
2011,Wycombe 011C,E01017927,1076,784,292,142,43,107
2011,Wycombe 011D,E01017928,1027,724,303,170,45,88
2011,Wycombe 012A,E01017911,1190,913,277,96,40,141
2011,Wycombe 012B,E01017912,1056,786,270,107,60,103
2011,Wycombe 012C,E01017913,1332,1072,260,59,65,136
2011,Wycombe 012D,E01017914,1020,798,222,95,40,87
2011,Wycombe 013A,E01017903,1180,787,393,73,110,210
2011,Wycombe 013B,E01017904,1310,952,358,57,96,205
2011,Wycombe 013C,E01017905,1721,1238,483,71,173,239
2011,Wycombe 013D,E01017906,1252,780,472,60,104,308
2011,Wycombe 013E,E01017907,1216,851,365,87,66,212
2011,Wycombe 014A,E01017899,1150,838,312,135,35,142
2011,Wycombe 014B,E01017900,977,722,255,79,58,118
2011,Wycombe 014C,E01017901,850,633,217,68,35,114
2011,Wycombe 014D,E01017902,1117,827,290,83,59,148
2011,Wycombe 015A,E01017836,1196,899,297,80,84,133
2011,Wycombe 015B,E01017837,1775,1220,555,92,331,132
2011,Wycombe 015C,E01017838,1149,819,330,100,101,129
2011,Wycombe 015D,E01017839,1205,725,480,120,296,64
2011,Wycombe 015E,E01017840,1344,1000,344,140,67,137
2011,Wycombe 015F,E01017841,1072,814,258,143,63,52
2011,Wycombe 016A,E01017908,1857,1469,388,136,50,202
2011,Wycombe 016B,E01017909,1630,1352,278,90,45,143
2011,Wycombe 016C,E01017910,1859,1430,429,174,114,141
2011,Wycombe 016D,E01017941,1087,864,223,126,19,78
2011,Wycombe 017A,E01017843,1140,785,355,225,47,83
2011,Wycombe 017B,E01017844,1158,817,341,147,57,137
2011,Wycombe 017C,E01017845,1268,925,343,133,51,159
2011,Wycombe 017D,E01017855,1025,751,274,158,28,88
2011,Wycombe 017E,E01017856,1008,720,288,125,34,129
2011,Wycombe 018A,E01017864,967,684,283,186,40,57
2011,Wycombe 018B,E01017865,1078,771,307,191,50,66
2011,Wycombe 018C,E01017867,1044,763,281,142,37,102
2011,Wycombe 018D,E01017868,1097,789,308,201,35,72
2011,Wycombe 019A,E01017934,1270,977,293,127,40,126
2011,Wycombe 019B,E01017935,1439,1179,260,153,22,85
2011,Wycombe 019C,E01017936,1180,840,340,194,56,90
2011,Wycombe 019D,E01017939,1031,814,217,112,34,71
2011,Wycombe 020A,E01017866,1066,766,300,204,44,52
2011,Wycombe 020B,E01017875,1052,798,254,128,36,90
2011,Wycombe 020C,E01017876,1487,1072,415,248,55,112
2011,Wycombe 020D,E01017877,1167,813,354,231,52,71
2011,Wycombe 021A,E01017846,967,670,297,163,35,99
2011,Wycombe 021B,E01017847,1056,786,270,173,34,63
2011,Wycombe 021C,E01017848,877,616,261,182,29,50
2011,Wycombe 021D,E01017849,1093,785,308,189,39,80
2011,Wycombe 022A,E01017889,957,746,211,108,33,70
2011,Wycombe 022B,E01017890,935,693,242,160,26,56
2011,Wycombe 022C,E01017891,983,722,261,167,33,61
2011,Wycombe 022D,E01017892,1028,688,340,221,43,76
2011,Wycombe 022E,E01017893,1118,824,294,170,37,87
2011,Wycombe 022F,E01017894,1095,772,323,228,27,68
2011,Wycombe 023A,E01017895,921,686,235,120,39,76
2011,Wycombe 023B,E01017896,973,698,275,177,36,62
2011,Wycombe 023C,E01017897,1158,931,227,120,26,81
2011,Wycombe 023D,E01017898,939,756,183,77,30,76
2011,Wycombe 024A,E01017880,1026,748,278,194,28,56
2011,Wycombe 024B,E01017881,1263,892,371,242,54,75
2011,Wycombe 024C,E01017882,1140,842,298,175,41,82
2011,Wycombe 024D,E01017883,1178,868,310,162,53,95
2011,Wycombe 024E,E01017884,985,794,191,124,23,44
2011,Wycombe 024F,E01032610,1188,869,319,219,38,62
2011,Eastbourne 001A,E01020924,1036,742,294,156,42,96
2011,Eastbourne 001B,E01020925,1117,752,365,100,60,205
2011,Eastbourne 001C,E01020927,1076,753,323,111,48,164
2011,Eastbourne 001D,E01020928,1084,668,416,258,26,132
2011,Eastbourne 001E,E01020930,1081,793,288,60,80,148
2011,Eastbourne 002A,E01020917,1046,722,324,103,53,168
2011,Eastbourne 002B,E01020918,1132,809,323,142,51,130
2011,Eastbourne 002C,E01020919,1076,774,302,125,48,129
2011,Eastbourne 002D,E01020923,1002,675,327,95,35,197
2011,Eastbourne 002E,E01020949,1142,768,374,238,24,112
2011,Eastbourne 003A,E01020926,1158,847,311,165,67,79
2011,Eastbourne 003B,E01020929,1093,684,409,182,36,191
2011,Eastbourne 003C,E01020955,1035,688,347,163,29,155
2011,Eastbourne 003D,E01020956,1066,588,478,379,16,83
2011,Eastbourne 003E,E01020957,1013,643,370,225,37,108
2011,Eastbourne 004A,E01020920,1055,614,441,204,44,193
2011,Eastbourne 004B,E01020921,1006,727,279,148,41,90
2011,Eastbourne 004C,E01020922,1037,707,330,137,39,154
2011,Eastbourne 004D,E01020945,1315,807,508,356,51,101
2011,Eastbourne 004E,E01020950,1102,666,436,294,52,90
2011,Eastbourne 006A,E01020940,982,686,296,190,49,57
2011,Eastbourne 006B,E01020941,1152,798,354,133,57,164
2011,Eastbourne 006C,E01020942,1119,816,303,175,63,65
2011,Eastbourne 006D,E01020946,1179,777,402,283,47,72
2011,Eastbourne 006E,E01020947,1062,673,389,224,45,120
2011,Eastbourne 007A,E01020914,1426,1101,325,128,90,107
2011,Eastbourne 007B,E01020915,1160,792,368,182,56,130
2011,Eastbourne 007C,E01020952,1242,894,348,171,44,133
2011,Eastbourne 007D,E01020953,1120,862,258,140,37,81
2011,Eastbourne 007E,E01020954,1228,946,282,132,65,85
2011,Eastbourne 008A,E01020948,965,611,354,265,21,68
2011,Eastbourne 008B,E01020963,1173,868,305,152,58,95
2011,Eastbourne 008C,E01020965,1409,1056,353,166,69,118
2011,Eastbourne 008D,E01020966,1152,790,362,197,44,121
2011,Eastbourne 009A,E01020938,1094,798,296,145,50,101
2011,Eastbourne 009B,E01020939,1094,823,271,149,53,69
2011,Eastbourne 009C,E01020943,1162,850,312,173,55,84
2011,Eastbourne 009D,E01020964,1127,802,325,231,37,57
2011,Eastbourne 009E,E01020967,1140,688,452,296,49,107
2011,Eastbourne 010A,E01020910,1301,863,438,134,123,181
2011,Eastbourne 010B,E01020911,1671,1162,509,109,182,218
2011,Eastbourne 010C,E01020912,1693,1184,509,101,183,225
2011,Eastbourne 010D,E01020916,1274,962,312,114,78,120
2011,Eastbourne 011A,E01020935,1441,1088,353,150,77,126
2011,Eastbourne 011B,E01020936,1135,695,440,288,91,61
2011,Eastbourne 011C,E01020937,1143,729,414,164,157,93
2011,Eastbourne 011D,E01020968,1201,823,378,177,107,94
2011,Eastbourne 012A,E01020931,1263,703,560,274,218,68
2011,Eastbourne 012B,E01020932,755,370,385,289,15,81
2011,Eastbourne 012C,E01020933,709,393,316,180,92,44
2011,Eastbourne 012D,E01020934,838,494,344,243,37,64
2011,Eastbourne 012E,E01020944,1057,692,365,215,59,91
2011,Eastbourne 013A,E01020913,1518,1010,508,250,40,218
2011,Eastbourne 013B,E01020951,1082,805,277,136,51,90
2011,Eastbourne 013C,E01020959,970,680,290,169,29,92
2011,Eastbourne 013D,E01020961,986,565,421,313,26,82
2011,Eastbourne 013E,E01020962,1449,987,462,332,31,99
2011,Eastbourne 014A,E01020960,1856,1302,554,334,60,160
2011,Eastbourne 014B,E01032831,1226,818,408,294,26,88
2011,Eastbourne 014C,E01032832,1140,725,415,205,54,156
2011,Eastbourne 014D,E01032833,1107,818,289,185,28,76
2011,Hastings 001A,E01020969,1107,711,396,251,41,104
2011,Hastings 001B,E01020970,2009,1503,506,279,93,134
2011,Hastings 001C,E01020971,1488,1010,478,233,72,173
2011,Hastings 001D,E01020987,1318,1074,244,108,51,85
2011,Hastings 002A,E01020974,1055,658,397,232,48,117
2011,Hastings 002B,E01020986,1089,748,341,214,37,90
2011,Hastings 002C,E01020988,1198,802,396,286,30,80
2011,Hastings 002D,E01021007,1064,652,412,304,33,75
2011,Hastings 002E,E01021008,1076,717,359,242,33,84
2011,Hastings 002F,E01021009,1373,913,460,310,50,100
2011,Hastings 003A,E01020993,968,561,407,126,64,217
2011,Hastings 003B,E01020994,1045,641,404,148,43,213
2011,Hastings 003C,E01020995,1019,624,395,133,60,202
2011,Hastings 003D,E01020996,1270,879,391,128,59,204
2011,Hastings 003E,E01021019,1164,623,541,232,52,257
2011,Hastings 004A,E01021004,1272,823,449,254,47,148
2011,Hastings 004B,E01021005,1116,648,468,147,49,272
2011,Hastings 004C,E01021006,1357,968,389,183,50,156
2011,Hastings 004D,E01021013,1332,1004,328,130,54,144
2011,Hastings 005A,E01020972,1056,537,519,123,49,347
2011,Hastings 005B,E01020973,1192,821,371,172,38,161
2011,Hastings 005C,E01020977,1171,828,343,113,27,203
2011,Hastings 005D,E01021015,1068,613,455,106,54,295
2011,Hastings 006A,E01021010,1169,827,342,202,52,88
2011,Hastings 006B,E01021011,1109,836,273,101,48,124
2011,Hastings 006C,E01021012,1186,831,355,167,30,158
2011,Hastings 006D,E01021020,1240,746,494,217,47,230
2011,Hastings 006E,E01021021,1394,982,412,208,57,147
2011,Hastings 007A,E01021000,1095,802,293,146,44,103
2011,Hastings 007B,E01021001,904,662,242,131,31,80
2011,Hastings 007C,E01021002,1062,727,335,178,47,110
2011,Hastings 007D,E01021003,1257,855,402,237,40,125
2011,Hastings 007E,E01021014,1320,887,433,126,83,224
2011,Hastings 008A,E01020975,1316,900,416,192,60,164
2011,Hastings 008B,E01020976,1436,1008,428,238,58,132
2011,Hastings 008C,E01020990,1214,830,384,116,57,211
2011,Hastings 008D,E01020991,1025,733,292,126,47,119
2011,Hastings 008E,E01020992,1416,962,454,144,65,245
2011,Hastings 009A,E01020978,1534,1087,447,136,64,247
2011,Hastings 009B,E01020979,1479,975,504,151,48,305
2011,Hastings 009C,E01020980,1209,835,374,107,58,209
2011,Hastings 009D,E01020981,1203,848,355,144,62,149
2011,Hastings 010A,E01020997,1126,790,336,157,44,135
2011,Hastings 010B,E01020998,1337,939,398,174,60,164
2011,Hastings 010C,E01020999,1214,780,434,274,36,124
2011,Hastings 010D,E01021016,1211,820,391,186,31,174
2011,Hastings 010E,E01021017,1241,926,315,156,39,120
2011,Hastings 010F,E01021018,1439,1069,370,196,67,107
2011,Hastings 011A,E01020982,1419,922,497,131,71,295
2011,Hastings 011B,E01020983,1253,745,508,169,81,258
2011,Hastings 011C,E01020984,1594,1131,463,180,42,241
2011,Hastings 011D,E01020985,1429,1021,408,182,56,170
2011,Hastings 011E,E01020989,1398,925,473,143,40,290
2011,Lewes 001A,E01021022,1477,1050,427,224,56,147
2011,Lewes 001B,E01021024,899,644,255,128,30,97
2011,Lewes 001C,E01021025,1365,975,390,208,53,129
2011,Lewes 001D,E01021052,903,658,245,166,35,44
2011,Lewes 001E,E01021053,851,584,267,162,32,73
2011,Lewes 002A,E01021023,1454,1040,414,217,72,125
2011,Lewes 002B,E01021026,1498,996,502,312,55,135
2011,Lewes 002C,E01021032,1451,1024,427,256,76,95
2011,Lewes 002D,E01021067,857,665,192,107,36,49
2011,Lewes 002E,E01021068,873,625,248,97,82,69
2011,Lewes 003A,E01021033,1235,907,328,168,45,115
2011,Lewes 003B,E01021034,993,759,234,115,47,72
2011,Lewes 003C,E01021035,1308,1034,274,144,52,78
2011,Lewes 003D,E01021036,1037,740,297,175,42,80
2011,Lewes 003E,E01021037,1149,815,334,118,59,157
2011,Lewes 003F,E01021038,1274,970,304,135,67,102
2011,Lewes 004A,E01021054,1098,841,257,158,34,65
2011,Lewes 004B,E01021055,1177,794,383,248,27,108
2011,Lewes 004C,E01021056,1183,799,384,262,46,76
2011,Lewes 004D,E01021057,1088,797,291,145,48,98
2011,Lewes 005A,E01021039,1022,739,283,140,68,75
2011,Lewes 005B,E01021040,1301,811,490,140,41,309
2011,Lewes 005C,E01021041,1051,678,373,219,58,96
2011,Lewes 005D,E01021042,925,690,235,128,45,62
2011,Lewes 005E,E01021043,1109,810,299,129,55,115
2011,Lewes 006A,E01021027,1101,767,334,211,35,88
2011,Lewes 006B,E01021028,1194,922,272,146,43,83
2011,Lewes 006C,E01021029,1128,845,283,182,29,72
2011,Lewes 006D,E01021030,838,603,235,149,31,55
2011,Lewes 006E,E01021031,1063,758,305,184,23,98
2011,Lewes 007A,E01021061,1155,857,298,144,49,105
2011,Lewes 007B,E01021063,1248,906,342,191,54,97
2011,Lewes 007C,E01021064,1171,799,372,245,23,104
2011,Lewes 007D,E01021065,847,574,273,176,19,78
2011,Lewes 007E,E01021066,1106,743,363,210,32,121
2011,Lewes 008A,E01021045,1281,802,479,349,25,105
2011,Lewes 008B,E01021046,1109,808,301,182,19,100
2011,Lewes 008C,E01021047,1058,751,307,172,29,106
2011,Lewes 008D,E01021048,1195,883,312,151,44,117
2011,Lewes 009A,E01021044,1309,978,331,110,49,172
2011,Lewes 009B,E01021049,1070,780,290,105,30,155
2011,Lewes 009C,E01021050,997,716,281,122,37,122
2011,Lewes 009D,E01021051,900,642,258,134,32,92
2011,Lewes 010A,E01021058,1307,901,406,204,33,169
2011,Lewes 010B,E01021059,1059,712,347,215,30,102
2011,Lewes 010C,E01021060,1183,714,469,283,37,149
2011,Lewes 010D,E01021062,1054,715,339,124,52,163
2011,Lewes 011A,E01021069,1111,686,425,291,46,88
2011,Lewes 011B,E01021075,1213,848,365,261,33,71
2011,Lewes 011C,E01021077,1022,640,382,251,43,88
2011,Lewes 011D,E01021081,1067,687,380,283,27,70
2011,Lewes 011E,E01021082,1140,732,408,336,22,50
2011,Lewes 011F,E01021083,971,594,377,274,40,63
2011,Lewes 012A,E01021072,1016,569,447,375,24,48
2011,Lewes 012B,E01021073,1006,644,362,244,38,80
2011,Lewes 012C,E01021074,1120,710,410,265,31,114
2011,Lewes 012D,E01021076,1332,901,431,225,51,155
2011,Lewes 012E,E01021078,906,556,350,271,31,48
2011,Lewes 013A,E01021070,1109,786,323,180,33,110
2011,Lewes 013B,E01021071,1284,876,408,225,33,150
2011,Lewes 013C,E01021079,1026,678,348,219,40,89
2011,Lewes 013D,E01021080,995,666,329,194,37,98
2011,Rother 001A,E01021132,1011,585,426,163,44,219
2011,Rother 001B,E01021133,1217,864,353,176,55,122
2011,Rother 001C,E01021134,1082,802,280,148,36,96
2011,Rother 001D,E01021139,860,583,277,155,29,93
2011,Rother 001E,E01021140,1322,937,385,211,44,130
2011,Rother 001F,E01021141,1083,755,328,163,48,117
2011,Rother 002A,E01021103,1102,699,403,246,35,122
2011,Rother 002B,E01021114,1084,685,399,246,31,122
2011,Rother 002C,E01021115,1149,737,412,306,38,68
2011,Rother 002D,E01021116,1106,742,364,214,35,115
2011,Rother 003A,E01021098,1214,825,389,234,46,109
2011,Rother 003B,E01021099,1236,822,414,229,46,139
2011,Rother 003C,E01021100,1317,913,404,212,74,118
2011,Rother 003D,E01021104,996,663,333,212,35,86
2011,Rother 003E,E01021105,914,566,348,190,73,85
2011,Rother 004A,E01021101,1206,717,489,328,44,117
2011,Rother 004B,E01021102,1196,806,390,221,42,127
2011,Rother 004C,E01021117,1168,780,388,244,27,117
2011,Rother 004D,E01021118,1146,785,361,233,32,96
2011,Rother 004E,E01021119,740,450,290,149,27,114
2011,Rother 005A,E01021087,1208,789,419,280,43,96
2011,Rother 005B,E01021088,1127,720,407,286,26,95
2011,Rother 005C,E01021089,1107,725,382,250,39,93
2011,Rother 005D,E01021109,1289,766,523,303,120,100
2011,Rother 005E,E01021110,1638,906,732,550,44,138
2011,Rother 006A,E01021084,1269,810,459,233,92,134
2011,Rother 006B,E01021085,1176,829,347,211,52,84
2011,Rother 006C,E01021086,1168,756,412,250,57,105
2011,Rother 006D,E01021096,961,626,335,173,47,115
2011,Rother 006E,E01021097,971,645,326,203,52,71
2011,Rother 007A,E01021111,655,375,280,191,22,67
2011,Rother 007B,E01021113,970,698,272,153,36,83
2011,Rother 007C,E01021131,1169,782,387,118,79,190
2011,Rother 007D,E01021135,1195,744,451,149,49,253
2011,Rother 007E,E01021136,846,476,370,127,30,213
2011,Rother 007F,E01021137,1024,660,364,176,39,149
2011,Rother 008A,E01021112,1008,614,394,237,83,74
2011,Rother 008B,E01021120,761,400,361,293,15,53
2011,Rother 008C,E01021126,998,612,386,224,34,128
2011,Rother 008D,E01021127,1098,650,448,240,41,167
2011,Rother 008E,E01021128,1271,803,468,309,41,118
2011,Rother 009A,E01021093,1033,588,445,337,37,71
2011,Rother 009B,E01021095,870,447,423,353,18,52
2011,Rother 009C,E01021123,1036,581,455,355,26,74
2011,Rother 009D,E01021124,1077,609,468,366,27,75
2011,Rother 009E,E01021125,822,486,336,263,25,48
2011,Rother 009F,E01021129,1251,741,510,376,37,97
2011,Rother 009G,E01021138,756,438,318,219,31,68
2011,Rother 010A,E01021094,905,510,395,311,25,59
2011,Rother 010B,E01021106,995,497,498,391,32,75
2011,Rother 010C,E01021107,1018,554,464,378,21,65
2011,Rother 010D,E01021108,1021,724,297,183,38,76
2011,Rother 010E,E01021130,976,633,343,219,40,84
2011,Rother 011A,E01021090,1199,863,336,153,34,149
2011,Rother 011B,E01021091,1391,938,453,242,20,191
2011,Rother 011C,E01021092,1350,824,526,270,41,215
2011,Rother 011D,E01021121,1141,727,414,281,30,103
2011,Rother 011E,E01021122,962,597,365,230,22,113
2011,Wealden 001A,E01021167,1574,1122,452,241,67,144
2011,Wealden 001B,E01021168,1231,908,323,181,47,95
2011,Wealden 001C,E01021169,968,707,261,126,69,66
2011,Wealden 001D,E01021186,880,640,240,140,29,71
2011,Wealden 002A,E01021171,1441,1041,400,184,71,145
2011,Wealden 002B,E01021172,1231,884,347,191,43,113
2011,Wealden 002C,E01021173,1006,734,272,146,38,88
2011,Wealden 002D,E01021218,848,600,248,161,25,62
2011,Wealden 003A,E01021156,1212,926,286,161,27,98
2011,Wealden 003B,E01021157,1330,899,431,299,42,90
2011,Wealden 003C,E01021158,1559,1145,414,246,57,111
2011,Wealden 004A,E01021159,1668,1076,592,427,41,124
2011,Wealden 004B,E01021160,1111,733,378,237,21,120
2011,Wealden 004C,E01021161,1143,862,281,176,27,78
2011,Wealden 004D,E01021162,1160,816,344,245,35,64
2011,Wealden 005A,E01021202,772,543,229,138,47,44
2011,Wealden 005B,E01021203,1080,730,350,211,48,91
2011,Wealden 005C,E01021229,1238,860,378,191,74,113
2011,Wealden 005D,E01021230,1228,817,411,213,63,135
2011,Wealden 005E,E01021231,1198,852,346,186,51,109
2011,Wealden 006A,E01021151,1305,1003,302,173,44,85
2011,Wealden 006B,E01021152,1230,814,416,126,34,256
2011,Wealden 006C,E01021153,1432,1125,307,169,30,108
2011,Wealden 006D,E01021154,1074,783,291,148,36,107
2011,Wealden 006E,E01021155,882,715,167,96,24,47
2011,Wealden 007A,E01021163,1537,1063,474,284,54,136
2011,Wealden 007B,E01021164,1333,962,371,181,42,148
2011,Wealden 007C,E01021187,1078,750,328,192,34,102
2011,Wealden 008A,E01021144,1315,936,379,228,50,101
2011,Wealden 008B,E01021145,1472,974,498,307,47,144
2011,Wealden 008C,E01021170,2063,1461,602,378,72,152
2011,Wealden 008D,E01021217,900,628,272,170,29,73
2011,Wealden 009A,E01021219,1020,741,279,202,23,54
2011,Wealden 009B,E01021220,1143,796,347,225,20,102
2011,Wealden 009C,E01021223,830,641,189,121,20,48
2011,Wealden 009D,E01021224,1038,742,296,132,29,135
2011,Wealden 009E,E01021225,1123,836,287,175,32,80
2011,Wealden 009F,E01021226,994,791,203,87,34,82
2011,Wealden 010A,E01021150,858,597,261,147,27,87
2011,Wealden 010B,E01021191,1166,842,324,222,28,74
2011,Wealden 010C,E01021192,1172,882,290,182,40,68
2011,Wealden 010D,E01021193,1222,844,378,177,59,142
2011,Wealden 010E,E01021194,1106,848,258,133,55,70
2011,Wealden 011A,E01021149,944,659,285,159,36,90
2011,Wealden 011B,E01021189,1048,736,312,163,41,108
2011,Wealden 011C,E01021190,1148,812,336,222,25,89
2011,Wealden 011D,E01021200,772,540,232,122,30,80
2011,Wealden 011E,E01021201,1080,761,319,212,32,75
2011,Wealden 012A,E01021221,946,722,224,109,32,83
2011,Wealden 012B,E01021222,1113,863,250,132,37,81
2011,Wealden 012C,E01021227,1226,962,264,144,45,75
2011,Wealden 012D,E01021228,1109,864,245,130,40,75
2011,Wealden 013A,E01021146,1243,856,387,220,44,123
2011,Wealden 013B,E01021147,1244,898,346,207,45,94
2011,Wealden 013C,E01021148,1138,813,325,165,53,107
2011,Wealden 013D,E01021165,872,643,229,133,28,68
2011,Wealden 014A,E01021188,839,597,242,164,29,49
2011,Wealden 014B,E01021198,1050,753,297,163,38,96
2011,Wealden 014C,E01021199,986,692,294,197,34,63
2011,Wealden 014D,E01021204,860,586,274,157,25,92
2011,Wealden 014E,E01021205,945,670,275,182,33,60
2011,Wealden 015A,E01021174,1166,850,316,194,46,76
2011,Wealden 015B,E01021175,1021,699,322,227,26,69
2011,Wealden 015C,E01021176,935,634,301,203,28,70
2011,Wealden 015D,E01021177,783,535,248,140,17,91
2011,Wealden 016A,E01021180,923,638,285,193,22,70
2011,Wealden 016B,E01021181,897,627,270,172,27,71
2011,Wealden 016C,E01021182,1075,739,336,236,31,69
2011,Wealden 016D,E01021183,918,606,312,108,37,167
2011,Wealden 017A,E01021178,903,565,338,159,36,143
2011,Wealden 017B,E01021179,1024,670,354,133,45,176
2011,Wealden 017C,E01021184,1011,669,342,235,25,82
2011,Wealden 017D,E01021185,989,665,324,150,26,148
2011,Wealden 018A,E01021142,731,371,360,296,15,49
2011,Wealden 018B,E01021143,846,557,289,192,25,72
2011,Wealden 018C,E01021166,1639,996,643,467,54,122
2011,Wealden 018D,E01021195,1425,949,476,284,44,148
2011,Wealden 018E,E01021196,1408,987,421,275,41,105
2011,Wealden 018F,E01021197,1479,1036,443,184,189,70
2011,Wealden 019A,E01021212,1304,847,457,324,27,106
2011,Wealden 019B,E01021213,1273,892,381,215,38,128
2011,Wealden 019C,E01021214,1029,689,340,245,28,67
2011,Wealden 019D,E01021215,823,534,289,207,16,66
2011,Wealden 019E,E01021216,812,533,279,177,17,85
2011,Wealden 020A,E01021206,1013,693,320,199,32,89
2011,Wealden 020B,E01021207,972,607,365,242,24,99
2011,Wealden 020C,E01021208,1362,1021,341,201,50,90
2011,Wealden 020D,E01021209,1137,757,380,273,36,71
2011,Wealden 020E,E01021210,1103,845,258,153,37,68
2011,Wealden 020F,E01021211,1056,579,477,368,18,91
2011,Wealden 021A,E01021232,1116,720,396,305,24,67
2011,Wealden 021B,E01021233,994,654,340,248,23,69
2011,Wealden 021C,E01021234,997,677,320,245,29,46
2011,Wealden 021D,E01021235,948,608,340,259,25,56
2011,Wealden 021E,E01021236,1033,669,364,246,27,91
2011,Basingstoke and Deane 001A,E01022553,1093,802,291,192,24,75
2011,Basingstoke and Deane 001B,E01022554,1212,920,292,197,22,73
2011,Basingstoke and Deane 001C,E01022555,1100,820,280,174,34,72
2011,Basingstoke and Deane 001D,E01022556,1153,822,331,136,39,156
2011,Basingstoke and Deane 001E,E01022560,911,718,193,105,22,66
2011,Basingstoke and Deane 002A,E01022493,983,723,260,156,32,72
2011,Basingstoke and Deane 002B,E01022536,976,675,301,203,31,67
2011,Basingstoke and Deane 002C,E01022537,973,717,256,197,27,32
2011,Basingstoke and Deane 002D,E01022557,1106,841,265,159,27,79
2011,Basingstoke and Deane 002E,E01022558,953,784,169,75,26,68
2011,Basingstoke and Deane 002F,E01022559,966,731,235,151,38,46
2011,Basingstoke and Deane 003A,E01022488,839,644,195,86,27,82
2011,Basingstoke and Deane 003B,E01022489,1046,765,281,179,29,73
2011,Basingstoke and Deane 003C,E01022499,1082,822,260,158,34,68
2011,Basingstoke and Deane 003D,E01022500,1008,753,255,126,37,92
2011,Basingstoke and Deane 003E,E01022513,1155,845,310,167,32,111
2011,Basingstoke and Deane 004A,E01022472,908,617,291,191,18,82
2011,Basingstoke and Deane 004B,E01022473,908,700,208,121,28,59
2011,Basingstoke and Deane 004C,E01022520,1228,911,317,180,37,100
2011,Basingstoke and Deane 004D,E01022521,1254,959,295,186,30,79
2011,Basingstoke and Deane 004E,E01022522,1176,902,274,140,40,94
2011,Basingstoke and Deane 005A,E01022490,1300,1003,297,183,32,82
2011,Basingstoke and Deane 005B,E01022491,1335,1063,272,111,32,129
2011,Basingstoke and Deane 005C,E01022492,1208,895,313,177,43,93
2011,Basingstoke and Deane 005D,E01022546,998,755,243,142,31,70
2011,Basingstoke and Deane 005E,E01022547,1228,857,371,235,33,103
2011,Basingstoke and Deane 006A,E01022495,1124,986,138,67,15,56
2011,Basingstoke and Deane 006B,E01022496,1841,1572,269,113,51,105
2011,Basingstoke and Deane 006C,E01022497,1051,888,163,91,19,53
2011,Basingstoke and Deane 006D,E01022498,1192,996,196,120,23,53
2011,Basingstoke and Deane 007B,E01022539,892,677,215,102,32,81
2011,Basingstoke and Deane 007C,E01022540,1377,1073,304,125,43,136
2011,Basingstoke and Deane 007E,E01022542,893,655,238,95,37,106
2011,Basingstoke and Deane 007F,E01022543,1200,922,278,134,31,113
2011,Basingstoke and Deane 007H,E01032843,1238,1081,157,32,25,100
2011,Basingstoke and Deane 007I,E01032844,1115,851,264,118,30,116
2011,Basingstoke and Deane 007J,E01032851,1458,1073,385,157,49,179
2011,Basingstoke and Deane 008A,E01022470,1441,1189,252,132,46,74
2011,Basingstoke and Deane 008B,E01022471,1173,959,214,133,27,54
2011,Basingstoke and Deane 008C,E01022494,1804,1533,271,108,35,128
2011,Basingstoke and Deane 008D,E01022523,1492,1148,344,137,49,158
2011,Basingstoke and Deane 009A,E01022524,1372,1032,340,145,49,146
2011,Basingstoke and Deane 009B,E01022525,1174,893,281,161,26,94
2011,Basingstoke and Deane 009C,E01022526,1222,960,262,123,43,96
2011,Basingstoke and Deane 009D,E01022527,1140,835,305,140,36,129
2011,Basingstoke and Deane 010B,E01022566,989,727,262,160,28,74
2011,Basingstoke and Deane 010C,E01022567,886,648,238,105,33,100
2011,Basingstoke and Deane 010D,E01022568,1053,785,268,141,36,91
2011,Basingstoke and Deane 010E,E01022570,1167,871,296,193,33,70
2011,Basingstoke and Deane 010F,E01032840,1403,1181,222,32,46,144
2011,Basingstoke and Deane 010G,E01032841,1240,1071,169,58,29,82
2011,Basingstoke and Deane 011B,E01022502,1188,940,248,151,29,68
2011,Basingstoke and Deane 011C,E01022506,964,774,190,118,18,54
2011,Basingstoke and Deane 011D,E01022507,1185,930,255,132,26,97
2011,Basingstoke and Deane 011E,E01032842,1070,932,138,28,25,85
2011,Basingstoke and Deane 011F,E01032847,1016,817,199,84,27,88
2011,Basingstoke and Deane 012A,E01022481,1374,1040,334,205,42,87
2011,Basingstoke and Deane 012B,E01022482,1107,809,298,117,50,131
2011,Basingstoke and Deane 012D,E01022503,1096,898,198,97,28,73
2011,Basingstoke and Deane 012E,E01032845,1310,1081,229,86,30,113
2011,Basingstoke and Deane 012F,E01032846,1237,1073,164,22,23,119
2011,Basingstoke and Deane 013A,E01022484,901,656,245,80,35,130
2011,Basingstoke and Deane 013B,E01022485,852,605,247,115,32,100
2011,Basingstoke and Deane 013C,E01022486,1479,1197,282,102,40,140
2011,Basingstoke and Deane 013D,E01022487,896,651,245,90,41,114
2011,Basingstoke and Deane 013E,E01022569,950,668,282,195,13,74
2011,Basingstoke and Deane 014A,E01022548,952,644,308,200,22,86
2011,Basingstoke and Deane 014B,E01022549,1164,852,312,142,30,140
2011,Basingstoke and Deane 014C,E01022550,1143,815,328,146,29,153
2011,Basingstoke and Deane 014D,E01022551,1125,858,267,137,25,105
2011,Basingstoke and Deane 014E,E01022552,1082,829,253,96,32,125
2011,Basingstoke and Deane 015A,E01022528,950,663,287,197,32,58
2011,Basingstoke and Deane 015B,E01022529,1046,745,301,199,9,93
2011,Basingstoke and Deane 015C,E01022530,942,637,305,223,23,59
2011,Basingstoke and Deane 015D,E01022531,1125,829,296,216,20,60
2011,Basingstoke and Deane 016A,E01022475,1308,1103,205,108,26,71
2011,Basingstoke and Deane 016B,E01022476,1365,1141,224,114,34,76
2011,Basingstoke and Deane 016C,E01022480,963,779,184,77,27,80
2011,Basingstoke and Deane 016D,E01022504,1090,773,317,203,33,81
2011,Basingstoke and Deane 016E,E01022505,1149,887,262,169,26,67
2011,Basingstoke and Deane 017A,E01022467,1194,872,322,220,35,67
2011,Basingstoke and Deane 017B,E01022468,1255,886,369,262,35,72
2011,Basingstoke and Deane 017C,E01022469,1093,804,289,182,25,82
2011,Basingstoke and Deane 017D,E01022561,1077,815,262,147,34,81
2011,Basingstoke and Deane 017E,E01022562,979,672,307,174,23,110
2011,Basingstoke and Deane 018A,E01022515,919,542,377,321,10,46
2011,Basingstoke and Deane 018B,E01022516,1081,731,350,272,21,57
2011,Basingstoke and Deane 018C,E01022517,959,697,262,194,28,40
2011,Basingstoke and Deane 018D,E01022518,1487,1163,324,198,44,82
2011,Basingstoke and Deane 018E,E01022519,965,688,277,214,20,43
2011,Basingstoke and Deane 019A,E01022474,1097,831,266,117,39,110
2011,Basingstoke and Deane 019B,E01022477,1047,853,194,86,27,81
2011,Basingstoke and Deane 019C,E01022478,1072,829,243,89,27,127
2011,Basingstoke and Deane 019D,E01022479,1001,755,246,107,32,107
2011,Basingstoke and Deane 019E,E01022509,1067,881,186,110,29,47
2011,Basingstoke and Deane 020A,E01022514,1124,840,284,171,26,87
2011,Basingstoke and Deane 020B,E01022563,1314,977,337,196,39,102
2011,Basingstoke and Deane 020C,E01022564,1271,929,342,221,21,100
2011,Basingstoke and Deane 020D,E01022565,1178,911,267,158,39,70
2011,Basingstoke and Deane 021B,E01022510,1228,1077,151,52,30,69
2011,Basingstoke and Deane 021C,E01022511,948,769,179,89,32,58
2011,Basingstoke and Deane 021D,E01022512,1017,858,159,56,42,61
2011,Basingstoke and Deane 021E,E01032848,1087,940,147,33,20,94
2011,Basingstoke and Deane 021F,E01032849,1047,908,139,38,15,86
2011,Basingstoke and Deane 021G,E01032850,1109,965,144,69,19,56
2011,Basingstoke and Deane 022A,E01022532,1009,747,262,167,32,63
2011,Basingstoke and Deane 022B,E01022533,1308,968,340,180,49,111
2011,Basingstoke and Deane 022C,E01022534,1198,844,354,242,24,88
2011,Basingstoke and Deane 022D,E01022535,1047,772,275,198,25,52
2011,East Hampshire 001A,E01022581,1060,792,268,150,30,88
2011,East Hampshire 001B,E01022582,1050,750,300,168,44,88
2011,East Hampshire 001C,E01022604,883,590,293,161,55,77
2011,East Hampshire 001D,E01022605,1210,843,367,147,162,58
2011,East Hampshire 002A,E01022574,958,717,241,109,32,100
2011,East Hampshire 002B,E01022575,1056,751,305,98,50,157
2011,East Hampshire 002C,E01022576,1057,811,246,129,28,89
2011,East Hampshire 002D,E01022579,806,531,275,145,23,107
2011,East Hampshire 003A,E01022571,900,694,206,125,35,46
2011,East Hampshire 003B,E01022572,965,751,214,144,32,38
2011,East Hampshire 003C,E01022573,1847,1445,402,242,51,109
2011,East Hampshire 003D,E01022577,1016,768,248,161,30,57
2011,East Hampshire 003E,E01022578,2136,1577,559,341,80,138
2011,East Hampshire 003F,E01022580,926,685,241,148,38,55
2011,East Hampshire 004A,E01022603,1048,770,278,109,51,118
2011,East Hampshire 004B,E01022634,787,631,156,73,17,66
2011,East Hampshire 004C,E01022639,1346,1121,225,41,51,133
2011,East Hampshire 004D,E01022640,1078,859,219,46,45,128
2011,East Hampshire 006A,E01022615,2103,1605,498,267,53,178
2011,East Hampshire 006B,E01022633,1028,836,192,102,25,65
2011,East Hampshire 006C,E01022635,1062,779,283,96,57,130
2011,East Hampshire 006D,E01022636,1001,830,171,60,27,84
2011,East Hampshire 006E,E01022641,950,773,177,103,26,48
2011,East Hampshire 007A,E01022591,1776,1237,539,318,70,151
2011,East Hampshire 007B,E01022593,885,627,258,157,33,68
2011,East Hampshire 007C,E01022594,1056,755,301,190,32,79
2011,East Hampshire 007D,E01022595,1395,1054,341,198,52,91
2011,East Hampshire 007E,E01022596,1040,714,326,225,26,75
2011,East Hampshire 007F,E01022627,1637,1155,482,269,90,123
2011,East Hampshire 008A,E01022630,1665,1190,475,268,64,143
2011,East Hampshire 008D,E01022642,806,620,186,117,24,45
2011,East Hampshire 008E,E01032663,1736,1349,387,219,48,120
2011,East Hampshire 009A,E01022583,1208,821,387,224,61,102
2011,East Hampshire 009B,E01022584,1187,830,357,177,45,135
2011,East Hampshire 009C,E01022585,1163,867,296,177,46,73
2011,East Hampshire 009D,E01022586,1264,904,360,207,43,110
2011,East Hampshire 009E,E01022587,1222,954,268,149,35,84
2011,East Hampshire 010A,E01022616,1186,833,353,180,43,130
2011,East Hampshire 010B,E01022617,1157,841,316,171,31,114
2011,East Hampshire 010C,E01022618,1210,792,418,269,41,108
2011,East Hampshire 010D,E01022631,940,700,240,134,41,65
2011,East Hampshire 010E,E01022632,836,598,238,147,26,65
2011,East Hampshire 011A,E01022592,1686,1175,511,257,70,184
2011,East Hampshire 011B,E01022597,1955,1310,645,249,234,162
2011,East Hampshire 011C,E01022619,943,692,251,144,43,64
2011,East Hampshire 011D,E01022624,1650,1148,502,353,67,82
2011,East Hampshire 011E,E01022625,1855,1331,524,297,81,146
2011,East Hampshire 012A,E01022620,851,672,179,88,27,64
2011,East Hampshire 012B,E01022621,926,675,251,103,32,116
2011,East Hampshire 012C,E01022622,938,644,294,190,30,74
2011,East Hampshire 012D,E01022623,1575,1162,413,209,64,140
2011,East Hampshire 012F,E01032664,743,547,196,111,29,56
2011,East Hampshire 012G,E01032665,972,750,222,105,39,78
2011,East Hampshire 013A,E01022588,1211,862,349,254,36,59
2011,East Hampshire 013B,E01022589,1300,974,326,185,35,106
2011,East Hampshire 013C,E01022590,1114,770,344,248,32,64
2011,East Hampshire 013D,E01022607,878,632,246,150,33,63
2011,East Hampshire 013E,E01022608,1009,755,254,166,36,52
2011,East Hampshire 014A,E01022606,1858,1394,464,306,63,95
2011,East Hampshire 014B,E01022611,1086,814,272,169,38,65
2011,East Hampshire 014C,E01022613,1030,780,250,136,38,76
2011,East Hampshire 014D,E01022614,795,536,259,150,28,81
2011,East Hampshire 016A,E01022610,960,714,246,154,28,64
2011,East Hampshire 016B,E01022628,870,649,221,135,31,55
2011,East Hampshire 016C,E01022629,988,576,412,305,40,67
2011,East Hampshire 016D,E01032615,759,479,280,217,15,48
2011,East Hampshire 016E,E01032616,1190,906,284,204,33,47
2011,East Hampshire 017A,E01022599,883,649,234,155,23,56
2011,East Hampshire 017B,E01022600,1115,745,370,241,45,84
2011,East Hampshire 017C,E01022601,1038,725,313,184,45,84
2011,East Hampshire 017D,E01022602,957,670,287,194,27,66
2011,East Hampshire 017E,E01032625,745,467,278,167,26,85
2011,Eastleigh 001A,E01022705,1035,677,358,246,45,67
2011,Eastleigh 001B,E01022706,1175,787,388,281,37,70
2011,Eastleigh 001C,E01022707,1435,1040,395,266,46,83
2011,Eastleigh 001D,E01022708,1249,914,335,221,49,65
2011,Eastleigh 001E,E01022709,1142,786,356,256,40,60
2011,Eastleigh 002A,E01022659,1225,956,269,152,55,62
2011,Eastleigh 002B,E01022660,1067,796,271,183,30,58
2011,Eastleigh 002C,E01022675,1114,845,269,186,23,60
2011,Eastleigh 002D,E01022676,1190,901,289,204,37,48
2011,Eastleigh 002E,E01022704,1272,930,342,229,43,70
2011,Eastleigh 003A,E01022661,1205,817,388,282,34,72
2011,Eastleigh 003B,E01022662,1021,753,268,169,40,59
2011,Eastleigh 003C,E01022663,1229,968,261,165,38,58
2011,Eastleigh 003D,E01022664,1104,811,293,196,31,66
2011,Eastleigh 003E,E01022665,1113,859,254,137,57,60
2011,Eastleigh 004A,E01022648,930,714,216,121,25,70
2011,Eastleigh 004B,E01022667,1157,895,262,136,39,87
2011,Eastleigh 004C,E01022672,1202,885,317,157,53,107
2011,Eastleigh 004D,E01022673,1558,1225,333,130,44,159
2011,Eastleigh 004E,E01022674,1247,971,276,161,37,78
2011,Eastleigh 005A,E01022643,1232,962,270,163,27,80
2011,Eastleigh 005B,E01022644,948,721,227,121,32,74
2011,Eastleigh 005C,E01022646,1158,903,255,165,36,54
2011,Eastleigh 005D,E01022647,1139,879,260,167,22,71
2011,Eastleigh 005E,E01022649,1055,737,318,119,39,160
2011,Eastleigh 005F,E01022650,855,649,206,127,24,55
2011,Eastleigh 006A,E01022668,1938,1584,354,114,62,178
2011,Eastleigh 006B,E01022677,1438,1063,375,134,83,158
2011,Eastleigh 006C,E01022678,1300,987,313,147,47,119
2011,Eastleigh 006D,E01022680,1111,755,356,168,26,162
2011,Eastleigh 006E,E01022681,1122,792,330,170,41,119
2011,Eastleigh 007A,E01022666,1638,1343,295,122,47,126
2011,Eastleigh 007B,E01022669,1348,1078,270,106,39,125
2011,Eastleigh 007C,E01022670,1158,898,260,67,41,152
2011,Eastleigh 007D,E01022671,1178,923,255,101,31,123
2011,Eastleigh 007E,E01022679,1365,1098,267,96,53,118
2011,Eastleigh 008A,E01022645,851,607,244,194,20,30
2011,Eastleigh 008B,E01022682,1018,778,240,161,23,56
2011,Eastleigh 008C,E01022683,1039,811,228,127,38,63
2011,Eastleigh 008D,E01022684,1115,805,310,210,42,58
2011,Eastleigh 008E,E01022685,859,637,222,138,30,54
2011,Eastleigh 008F,E01022686,1205,944,261,148,40,73
2011,Eastleigh 008G,E01022687,1300,1032,268,147,42,79
2011,Eastleigh 009A,E01022713,1261,910,351,233,21,97
2011,Eastleigh 009B,E01022714,1213,835,378,281,27,70
2011,Eastleigh 009C,E01022715,1177,926,251,140,34,77
2011,Eastleigh 009D,E01022716,1213,946,267,132,38,97
2011,Eastleigh 009E,E01022717,949,755,194,106,35,53
2011,Eastleigh 009F,E01022718,1101,804,297,175,39,83
2011,Eastleigh 009G,E01022719,1116,823,293,202,29,62
2011,Eastleigh 010A,E01022653,1066,755,311,212,28,71
2011,Eastleigh 010B,E01022691,1153,975,178,84,30,64
2011,Eastleigh 010C,E01022692,2018,1773,245,60,49,136
2011,Eastleigh 010D,E01022693,1098,902,196,100,30,66
2011,Eastleigh 010E,E01022694,1295,1090,205,81,44,80
2011,Eastleigh 011A,E01022652,1264,897,367,217,53,97
2011,Eastleigh 011B,E01022695,958,723,235,148,27,60
2011,Eastleigh 011C,E01022700,1098,799,299,153,31,115
2011,Eastleigh 011D,E01022701,733,507,226,139,19,68
2011,Eastleigh 011E,E01022703,1133,838,295,173,42,80
2011,Eastleigh 012A,E01022651,1430,1148,282,167,35,80
2011,Eastleigh 012B,E01022696,1107,743,364,273,21,70
2011,Eastleigh 012C,E01022697,1113,812,301,189,34,78
2011,Eastleigh 012D,E01022698,1163,811,352,233,28,91
2011,Eastleigh 012E,E01022699,1130,805,325,219,24,82
2011,Eastleigh 012F,E01022702,993,813,180,91,40,49
2011,Eastleigh 013A,E01022654,1045,853,192,101,23,68
2011,Eastleigh 013B,E01022655,1022,700,322,82,56,184
2011,Eastleigh 013C,E01022656,1103,780,323,177,29,117
2011,Eastleigh 013D,E01022657,1243,959,284,156,37,91
2011,Eastleigh 013E,E01022658,1250,870,380,258,28,94
2011,Eastleigh 014A,E01022710,1433,1012,421,253,27,141
2011,Eastleigh 014B,E01022711,1216,837,379,194,48,137
2011,Eastleigh 014C,E01022712,1233,978,255,140,39,76
2011,Eastleigh 015A,E01022688,1678,1310,368,232,51,85
2011,Eastleigh 015B,E01022689,1156,823,333,234,35,64
2011,Eastleigh 015C,E01022690,1381,1005,376,197,58,121
2011,Fareham 001A,E01022758,1115,834,281,133,43,105
2011,Fareham 001B,E01022771,1166,990,176,80,36,60
2011,Fareham 001C,E01022772,1590,1305,285,139,42,104
2011,Fareham 001D,E01022773,1163,859,304,208,31,65
2011,Fareham 001E,E01022774,1409,1054,355,215,56,84
2011,Fareham 002A,E01022749,998,712,286,187,46,53
2011,Fareham 002B,E01022753,933,720,213,129,35,49
2011,Fareham 002C,E01022754,1282,1015,267,144,27,96
2011,Fareham 002D,E01022780,1114,905,209,98,24,87
2011,Fareham 002E,E01022787,962,730,232,136,36,60
2011,Fareham 002F,E01022788,944,740,204,109,36,59
2011,Fareham 003A,E01022730,1084,760,324,230,35,59
2011,Fareham 003B,E01022731,1036,842,194,116,27,51
2011,Fareham 003C,E01022732,1076,770,306,97,55,154
2011,Fareham 003D,E01022733,1219,834,385,260,39,86
2011,Fareham 003E,E01022734,987,706,281,123,42,116
2011,Fareham 004A,E01022720,1053,762,291,194,40,57
2011,Fareham 004B,E01022725,920,582,338,232,31,75
2011,Fareham 004C,E01022726,1007,672,335,249,32,54
2011,Fareham 004D,E01022727,1102,744,358,234,59,65
2011,Fareham 004E,E01022729,885,683,202,131,15,56
2011,Fareham 004F,E01022743,1363,952,411,289,52,70
2011,Fareham 005A,E01022750,1040,751,289,163,66,60
2011,Fareham 005B,E01022751,1104,739,365,256,41,68
2011,Fareham 005C,E01022752,1073,798,275,186,31,58
2011,Fareham 005D,E01022757,1230,1072,158,76,23,59
2011,Fareham 005E,E01022790,1340,1029,311,208,40,63
2011,Fareham 006A,E01022755,1048,744,304,191,38,75
2011,Fareham 006B,E01022756,986,799,187,133,23,31
2011,Fareham 006C,E01022791,1539,1061,478,271,134,73
2011,Fareham 006D,E01022792,1120,812,308,188,44,76
2011,Fareham 006E,E01022793,1277,952,325,222,49,54
2011,Fareham 007A,E01022781,977,674,303,151,36,116
2011,Fareham 007B,E01022782,1078,765,313,198,36,79
2011,Fareham 007C,E01022785,1122,858,264,179,30,55
2011,Fareham 007D,E01022786,1183,906,277,174,38,65
2011,Fareham 007E,E01022789,1111,875,236,144,28,64
2011,Fareham 008A,E01022721,1064,765,299,199,30,70
2011,Fareham 008B,E01022722,1124,827,297,162,46,89
2011,Fareham 008C,E01022723,1124,837,287,128,28,131
2011,Fareham 008D,E01022724,1061,836,225,108,33,84
2011,Fareham 008E,E01022737,1189,867,322,195,44,83
2011,Fareham 008F,E01022766,980,674,306,238,32,36
2011,Fareham 008G,E01022769,952,745,207,126,28,53
2011,Fareham 009A,E01022740,1281,896,385,310,24,51
2011,Fareham 009B,E01022741,904,662,242,157,23,62
2011,Fareham 009C,E01022742,1240,803,437,352,26,59
2011,Fareham 009D,E01022783,1105,744,361,272,38,51
2011,Fareham 009E,E01022784,1031,765,266,171,44,51
2011,Fareham 010A,E01022759,1119,811,308,222,29,57
2011,Fareham 010B,E01022763,1159,772,387,293,50,44
2011,Fareham 010C,E01022765,1205,860,345,242,27,76
2011,Fareham 010D,E01022768,1073,794,279,193,24,62
2011,Fareham 010E,E01022770,1270,918,352,261,38,53
2011,Fareham 011A,E01022728,1242,944,298,134,41,123
2011,Fareham 011B,E01022735,1107,849,258,145,30,83
2011,Fareham 011C,E01022736,1148,850,298,172,29,97
2011,Fareham 011D,E01022738,771,519,252,118,22,112
2011,Fareham 011E,E01022739,1117,765,352,138,66,148
2011,Fareham 012A,E01022760,1118,815,303,189,33,81
2011,Fareham 012B,E01022761,1096,757,339,195,32,112
2011,Fareham 012C,E01022762,1122,836,286,185,35,66
2011,Fareham 012D,E01022764,1111,745,366,241,30,95
2011,Fareham 012E,E01022767,895,653,242,160,34,48
2011,Fareham 013B,E01022776,1176,866,310,213,41,56
2011,Fareham 013C,E01022777,1088,651,437,311,44,82
2011,Fareham 013D,E01022778,1049,735,314,215,37,62
2011,Fareham 013F,E01032877,1529,1013,516,394,39,83
2011,Fareham 014A,E01022744,1006,653,353,255,39,59
2011,Fareham 014B,E01022745,1069,697,372,286,38,48
2011,Fareham 014C,E01022746,1093,704,389,270,28,91
2011,Fareham 014D,E01022747,887,637,250,173,26,51
2011,Fareham 014E,E01022748,1057,792,265,182,26,57
2011,Gosport 001A,E01022800,1217,856,361,187,74,100
2011,Gosport 001B,E01022801,1088,722,366,175,49,142
2011,Gosport 001C,E01022802,1133,809,324,204,24,96
2011,Gosport 001D,E01022803,1185,851,334,127,59,148
2011,Gosport 001E,E01022836,1028,648,380,283,34,63
2011,Gosport 002A,E01022804,1192,828,364,194,40,130
2011,Gosport 002B,E01022805,1043,720,323,171,27,125
2011,Gosport 002C,E01022834,963,652,311,208,20,83
2011,Gosport 002D,E01022835,1082,754,328,160,47,121
2011,Gosport 002E,E01022840,1190,814,376,147,52,177
2011,Gosport 003A,E01022813,1027,815,212,112,31,69
2011,Gosport 003B,E01022814,1255,937,318,179,38,101
2011,Gosport 003C,E01022815,1143,865,278,165,41,72
2011,Gosport 003D,E01022823,1167,882,285,168,33,84
2011,Gosport 003E,E01022825,1080,832,248,149,28,71
2011,Gosport 004A,E01022819,1125,861,264,79,46,139
2011,Gosport 004B,E01022820,1157,869,288,35,70,183
2011,Gosport 004E,E01022841,1032,759,273,92,34,147
2011,Gosport 004F,E01022842,1114,845,269,103,42,124
2011,Gosport 004G,E01032882,1385,999,386,73,88,225
2011,Gosport 005A,E01022807,1165,893,272,115,34,123
2011,Gosport 005B,E01022816,1124,855,269,133,51,85
2011,Gosport 005C,E01022817,1320,1005,315,131,49,135
2011,Gosport 005D,E01022818,1052,710,342,152,45,145
2011,Gosport 005E,E01022824,2106,1681,425,201,65,159
2011,Gosport 006A,E01022826,1185,896,289,198,39,52
2011,Gosport 006C,E01022828,821,508,313,255,8,50
2011,Gosport 006D,E01022829,1394,893,501,320,47,134
2011,Gosport 006E,E01022830,997,667,330,258,21,51
2011,Gosport 006F,E01032880,999,791,208,113,36,59
2011,Gosport 006G,E01032881,1188,966,222,91,50,81
2011,Gosport 006H,E01032883,924,624,300,171,35,94
2011,Gosport 007A,E01022806,1089,831,258,147,32,79
2011,Gosport 007D,E01022832,1213,940,273,132,57,84
2011,Gosport 007E,E01022839,1056,737,319,135,41,143
2011,Gosport 007F,E01032884,1551,1096,455,291,34,130
2011,Gosport 008A,E01022810,1152,856,296,155,45,96
2011,Gosport 008B,E01022811,1734,1368,366,158,64,144
2011,Gosport 008C,E01022833,1335,940,395,111,49,235
2011,Gosport 008D,E01022843,1061,658,403,160,44,199
2011,Gosport 008F,E01032878,892,676,216,70,34,112
2011,Gosport 008G,E01032879,947,586,361,181,22,158
2011,Gosport 009A,E01022794,1016,653,363,249,41,73
2011,Gosport 009B,E01022795,1110,768,342,243,26,73
2011,Gosport 009C,E01022796,756,481,275,200,18,57
2011,Gosport 009D,E01022837,1086,795,291,191,44,56
2011,Gosport 009E,E01022838,894,621,273,186,32,55
2011,Gosport 010A,E01022797,795,537,258,154,31,73
2011,Gosport 010B,E01022798,927,606,321,182,36,103
2011,Gosport 010C,E01022799,968,695,273,179,33,61
2011,Gosport 010D,E01022812,946,755,191,100,27,64
2011,Gosport 010E,E01022831,1041,793,248,133,51,64
2011,Gosport 010F,E01022845,1049,782,267,144,39,84
2011,Hart 001A,E01022890,1060,737,323,187,37,99
2011,Hart 001B,E01022891,1311,1003,308,170,47,91
2011,Hart 001C,E01022892,1408,980,428,320,36,72
2011,Hart 001D,E01022893,1173,893,280,177,35,68
2011,Hart 001E,E01022894,1108,830,278,164,39,75
2011,Hart 002A,E01022859,1192,924,268,136,37,95
2011,Hart 002B,E01022895,1384,1077,307,199,37,71
2011,Hart 002C,E01022896,1245,958,287,190,47,50
2011,Hart 002D,E01022897,1334,1054,280,153,42,85
2011,Hart 002E,E01022898,1161,902,259,167,29,63
2011,Hart 003A,E01022846,944,706,238,135,37,66
2011,Hart 003B,E01022847,1307,1010,297,197,24,76
2011,Hart 003C,E01022848,1140,827,313,228,25,60
2011,Hart 003D,E01022874,1010,773,237,150,41,46
2011,Hart 003E,E01022875,1055,812,243,91,49,103
2011,Hart 003F,E01022876,1015,757,258,185,22,51
2011,Hart 003G,E01022877,1056,793,263,169,32,62
2011,Hart 004A,E01022858,804,585,219,128,32,59
2011,Hart 004B,E01022878,1282,841,441,307,43,91
2011,Hart 004C,E01022879,1180,854,326,207,35,84
2011,Hart 004D,E01022880,1123,822,301,144,37,120
2011,Hart 005A,E01022860,1261,881,380,245,40,95
2011,Hart 005B,E01022862,1427,1162,265,141,33,91
2011,Hart 005D,E01022867,1174,968,206,98,26,82
2011,Hart 005E,E01032852,1205,1041,164,41,35,88
2011,Hart 005F,E01032853,1206,1011,195,55,38,102
2011,Hart 005G,E01032854,1148,961,187,50,34,103
2011,Hart 005H,E01032857,795,671,124,49,27,48
2011,Hart 006A,E01022881,1675,1293,382,186,61,135
2011,Hart 006B,E01022882,1114,866,248,131,44,73
2011,Hart 006C,E01022883,1037,765,272,140,52,80
2011,Hart 006D,E01022884,1107,841,266,164,37,65
2011,Hart 006E,E01022885,1122,896,226,122,46,58
2011,Hart 007A,E01022861,1241,900,341,218,44,79
2011,Hart 007B,E01022863,1080,750,330,239,29,62
2011,Hart 007C,E01022865,1185,831,354,247,43,64
2011,Hart 007D,E01022868,1226,862,364,241,36,87
2011,Hart 007E,E01022870,1028,707,321,196,43,82
2011,Hart 008A,E01022864,1010,649,361,237,26,98
2011,Hart 008B,E01022871,1050,825,225,101,37,87
2011,Hart 008C,E01022872,1256,935,321,205,37,79
2011,Hart 008D,E01022873,1266,869,397,251,50,96
2011,Hart 008E,E01022887,1123,772,351,180,31,140
2011,Hart 009A,E01022849,1205,908,297,184,36,77
2011,Hart 009B,E01022850,1090,854,236,139,20,77
2011,Hart 009C,E01022851,1190,877,313,196,41,76
2011,Hart 009D,E01022853,1219,892,327,220,39,68
2011,Hart 009E,E01022869,1058,780,278,179,35,64
2011,Hart 010A,E01022852,1352,1134,218,95,40,83
2011,Hart 010B,E01022854,1204,931,273,137,49,87
2011,Hart 010C,E01022855,867,601,266,147,26,93
2011,Hart 010D,E01022856,1075,726,349,205,45,99
2011,Hart 010E,E01022857,948,758,190,50,40,100
2011,Hart 011B,E01022888,1190,860,330,224,32,74
2011,Hart 011C,E01022889,1045,774,271,171,24,76
2011,Hart 011D,E01032855,917,621,296,112,117,67
2011,Hart 011E,E01032856,1699,1565,134,25,17,92
2011,Havant 003A,E01022930,1242,823,419,310,31,78
2011,Havant 003B,E01022931,1219,875,344,237,44,63
2011,Havant 003C,E01022935,1045,665,380,272,29,79
2011,Havant 003D,E01022975,1087,748,339,275,26,38
2011,Havant 003E,E01022976,1102,733,369,199,45,125
2011,Havant 004A,E01022922,1181,972,209,93,36,80
2011,Havant 004B,E01022971,1128,840,288,189,38,61
2011,Havant 004C,E01022972,1167,849,318,232,28,58
2011,Havant 004D,E01022974,1102,799,303,219,33,51
2011,Havant 005A,E01022959,999,665,334,148,50,136
2011,Havant 005B,E01022962,1089,806,283,173,30,80
2011,Havant 005C,E01022965,1045,722,323,107,46,170
2011,Havant 005D,E01022973,1315,900,415,207,43,165
2011,Havant 006A,E01022901,1169,825,344,139,41,164
2011,Havant 006B,E01022902,1089,744,345,118,57,170
2011,Havant 006C,E01022966,936,642,294,94,34,166
2011,Havant 006D,E01022967,816,517,299,105,33,161
2011,Havant 007A,E01022960,1045,824,221,69,51,101
2011,Havant 007B,E01022961,1013,792,221,87,32,102
2011,Havant 007C,E01022963,1070,760,310,205,37,68
2011,Havant 007D,E01022964,971,688,283,118,33,132
2011,Havant 008A,E01022903,1242,862,380,140,43,197
2011,Havant 008B,E01022906,1024,701,323,109,55,159
2011,Havant 008C,E01022968,977,652,325,89,57,179
2011,Havant 008D,E01022969,1183,845,338,101,44,193
2011,Havant 009A,E01022913,936,653,283,130,27,126
2011,Havant 009B,E01022914,927,610,317,135,30,152
2011,Havant 009C,E01022915,1044,678,366,131,45,190
2011,Havant 009D,E01022916,1133,840,293,131,30,132
2011,Havant 009E,E01022917,870,535,335,129,51,155
2011,Havant 010A,E01022900,1293,876,417,168,38,211
2011,Havant 010B,E01022904,1408,967,441,193,48,200
2011,Havant 010C,E01022905,1205,764,441,135,46,260
2011,Havant 010D,E01022908,1052,768,284,128,30,126
2011,Havant 010E,E01022970,1251,879,372,109,57,206
2011,Havant 011A,E01022947,1280,958,322,209,41,72
2011,Havant 011B,E01022948,1187,868,319,185,38,96
2011,Havant 011C,E01022949,1124,764,360,163,35,162
2011,Havant 011D,E01022950,1085,762,323,224,38,61
2011,Havant 011E,E01022951,1035,751,284,194,37,53
2011,Havant 011F,E01022952,1074,790,284,189,22,73
2011,Havant 013A,E01022924,1155,790,365,239,37,89
2011,Havant 013B,E01022925,992,679,313,213,32,68
2011,Havant 013C,E01022926,1041,704,337,252,27,58
2011,Havant 013D,E01022927,1084,706,378,257,32,89
2011,Havant 013E,E01022928,1133,708,425,315,54,56
2011,Havant 013F,E01022929,1059,728,331,227,30,74
2011,Havant 014A,E01022953,1483,1046,437,211,38,188
2011,Havant 014B,E01022954,1095,739,356,264,36,56
2011,Havant 014C,E01022955,960,650,310,208,36,66
2011,Havant 014D,E01022956,881,690,191,92,26,73
2011,Havant 014E,E01022957,917,617,300,144,38,118
2011,Havant 014F,E01022958,1055,754,301,226,32,43
2011,Havant 015A,E01022937,1084,742,342,198,39,105
2011,Havant 015B,E01022943,998,588,410,337,28,45
2011,Havant 015C,E01022944,1009,673,336,224,39,73
2011,Havant 015D,E01022946,1271,826,445,309,34,102
2011,Havant 016A,E01022940,1122,739,383,248,37,98
2011,Havant 016B,E01022942,1052,638,414,258,29,127
2011,Havant 016C,E01022945,1608,995,613,446,43,124
2011,Havant 017A,E01022936,1145,739,406,261,27,118
2011,Havant 017B,E01022938,975,631,344,254,27,63
2011,Havant 017C,E01022939,1169,758,411,265,29,117
2011,Havant 017D,E01022941,1159,725,434,304,38,92
2011,Havant 018A,E01022899,1002,706,296,114,53,129
2011,Havant 018B,E01022907,1075,750,325,204,37,84
2011,Havant 018C,E01022909,1144,835,309,188,39,82
2011,Havant 018D,E01022910,1063,796,267,131,31,105
2011,Havant 018E,E01022911,1077,762,315,203,30,82
2011,Havant 018F,E01032605,975,699,276,178,41,57
2011,Havant 019A,E01022919,1210,830,380,209,54,117
2011,Havant 019B,E01022933,1165,753,412,126,60,226
2011,Havant 019C,E01022934,1331,925,406,128,46,232
2011,Havant 019D,E01032618,1103,768,335,180,36,119
2011,Havant 020A,E01022918,1078,745,333,230,36,67
2011,Havant 020B,E01022920,1136,825,311,196,27,88
2011,Havant 020C,E01022921,1177,864,313,222,29,62
2011,Havant 020D,E01032617,1104,766,338,245,31,62
2011,New Forest 001A,E01023011,1075,769,306,194,29,83
2011,New Forest 001B,E01023012,1017,736,281,181,29,71
2011,New Forest 001C,E01023021,1052,737,315,210,41,64
2011,New Forest 001D,E01023022,1214,908,306,171,27,108
2011,New Forest 001E,E01023023,1209,854,355,231,31,93
2011,New Forest 001F,E01023024,1094,792,302,215,29,58
2011,New Forest 001G,E01023025,990,672,318,221,22,75
2011,New Forest 002A,E01023076,1018,701,317,247,18,52
2011,New Forest 002B,E01023082,1120,886,234,122,30,82
2011,New Forest 002C,E01023083,1109,793,316,156,38,122
2011,New Forest 002D,E01023088,1164,808,356,178,38,140
2011,New Forest 003A,E01023073,1072,888,184,84,45,55
2011,New Forest 003B,E01023080,974,717,257,154,22,81
2011,New Forest 003C,E01023081,1444,1102,342,149,36,157
2011,New Forest 003D,E01023089,1162,905,257,146,23,88
2011,New Forest 003E,E01023090,1416,1162,254,108,43,103
2011,New Forest 004A,E01023074,1009,709,300,193,27,80
2011,New Forest 004B,E01023077,1087,812,275,113,33,129
2011,New Forest 004C,E01023078,974,701,273,203,18,52
2011,New Forest 004D,E01023079,1271,939,332,161,39,132
2011,New Forest 004E,E01023085,1104,808,296,161,36,99
2011,New Forest 005A,E01023072,1005,839,166,90,20,56
2011,New Forest 005B,E01023075,857,653,204,119,25,60
2011,New Forest 005C,E01023084,1102,827,275,176,33,66
2011,New Forest 005D,E01023086,1076,751,325,194,24,107
2011,New Forest 005E,E01023087,1139,985,154,68,41,45
2011,New Forest 006A,E01022977,1042,747,295,192,31,72
2011,New Forest 006B,E01022978,1117,779,338,228,34,76
2011,New Forest 006C,E01022979,884,604,280,208,22,50
2011,New Forest 006D,E01022980,1074,716,358,231,27,100
2011,New Forest 007A,E01022992,868,615,253,177,20,56
2011,New Forest 007B,E01022993,1002,675,327,197,22,108
2011,New Forest 007C,E01023045,1139,821,318,232,25,61
2011,New Forest 007D,E01023046,995,716,279,175,23,81
2011,New Forest 008A,E01023007,840,587,253,167,23,63
2011,New Forest 008B,E01023010,1132,879,253,106,35,112
2011,New Forest 008C,E01023047,1015,835,180,100,28,52
2011,New Forest 008D,E01023048,1018,735,283,166,40,77
2011,New Forest 008E,E01023049,1274,1083,191,91,27,73
2011,New Forest 008F,E01023050,1308,1045,263,124,36,103
2011,New Forest 009A,E01023008,1050,595,455,340,24,91
2011,New Forest 009B,E01023009,1151,915,236,150,30,56
2011,New Forest 009C,E01023038,1058,749,309,244,21,44
2011,New Forest 009D,E01023039,1007,665,342,224,26,92
2011,New Forest 009E,E01023040,1035,654,381,304,25,52
2011,New Forest 010A,E01023026,842,584,258,162,26,70
2011,New Forest 010B,E01023062,1106,795,311,200,40,71
2011,New Forest 010C,E01023064,993,737,256,148,32,76
2011,New Forest 010D,E01023066,1143,786,357,260,23,74
2011,New Forest 010E,E01023067,1051,730,321,231,28,62
2011,New Forest 011A,E01023003,1198,807,391,279,27,85
2011,New Forest 011B,E01023004,1344,976,368,231,34,103
2011,New Forest 011C,E01023005,1088,797,291,222,24,45
2011,New Forest 011D,E01023006,991,683,308,97,42,169
2011,New Forest 011E,E01023028,1446,1043,403,228,32,143
2011,New Forest 011F,E01023037,1305,897,408,250,23,135
2011,New Forest 012A,E01023065,1127,778,349,220,31,98
2011,New Forest 012B,E01023068,939,640,299,150,35,114
2011,New Forest 012C,E01023069,1137,815,322,194,35,93
2011,New Forest 012D,E01023070,1144,830,314,186,31,97
2011,New Forest 012E,E01023071,1035,807,228,136,26,66
2011,New Forest 013A,E01023029,1088,744,344,106,38,200
2011,New Forest 013B,E01023030,986,773,213,112,32,69
2011,New Forest 013C,E01023032,970,686,284,209,21,54
2011,New Forest 013D,E01023033,927,616,311,164,32,115
2011,New Forest 014A,E01023013,1092,745,347,239,27,81
2011,New Forest 014B,E01023014,1208,785,423,290,25,108
2011,New Forest 014C,E01023015,1061,739,322,206,18,98
2011,New Forest 014D,E01023016,1060,688,372,286,16,70
2011,New Forest 014E,E01023027,1070,726,344,201,36,107
2011,New Forest 014F,E01023031,950,684,266,180,27,59
2011,New Forest 015A,E01022989,1215,815,400,265,48,87
2011,New Forest 015B,E01022991,1528,997,531,386,41,104
2011,New Forest 015C,E01022998,1260,761,499,338,44,117
2011,New Forest 015D,E01023000,1208,840,368,263,30,75
2011,New Forest 016A,E01022994,1148,780,368,274,28,66
2011,New Forest 016B,E01022995,1019,725,294,200,28,66
2011,New Forest 016C,E01022996,878,573,305,193,18,94
2011,New Forest 016D,E01022997,983,631,352,205,46,101
2011,New Forest 016E,E01023063,944,615,329,151,97,81
2011,New Forest 017A,E01022990,1089,717,372,235,41,96
2011,New Forest 017B,E01022999,1547,1083,464,300,47,117
2011,New Forest 017C,E01023041,1060,661,399,294,20,85
2011,New Forest 017D,E01023042,980,647,333,246,8,79
2011,New Forest 017E,E01023043,1168,826,342,229,33,80
2011,New Forest 018A,E01022984,1066,615,451,305,64,82
2011,New Forest 018B,E01022985,880,650,230,158,21,51
2011,New Forest 018C,E01023020,1029,647,382,309,21,52
2011,New Forest 018D,E01023034,1241,797,444,317,30,97
2011,New Forest 018E,E01023035,1224,882,342,244,29,69
2011,New Forest 018F,E01023036,1326,820,506,401,29,76
2011,New Forest 019A,E01023001,1324,1016,308,192,28,88
2011,New Forest 019B,E01023002,1195,835,360,167,47,146
2011,New Forest 019C,E01023058,1017,663,354,155,32,167
2011,New Forest 019D,E01023060,1024,703,321,227,15,79
2011,New Forest 019E,E01023061,1064,760,304,165,40,99
2011,New Forest 020A,E01023017,1342,893,449,257,48,144
2011,New Forest 020B,E01023018,978,576,402,216,20,166
2011,New Forest 020C,E01023019,1067,776,291,128,32,131
2011,New Forest 020D,E01023055,854,549,305,117,35,153
2011,New Forest 021A,E01022986,1000,680,320,220,31,69
2011,New Forest 021B,E01022988,1077,795,282,142,34,106
2011,New Forest 021C,E01023054,1167,742,425,298,27,100
2011,New Forest 021D,E01023056,880,505,375,285,11,79
2011,New Forest 021E,E01023057,1086,708,378,248,26,104
2011,New Forest 022A,E01022981,1248,710,538,446,30,62
2011,New Forest 022B,E01022982,1240,714,526,440,16,70
2011,New Forest 022C,E01022983,1120,660,460,369,22,69
2011,New Forest 022D,E01022987,1229,663,566,484,17,65
2011,New Forest 023A,E01023044,670,351,319,272,16,31
2011,New Forest 023B,E01023051,1073,711,362,261,36,65
2011,New Forest 023C,E01023052,1082,600,482,395,21,66
2011,New Forest 023D,E01023053,1086,610,476,401,12,63
2011,New Forest 023E,E01023059,1118,714,404,309,29,66
2011,Rushmoor 001A,E01023099,1119,799,320,145,41,134
2011,Rushmoor 001B,E01023104,1211,909,302,126,59,117
2011,Rushmoor 001C,E01023106,1108,807,301,102,67,132
2011,Rushmoor 001D,E01023121,1488,1134,354,182,45,127
2011,Rushmoor 002A,E01023105,1148,835,313,102,70,141
2011,Rushmoor 002B,E01023119,949,647,302,73,71,158
2011,Rushmoor 002C,E01023120,1308,975,333,107,74,152
2011,Rushmoor 002D,E01023122,1128,834,294,96,63,135
2011,Rushmoor 002E,E01023146,1038,766,272,103,56,113
2011,Rushmoor 003A,E01023100,939,795,144,54,31,59
2011,Rushmoor 003B,E01023101,996,754,242,165,29,48
2011,Rushmoor 003C,E01023102,1068,809,259,151,28,80
2011,Rushmoor 003D,E01023134,1401,1167,234,112,41,81
2011,Rushmoor 003E,E01023147,1111,842,269,158,39,72
2011,Rushmoor 004A,E01023096,1587,1221,366,199,48,119
2011,Rushmoor 004B,E01023097,1080,823,257,175,38,44
2011,Rushmoor 004C,E01023103,1238,979,259,154,38,67
2011,Rushmoor 004D,E01023111,1296,977,319,193,42,84
2011,Rushmoor 004E,E01023112,933,770,163,80,40,43
2011,Rushmoor 005A,E01023092,1091,925,166,85,23,58
2011,Rushmoor 005B,E01023093,1082,857,225,143,33,49
2011,Rushmoor 005C,E01023132,1132,878,254,134,45,75
2011,Rushmoor 005D,E01023133,1027,851,176,85,26,65
2011,Rushmoor 005E,E01023135,1673,1343,330,143,46,141
2011,Rushmoor 006A,E01023091,1201,877,324,88,55,181
2011,Rushmoor 006B,E01023094,1013,784,229,162,29,38
2011,Rushmoor 006C,E01023095,1274,1015,259,98,41,120
2011,Rushmoor 006D,E01023098,1203,930,273,141,48,84
2011,Rushmoor 006E,E01023148,1088,822,266,168,34,64
2011,Rushmoor 006F,E01023149,932,683,249,171,22,56
2011,Rushmoor 007A,E01023113,1188,903,285,127,51,107
2011,Rushmoor 007B,E01023114,1053,857,196,86,35,75
2011,Rushmoor 007C,E01023136,1296,1061,235,66,55,114
2011,Rushmoor 007D,E01023137,989,764,225,99,38,88
2011,Rushmoor 007E,E01023138,1029,801,228,94,27,107
2011,Rushmoor 007F,E01023139,885,674,211,112,28,71
2011,Rushmoor 007G,E01023140,1115,866,249,41,39,169
2011,Rushmoor 008A,E01023141,2505,2268,237,12,28,197
2011,Rushmoor 008B,E01023142,1529,1182,347,75,64,208
2011,Rushmoor 008C,E01023143,1301,1019,282,43,59,180
2011,Rushmoor 008D,E01023144,1326,1034,292,67,88,137
2011,Rushmoor 009A,E01023118,1328,1069,259,91,66,102
2011,Rushmoor 009B,E01023124,968,798,170,69,41,60
2011,Rushmoor 009C,E01023125,1778,1461,317,147,46,124
2011,Rushmoor 009F,E01032858,1555,1199,356,110,56,190
2011,Rushmoor 010A,E01023128,1008,741,267,123,40,104
2011,Rushmoor 010B,E01023129,1001,784,217,86,30,101
2011,Rushmoor 010C,E01023130,1034,782,252,154,38,60
2011,Rushmoor 010D,E01023131,968,710,258,160,36,62
2011,Rushmoor 010E,E01023145,1578,1272,306,106,50,150
2011,Rushmoor 011A,E01023109,1153,907,246,127,41,78
2011,Rushmoor 011B,E01023115,997,776,221,116,42,63
2011,Rushmoor 011C,E01023116,1430,1118,312,112,83,117
2011,Rushmoor 011D,E01023117,1382,1078,304,173,49,82
2011,Rushmoor 012A,E01023107,1032,721,311,148,42,121
2011,Rushmoor 012B,E01023108,959,634,325,144,31,150
2011,Rushmoor 012C,E01023110,1294,971,323,123,77,123
2011,Rushmoor 012D,E01023123,1109,887,222,108,38,76
2011,Test Valley 001A,E01023165,1537,1126,411,245,42,124
2011,Test Valley 001B,E01023169,1485,1080,405,284,41,80
2011,Test Valley 001C,E01023181,1055,886,169,69,36,64
2011,Test Valley 001D,E01023182,1193,998,195,92,39,64
2011,Test Valley 002A,E01023153,1240,978,262,93,34,135
2011,Test Valley 002B,E01023154,1202,882,320,110,57,153
2011,Test Valley 002C,E01023156,985,695,290,65,49,176
2011,Test Valley 002D,E01023157,1013,721,292,116,42,134
2011,Test Valley 002E,E01023205,911,717,194,58,39,97
2011,Test Valley 003A,E01023155,2030,1451,579,203,66,310
2011,Test Valley 003B,E01023201,1177,835,342,178,45,119
2011,Test Valley 003C,E01023202,1304,933,371,194,30,147
2011,Test Valley 003D,E01023215,1131,831,300,172,37,91
2011,Test Valley 003E,E01023219,1076,805,271,165,31,75
2011,Test Valley 004A,E01023179,1329,1029,300,157,44,99
2011,Test Valley 004B,E01023183,1017,747,270,128,30,112
2011,Test Valley 004C,E01023190,881,633,248,170,24,54
2011,Test Valley 004D,E01023203,1184,878,306,190,24,92
2011,Test Valley 004E,E01023204,1268,955,313,157,32,124
2011,Test Valley 005B,E01023180,1159,836,323,213,21,89
2011,Test Valley 005C,E01023186,1246,969,277,168,30,79
2011,Test Valley 005D,E01023189,1225,949,276,153,36,87
2011,Test Valley 005E,E01023196,1230,887,343,214,38,91
2011,Test Valley 005F,E01032870,1401,1093,308,176,44,88
2011,Test Valley 005G,E01032871,1111,783,328,228,29,71
2011,Test Valley 006A,E01023187,1143,867,276,151,43,82
2011,Test Valley 006B,E01023188,997,813,184,97,35,52
2011,Test Valley 006C,E01023216,1345,1035,310,152,45,113
2011,Test Valley 006D,E01023217,1169,898,271,162,38,71
2011,Test Valley 006E,E01023218,1096,845,251,173,27,51
2011,Test Valley 007A,E01023159,1650,1162,488,312,59,117
2011,Test Valley 007B,E01023195,1602,1274,328,132,46,150
2011,Test Valley 007C,E01023197,1095,880,215,123,17,75
2011,Test Valley 007D,E01023198,1073,774,299,198,20,81
2011,Test Valley 008A,E01023160,1091,743,348,235,38,75
2011,Test Valley 008B,E01023168,1112,756,356,242,36,78
2011,Test Valley 008C,E01023178,1628,1212,416,249,42,125
2011,Test Valley 009A,E01023166,1095,784,311,188,30,93
2011,Test Valley 009B,E01023167,1108,753,355,233,43,79
2011,Test Valley 009C,E01023177,1589,1105,484,278,64,142
2011,Test Valley 009D,E01023184,1000,737,263,144,34,85
2011,Test Valley 009E,E01023185,868,604,264,164,24,76
2011,Test Valley 010A,E01023174,1335,1011,324,197,39,88
2011,Test Valley 010B,E01023175,1185,792,393,278,46,69
2011,Test Valley 010C,E01023176,1110,764,346,210,44,92
2011,Test Valley 010D,E01023207,1108,754,354,253,32,69
2011,Test Valley 010E,E01023208,867,663,204,123,24,57
2011,Test Valley 010F,E01023209,1052,786,266,178,41,47
2011,Test Valley 011A,E01023150,1108,774,334,183,47,104
2011,Test Valley 011B,E01023151,920,584,336,187,29,120
2011,Test Valley 011C,E01023152,1101,701,400,293,35,72
2011,Test Valley 011D,E01023206,835,548,287,159,33,95
2011,Test Valley 012A,E01023158,1653,1105,548,374,61,113
2011,Test Valley 012B,E01023191,1363,1078,285,186,33,66
2011,Test Valley 012C,E01023192,1250,859,391,227,41,123
2011,Test Valley 012D,E01023193,1167,773,394,277,38,79
2011,Test Valley 012E,E01023194,1123,760,363,289,37,37
2011,Test Valley 012F,E01023200,1138,868,270,174,40,56
2011,Test Valley 013A,E01023162,1284,859,425,231,70,124
2011,Test Valley 013B,E01023163,1245,856,389,282,43,64
2011,Test Valley 013C,E01023164,1165,803,362,246,37,79
2011,Test Valley 013D,E01023199,1264,895,369,188,80,101
2011,Test Valley 014A,E01023210,1118,900,218,109,45,64
2011,Test Valley 014B,E01023211,1308,1096,212,71,49,92
2011,Test Valley 014C,E01023212,1123,860,263,148,54,61
2011,Test Valley 014D,E01023213,996,769,227,109,51,67
2011,Test Valley 014E,E01023214,1016,823,193,116,29,48
2011,Test Valley 015A,E01023170,1268,960,308,164,47,97
2011,Test Valley 015B,E01023171,1225,878,347,194,63,90
2011,Test Valley 015C,E01023172,1111,830,281,196,33,52
2011,Test Valley 015D,E01023173,1163,853,310,214,35,61
2011,Winchester 001A,E01023286,1013,741,272,128,35,109
2011,Winchester 001B,E01023287,2077,1587,490,290,76,124
2011,Winchester 001C,E01023288,1017,775,242,133,21,88
2011,Winchester 002A,E01023236,1363,957,406,263,38,105
2011,Winchester 002B,E01023237,902,672,230,105,34,91
2011,Winchester 002C,E01023238,1167,921,246,149,31,66
2011,Winchester 002D,E01023239,1199,891,308,203,46,59
2011,Winchester 003A,E01023240,1512,1037,475,296,55,124
2011,Winchester 003B,E01023241,901,609,292,207,35,50
2011,Winchester 003C,E01023248,1154,799,355,238,48,69
2011,Winchester 003D,E01023253,1054,700,354,214,39,101
2011,Winchester 003E,E01023274,1374,883,491,193,221,77
2011,Winchester 004A,E01023225,1640,1153,487,254,98,135
2011,Winchester 004B,E01023278,1119,816,303,206,31,66
2011,Winchester 004C,E01023279,1086,788,298,214,39,45
2011,Winchester 004D,E01023280,1090,787,303,175,50,78
2011,Winchester 004E,E01023281,1162,787,375,254,37,84
2011,Winchester 005A,E01023247,1037,714,323,207,39,77
2011,Winchester 005B,E01023249,869,612,257,137,39,81
2011,Winchester 005C,E01023250,1136,803,333,147,64,122
2011,Winchester 005D,E01023268,943,719,224,103,63,58
2011,Winchester 005E,E01023269,1902,1208,694,154,473,67
2011,Winchester 005F,E01023270,1184,700,484,84,61,339
2011,Winchester 006A,E01023251,787,553,234,125,44,65
2011,Winchester 006B,E01023255,1468,951,517,116,297,104
2011,Winchester 006C,E01023256,1032,699,333,101,96,136
2011,Winchester 006D,E01023257,1155,827,328,131,91,106
2011,Winchester 006E,E01023258,1084,677,407,120,169,118
2011,Winchester 007A,E01023252,1446,1042,404,99,148,157
2011,Winchester 007B,E01023254,1330,1031,299,137,74,88
2011,Winchester 007C,E01023263,988,682,306,138,89,79
2011,Winchester 007D,E01023264,1276,756,520,115,342,63
2011,Winchester 007E,E01023265,1301,901,400,180,112,108
2011,Winchester 007F,E01023267,1027,769,258,62,132,64
2011,Winchester 008A,E01023260,1306,769,537,80,344,113
2011,Winchester 008B,E01023261,1262,775,487,104,246,137
2011,Winchester 008C,E01023262,1225,827,398,86,219,93
2011,Winchester 008D,E01023266,1163,725,438,129,200,109
2011,Winchester 009A,E01023229,1401,1008,393,238,45,110
2011,Winchester 009B,E01023242,934,730,204,113,41,50
2011,Winchester 009C,E01023243,1034,864,170,79,53,38
2011,Winchester 009D,E01023244,1069,686,383,268,52,63
2011,Winchester 009E,E01023259,1101,724,377,173,109,95
2011,Winchester 010A,E01023226,1075,779,296,174,33,89
2011,Winchester 010B,E01023227,1325,1017,308,174,38,96
2011,Winchester 010C,E01023228,1483,1010,473,328,57,88
2011,Winchester 010D,E01023230,1499,1072,427,259,51,117
2011,Winchester 010E,E01023246,1094,818,276,144,40,92
2011,Winchester 011A,E01023235,1454,991,463,276,48,139
2011,Winchester 011B,E01023275,1023,708,315,186,59,70
2011,Winchester 011C,E01023276,1147,789,358,230,53,75
2011,Winchester 011D,E01023277,945,679,266,172,33,61
2011,Winchester 011E,E01023282,1355,960,395,227,62,106
2011,Winchester 012A,E01023220,1489,1154,335,202,42,91
2011,Winchester 012B,E01023221,1186,831,355,240,22,93
2011,Winchester 012C,E01023222,1103,791,312,210,34,68
2011,Winchester 012D,E01023223,1055,740,315,171,43,101
2011,Winchester 012E,E01023272,932,715,217,136,34,47
2011,Winchester 012F,E01023273,1064,805,259,178,33,48
2011,Winchester 013A,E01023245,1777,1234,543,297,51,195
2011,Winchester 013B,E01023271,847,620,227,154,21,52
2011,Winchester 013D,E01023284,2050,1554,496,218,63,215
2011,Winchester 013E,E01023285,1029,691,338,203,31,104
2011,Winchester 013F,E01032859,1252,1056,196,76,41,79
2011,Winchester 013G,E01032860,1113,970,143,51,32,60
2011,Winchester 014A,E01023224,1111,863,248,142,28,78
2011,Winchester 014B,E01023231,1295,924,371,253,38,80
2011,Winchester 014C,E01023232,1365,1010,355,225,42,88
2011,Winchester 014D,E01023233,1013,757,256,172,34,50
2011,Winchester 014E,E01023234,1124,836,288,177,26,85
2011,Ashford 001B,E01023987,761,514,247,152,19,76
2011,Ashford 001C,E01023988,1036,718,318,199,28,91
2011,Ashford 001D,E01024040,773,514,259,160,23,76
2011,Ashford 001E,E01024041,740,531,209,122,29,58
2011,Ashford 001F,E01032810,1045,827,218,83,24,111
2011,Ashford 001G,E01032812,1248,960,288,171,35,82
2011,Ashford 002A,E01023985,827,505,322,224,23,75
2011,Ashford 002B,E01023986,893,596,297,185,21,91
2011,Ashford 002C,E01023989,846,621,225,141,28,56
2011,Ashford 002D,E01023990,883,563,320,148,38,134
2011,Ashford 002E,E01024033,1285,929,356,200,44,112
2011,Ashford 002F,E01024035,773,536,237,158,23,56
2011,Ashford 003A,E01023983,974,665,309,231,25,53
2011,Ashford 003B,E01023999,1592,1119,473,312,48,113
2011,Ashford 003D,E01032811,1150,923,227,99,32,96
2011,Ashford 003E,E01032822,990,729,261,157,36,68
2011,Ashford 004A,E01023980,835,591,244,152,23,69
2011,Ashford 004B,E01023981,874,598,276,140,33,103
2011,Ashford 004C,E01023984,827,552,275,88,37,150
2011,Ashford 004E,E01023992,1069,809,260,100,47,113
2011,Ashford 004F,E01023993,1072,856,216,91,44,81
2011,Ashford 004G,E01024021,971,752,219,118,35,66
2011,Ashford 004H,E01024022,1045,689,356,223,44,89
2011,Ashford 004I,E01032820,1141,920,221,95,28,98
2011,Ashford 004J,E01032821,1178,976,202,77,46,79
2011,Ashford 005A,E01023973,1120,744,376,133,35,208
2011,Ashford 005B,E01024002,1043,816,227,80,28,119
2011,Ashford 005C,E01024023,1737,1328,409,171,64,174
2011,Ashford 005D,E01024027,1255,909,346,99,127,120
2011,Ashford 005E,E01024029,1697,1237,460,212,65,183
2011,Ashford 006A,E01023972,907,649,258,104,33,121
2011,Ashford 006B,E01023995,905,689,216,152,28,36
2011,Ashford 006C,E01023996,977,807,170,89,27,54
2011,Ashford 006D,E01024003,1268,885,383,267,28,88
2011,Ashford 006E,E01024004,1273,942,331,200,41,90
2011,Ashford 006F,E01024005,1131,849,282,144,44,94
2011,Ashford 007A,E01023974,944,661,283,129,34,120
2011,Ashford 007B,E01023975,1154,776,378,151,51,176
2011,Ashford 007C,E01023977,913,687,226,132,17,77
2011,Ashford 007D,E01024016,1053,833,220,99,25,96
2011,Ashford 007E,E01024017,1281,982,299,151,37,111
2011,Ashford 007F,E01024028,1229,853,376,121,57,198
2011,Ashford 008A,E01023976,1139,768,371,151,33,187
2011,Ashford 008B,E01024019,982,701,281,70,54,157
2011,Ashford 008C,E01024020,1232,817,415,84,75,256
2011,Ashford 008E,E01032816,1339,1115,224,98,38,88
2011,Ashford 008F,E01032823,1223,926,297,91,39,167
2011,Ashford 009A,E01024001,1112,785,327,150,28,149
2011,Ashford 009B,E01024006,919,739,180,79,34,67
2011,Ashford 009D,E01024008,1420,1155,265,120,38,107
2011,Ashford 009F,E01032815,708,522,186,51,28,107
2011,Ashford 009G,E01032817,865,728,137,39,26,72
2011,Ashford 009H,E01032818,1077,877,200,64,38,98
2011,Ashford 009I,E01032819,1242,1007,235,65,37,133
2011,Ashford 009J,E01032824,1112,861,251,115,30,106
2011,Ashford 010A,E01024013,1206,847,359,229,39,91
2011,Ashford 010B,E01024014,1266,883,383,236,37,110
2011,Ashford 010C,E01024015,1219,842,377,257,29,91
2011,Ashford 010D,E01024034,1785,1292,493,277,51,165
2011,Ashford 011A,E01023978,922,602,320,212,36,72
2011,Ashford 011B,E01023979,912,634,278,147,34,97
2011,Ashford 011C,E01024032,1149,812,337,185,40,112
2011,Ashford 011D,E01024036,972,698,274,160,23,91
2011,Ashford 012B,E01024031,1072,741,331,208,27,96
2011,Ashford 012C,E01024038,1355,822,533,349,39,145
2011,Ashford 012D,E01024039,1095,753,342,217,37,88
2011,Ashford 012E,E01032813,1310,1119,191,56,34,101
2011,Ashford 012F,E01032814,1320,1000,320,164,34,122
2011,Ashford 013A,E01024009,819,517,302,209,29,64
2011,Ashford 013B,E01024010,914,634,280,168,27,85
2011,Ashford 013C,E01024011,856,611,245,160,21,64
2011,Ashford 013D,E01024012,756,542,214,128,18,68
2011,Ashford 013E,E01024024,1472,934,538,394,37,107
2011,Ashford 013F,E01024025,713,452,261,158,27,76
2011,Ashford 014A,E01023997,1072,736,336,211,27,98
2011,Ashford 014B,E01023998,830,555,275,179,17,79
2011,Ashford 014C,E01024026,894,621,273,168,33,72
2011,Ashford 014D,E01024037,1258,901,357,232,23,102
2011,Canterbury 001A,E01024078,1172,865,307,123,30,154
2011,Canterbury 001B,E01024080,936,650,286,111,31,144
2011,Canterbury 001C,E01024081,1058,680,378,169,35,174
2011,Canterbury 001D,E01024082,961,686,275,129,38,108
2011,Canterbury 001E,E01024095,1079,760,319,185,34,100
2011,Canterbury 002A,E01024094,1764,1146,618,402,64,152
2011,Canterbury 002B,E01024096,1215,728,487,334,41,112
2011,Canterbury 002C,E01024097,1043,611,432,339,22,71
2011,Canterbury 002D,E01024098,1074,683,391,281,28,82
2011,Canterbury 003A,E01024064,1744,1237,507,295,76,136
2011,Canterbury 003B,E01024066,1096,696,400,159,40,201
2011,Canterbury 003C,E01024079,1021,672,349,234,39,76
2011,Canterbury 003D,E01024083,928,563,365,210,26,129
2011,Canterbury 003E,E01024118,1252,795,457,238,47,172
2011,Canterbury 004A,E01024059,1002,593,409,246,35,128
2011,Canterbury 004B,E01024065,1421,992,429,260,40,129
2011,Canterbury 004C,E01024117,1013,622,391,291,26,74
2011,Canterbury 004D,E01024119,1051,713,338,149,55,134
2011,Canterbury 004E,E01024120,1110,658,452,299,35,118
2011,Canterbury 005A,E01024056,1383,828,555,398,58,99
2011,Canterbury 005B,E01024057,1272,780,492,356,33,103
2011,Canterbury 005C,E01024058,1175,840,335,224,38,73
2011,Canterbury 005D,E01024114,1175,826,349,242,39,68
2011,Canterbury 005E,E01024115,977,598,379,290,37,52
2011,Canterbury 006A,E01024073,1415,1017,398,252,48,98
2011,Canterbury 006B,E01024074,1094,818,276,183,35,58
2011,Canterbury 006C,E01024075,1187,746,441,271,34,136
2011,Canterbury 006D,E01024076,1340,1003,337,188,46,103
2011,Canterbury 006E,E01024077,1056,790,266,136,51,79
2011,Canterbury 007A,E01024055,1074,669,405,277,35,93
2011,Canterbury 007B,E01024061,972,575,397,170,54,173
2011,Canterbury 007C,E01024063,1106,785,321,190,37,94
2011,Canterbury 007D,E01024071,1203,888,315,135,58,122
2011,Canterbury 007E,E01024116,1004,647,357,231,41,85
2011,Canterbury 008A,E01024060,1106,780,326,202,50,74
2011,Canterbury 008B,E01024069,977,778,199,84,37,78
2011,Canterbury 008C,E01024070,1038,750,288,174,31,83
2011,Canterbury 008D,E01024072,991,765,226,105,28,93
2011,Canterbury 008E,E01024106,1084,707,377,268,44,65
2011,Canterbury 009A,E01024062,1142,783,359,196,56,107
2011,Canterbury 009B,E01024105,1096,713,383,290,25,68
2011,Canterbury 009C,E01024107,1074,758,316,198,46,72
2011,Canterbury 009D,E01024108,820,472,348,180,25,143
2011,Canterbury 009E,E01024109,1566,1008,558,399,59,100
2011,Canterbury 010A,E01024084,793,541,252,136,33,83
2011,Canterbury 010B,E01024085,1129,804,325,192,56,77
2011,Canterbury 010C,E01024086,1466,1060,406,158,75,173
2011,Canterbury 010D,E01024087,905,588,317,165,27,125
2011,Canterbury 011A,E01024091,1036,661,375,89,100,186
2011,Canterbury 011B,E01024110,943,611,332,233,27,72
2011,Canterbury 011C,E01024111,1047,719,328,172,40,116
2011,Canterbury 011D,E01024112,1178,835,343,238,40,65
2011,Canterbury 011E,E01024113,925,626,299,185,42,72
2011,Canterbury 012C,E01024067,815,559,256,157,51,48
2011,Canterbury 012D,E01024068,1124,670,454,224,168,62
2011,Canterbury 012E,E01024123,1278,781,497,194,258,45
2011,Canterbury 012F,E01032809,5561,2155,3406,338,2954,114
2011,Canterbury 013A,E01024099,1202,610,592,73,400,119
2011,Canterbury 013B,E01024100,1325,635,690,107,519,64
2011,Canterbury 013C,E01024101,1563,814,749,105,554,90
2011,Canterbury 013D,E01024102,1441,824,617,152,386,79
2011,Canterbury 013E,E01024103,1284,688,596,125,338,133
2011,Canterbury 014A,E01024047,1065,696,369,50,134,185
2011,Canterbury 014B,E01024049,1400,914,486,113,169,204
2011,Canterbury 014C,E01024090,2072,1107,965,113,659,193
2011,Canterbury 014D,E01024092,1296,705,591,104,350,137
2011,Canterbury 014E,E01024093,1252,711,541,90,284,167
2011,Canterbury 016A,E01024044,1614,1099,515,133,297,85
2011,Canterbury 016B,E01024045,1151,742,409,164,149,96
2011,Canterbury 016C,E01024046,1406,892,514,209,224,81
2011,Canterbury 016D,E01024048,1690,765,925,75,543,307
2011,Canterbury 016E,E01024131,1209,815,394,126,149,119
2011,Canterbury 017A,E01024052,1563,1171,392,140,82,170
2011,Canterbury 017B,E01024053,1342,981,361,204,67,90
2011,Canterbury 017C,E01024054,1338,936,402,228,69,105
2011,Canterbury 017D,E01024127,1158,812,346,218,38,90
2011,Canterbury 018A,E01024042,1015,690,325,134,36,155
2011,Canterbury 018B,E01024043,1008,669,339,229,36,74
2011,Canterbury 018C,E01024088,1018,739,279,170,54,55
2011,Canterbury 018D,E01024089,842,589,253,139,47,67
2011,Canterbury 019A,E01024128,1194,777,417,101,117,199
2011,Canterbury 019B,E01024129,1517,973,544,77,400,67
2011,Canterbury 019C,E01024130,1917,1385,532,159,222,151
2011,Canterbury 020A,E01024104,1686,1113,573,143,348,82
2011,Canterbury 020B,E01024121,1223,781,442,111,274,57
2011,Canterbury 020C,E01024122,993,625,368,112,197,59
2011,Canterbury 020D,E01024124,1116,572,544,102,410,32
2011,Canterbury 020E,E01024126,1079,648,431,113,171,147
2011,Canterbury 020F,E01032807,1240,793,447,85,317,45
2011,Canterbury 020G,E01032808,1181,767,414,52,257,105
2011,Dartford 001A,E01024148,1112,733,379,142,40,197
2011,Dartford 001B,E01024149,2019,1566,453,125,82,246
2011,Dartford 001C,E01024154,874,613,261,98,33,130
2011,Dartford 001D,E01024155,948,622,326,101,48,177
2011,Dartford 002A,E01024140,2047,1776,271,87,45,139
2011,Dartford 002B,E01024141,1164,889,275,143,38,94
2011,Dartford 002C,E01024143,1789,1527,262,116,36,110
2011,Dartford 002D,E01024179,2066,1657,409,102,76,231
2011,Dartford 003A,E01024180,1124,936,188,76,35,77
2011,Dartford 003B,E01024181,991,788,203,90,38,75
2011,Dartford 003C,E01024182,1213,970,243,77,48,118
2011,Dartford 003D,E01024183,992,741,251,136,39,76
2011,Dartford 003E,E01024184,1420,1154,266,121,48,97
2011,Dartford 003F,E01024185,1493,1154,339,144,58,137
2011,Dartford 004A,E01024142,2064,1720,344,115,49,180
2011,Dartford 004B,E01024176,1134,825,309,139,35,135
2011,Dartford 004C,E01024177,991,653,338,132,39,167
2011,Dartford 004D,E01024178,1174,874,300,119,43,138
2011,Dartford 005A,E01024156,1266,998,268,107,50,111
2011,Dartford 005B,E01024161,1495,1225,270,72,56,142
2011,Dartford 005C,E01024162,1307,1090,217,80,27,110
2011,Dartford 005D,E01024163,1304,991,313,164,40,109
2011,Dartford 005E,E01024164,1434,1136,298,116,49,133
2011,Dartford 006A,E01024169,1056,740,316,144,39,133
2011,Dartford 006B,E01024170,1083,743,340,122,47,171
2011,Dartford 006C,E01024171,1134,867,267,123,35,109
2011,Dartford 006D,E01024172,1570,1288,282,131,23,128
2011,Dartford 007A,E01024144,1106,843,263,137,55,71
2011,Dartford 007B,E01024145,1185,885,300,163,52,85
2011,Dartford 007C,E01024146,1104,791,313,201,49,63
2011,Dartford 007D,E01024147,1250,944,306,197,40,69
2011,Dartford 007E,E01024186,953,720,233,148,23,62
2011,Dartford 008A,E01024133,991,813,178,85,25,68
2011,Dartford 008B,E01024136,1178,933,245,106,43,96
2011,Dartford 008C,E01024137,1087,802,285,147,45,93
2011,Dartford 008D,E01024138,1181,888,293,132,46,115
2011,Dartford 008E,E01024139,1284,953,331,230,39,62
2011,Dartford 009A,E01024165,1046,701,345,120,48,177
2011,Dartford 009B,E01024166,1203,867,336,112,65,159
2011,Dartford 009C,E01024167,1319,948,371,165,55,151
2011,Dartford 009D,E01024168,903,629,274,126,47,101
2011,Dartford 010A,E01024150,1020,672,348,243,42,63
2011,Dartford 010B,E01024151,1002,622,380,296,31,53
2011,Dartford 010C,E01024152,1858,1424,434,149,84,201
2011,Dartford 010D,E01024153,1016,720,296,199,38,59
2011,Dartford 011A,E01024173,1247,931,316,183,31,102
2011,Dartford 011B,E01024187,798,600,198,123,23,52
2011,Dartford 011C,E01024188,871,640,231,145,29,57
2011,Dartford 011D,E01024189,1127,819,308,191,47,70
2011,Dartford 012A,E01024132,924,686,238,107,35,96
2011,Dartford 012B,E01024134,1226,891,335,181,38,116
2011,Dartford 012C,E01024135,991,694,297,141,33,123
2011,Dartford 012D,E01024174,858,649,209,125,19,65
2011,Dartford 012E,E01024175,968,745,223,135,29,59
2011,Dartford 013A,E01024157,1233,861,372,247,31,94
2011,Dartford 013B,E01024158,1061,756,305,192,38,75
2011,Dartford 013C,E01024159,1194,805,389,276,46,67
2011,Dartford 013D,E01024160,1040,676,364,235,46,83
2011,Dover 001A,E01024206,1327,903,424,238,61,125
2011,Dover 001B,E01024207,1319,917,402,244,48,110
2011,Dover 001C,E01024208,1184,831,353,181,47,125
2011,Dover 001D,E01024209,1253,890,363,223,43,97
2011,Dover 002A,E01024202,1318,826,492,273,55,164
2011,Dover 002B,E01024242,1272,797,475,265,83,127
2011,Dover 002C,E01024243,1155,747,408,197,60,151
2011,Dover 002D,E01024244,1287,885,402,283,40,79
2011,Dover 002E,E01024245,1320,872,448,259,64,125
2011,Dover 003A,E01024219,898,537,361,213,25,123
2011,Dover 003B,E01024220,1118,706,412,262,38,112
2011,Dover 003C,E01024221,1171,815,356,220,36,100
2011,Dover 003D,E01024227,1087,735,352,200,48,104
2011,Dover 003E,E01024229,1111,743,368,216,35,117
2011,Dover 004A,E01024228,1169,767,402,235,37,130
2011,Dover 004B,E01024230,1037,693,344,233,22,89
2011,Dover 004C,E01024231,1189,814,375,207,42,126
2011,Dover 004D,E01024252,1826,1253,573,354,67,152
2011,Dover 005A,E01024201,1134,799,335,179,42,114
2011,Dover 005B,E01024217,1247,831,416,232,46,138
2011,Dover 005C,E01024223,1132,758,374,183,56,135
2011,Dover 005D,E01024225,1235,871,364,176,53,135
2011,Dover 005E,E01024226,1028,680,348,195,48,105
2011,Dover 006A,E01024190,1096,688,408,189,36,183
2011,Dover 006B,E01024191,1274,914,360,169,55,136
2011,Dover 006C,E01024192,1145,696,449,194,50,205
2011,Dover 006D,E01024204,1124,722,402,198,47,157
2011,Dover 007A,E01024218,884,610,274,99,41,134
2011,Dover 007B,E01024222,1119,739,380,150,52,178
2011,Dover 007C,E01024224,1135,767,368,215,45,108
2011,Dover 007D,E01024250,1159,718,441,283,45,113
2011,Dover 007E,E01024251,1082,672,410,286,45,79
2011,Dover 008A,E01024200,1306,861,445,260,60,125
2011,Dover 008B,E01024203,1198,836,362,235,45,82
2011,Dover 008C,E01024205,1173,845,328,164,53,111
2011,Dover 008D,E01024255,1149,725,424,310,32,82
2011,Dover 009A,E01024232,1505,933,572,393,54,125
2011,Dover 009B,E01024236,1181,769,412,290,25,97
2011,Dover 009C,E01024237,1144,652,492,364,32,96
2011,Dover 009D,E01024253,1228,756,472,344,42,86
2011,Dover 010C,E01024233,1177,859,318,227,40,51
2011,Dover 010D,E01024235,1110,735,375,285,22,68
2011,Dover 010E,E01024254,1484,1040,444,219,57,168
2011,Dover 010F,E01024256,1069,745,324,242,25,57
2011,Dover 010G,E01033210,1719,1204,515,339,56,120
2011,Dover 011A,E01024193,1121,713,408,141,50,217
2011,Dover 011B,E01024194,1117,827,290,111,57,122
2011,Dover 011C,E01024195,1034,747,287,109,52,126
2011,Dover 011D,E01024196,1043,688,355,117,47,191
2011,Dover 011E,E01024197,1164,825,339,172,38,129
2011,Dover 011F,E01024240,1089,696,393,91,48,254
2011,Dover 011G,E01024241,1467,1056,411,98,79,234
2011,Dover 011H,E01024248,1341,932,409,129,50,230
2011,Dover 012B,E01024238,1270,837,433,99,173,161
2011,Dover 012C,E01024239,1269,864,405,204,43,158
2011,Dover 012D,E01024247,1468,999,469,165,51,253
2011,Dover 012E,E01033209,819,560,259,159,25,75
2011,Dover 012F,E01033211,808,517,291,157,13,121
2011,Dover 013A,E01024214,1199,847,352,145,51,156
2011,Dover 013B,E01024215,1222,858,364,83,103,178
2011,Dover 013C,E01024216,1103,849,254,116,44,94
2011,Dover 013D,E01024246,1460,1060,400,126,49,225
2011,Dover 013E,E01024249,1439,905,534,214,46,274
2011,Dover 014A,E01024198,1792,1131,661,484,45,132
2011,Dover 014B,E01024212,1166,876,290,161,34,95
2011,Dover 014C,E01024213,1052,810,242,172,26,44
2011,Dover 014D,E01024234,1065,725,340,239,29,72
2011,Gravesham 001A,E01024276,1872,1462,410,140,68,202
2011,Gravesham 001B,E01024277,1313,897,416,115,58,243
2011,Gravesham 001C,E01024278,1325,872,453,111,57,285
2011,Gravesham 001D,E01024279,1070,759,311,106,54,151
2011,Gravesham 002A,E01024257,1546,1061,485,106,102,277
2011,Gravesham 002C,E01024290,1230,863,367,124,73,170
2011,Gravesham 002D,E01024291,1282,886,396,127,62,207
2011,Gravesham 002E,E01024295,1298,954,344,129,28,187
2011,Gravesham 002F,E01032799,1195,878,317,85,59,173
2011,Gravesham 002G,E01032800,919,754,165,61,12,92
2011,Gravesham 003A,E01024258,1189,896,293,95,59,139
2011,Gravesham 003B,E01024261,1563,1093,470,333,42,95
2011,Gravesham 003C,E01024293,1211,850,361,144,53,164
2011,Gravesham 003D,E01024294,1525,1086,439,116,68,255
2011,Gravesham 003E,E01024296,2146,1660,486,130,94,262
2011,Gravesham 004A,E01024262,1242,908,334,132,44,158
2011,Gravesham 004B,E01024263,1046,702,344,125,44,175
2011,Gravesham 004C,E01024282,1183,889,294,96,65,133
2011,Gravesham 004D,E01024283,945,698,247,104,46,97
2011,Gravesham 004E,E01024284,1123,852,271,101,49,121
2011,Gravesham 005A,E01024259,1136,813,323,186,54,83
2011,Gravesham 005B,E01024260,1376,996,380,179,53,148
2011,Gravesham 005C,E01024292,1213,883,330,128,67,135
2011,Gravesham 005D,E01024313,1153,872,281,153,33,95
2011,Gravesham 005E,E01024317,1201,893,308,158,53,97
2011,Gravesham 005F,E01024318,1127,860,267,130,42,95
2011,Gravesham 006A,E01024280,1198,855,343,71,60,212
2011,Gravesham 006B,E01024281,1039,742,297,149,51,97
2011,Gravesham 006C,E01024285,989,711,278,131,57,90
2011,Gravesham 006D,E01024287,945,630,315,169,39,107
2011,Gravesham 006E,E01024288,914,597,317,221,20,76
2011,Gravesham 007A,E01024308,952,598,354,135,40,179
2011,Gravesham 007B,E01024310,1070,671,399,205,35,159
2011,Gravesham 007C,E01024311,889,596,293,80,58,155
2011,Gravesham 007D,E01024314,951,695,256,131,43,82
2011,Gravesham 007E,E01024315,1099,730,369,156,52,161
2011,Gravesham 008A,E01024297,1148,865,283,176,26,81
2011,Gravesham 008B,E01024298,1024,747,277,171,41,65
2011,Gravesham 008C,E01024299,1038,758,280,183,30,67
2011,Gravesham 008D,E01024309,893,595,298,118,48,132
2011,Gravesham 008E,E01024312,942,640,302,141,41,120
2011,Gravesham 009A,E01024264,1050,725,325,135,31,159
2011,Gravesham 009B,E01024286,1247,911,336,199,34,103
2011,Gravesham 009C,E01024316,1304,1003,301,165,49,87
2011,Gravesham 009D,E01024319,1101,784,317,132,66,119
2011,Gravesham 010A,E01024265,928,626,302,193,41,68
2011,Gravesham 010B,E01024266,820,561,259,137,38,84
2011,Gravesham 010C,E01024267,1112,755,357,234,37,86
2011,Gravesham 010D,E01024300,1073,753,320,199,37,84
2011,Gravesham 010E,E01024301,906,557,349,203,73,73
2011,Gravesham 011A,E01024303,1115,868,247,114,31,102
2011,Gravesham 011B,E01024304,1097,790,307,145,45,117
2011,Gravesham 011C,E01024305,1048,668,380,102,68,210
2011,Gravesham 011D,E01024306,775,493,282,83,42,157
2011,Gravesham 011E,E01024307,1001,666,335,171,33,131
2011,Gravesham 012A,E01024268,1155,772,383,275,42,66
2011,Gravesham 012B,E01024269,1361,903,458,338,41,79
2011,Gravesham 012C,E01024270,1037,761,276,179,33,64
2011,Gravesham 012D,E01024271,1019,696,323,192,37,94
2011,Gravesham 012E,E01024272,1090,739,351,243,38,70
2011,Gravesham 013A,E01024273,1169,831,338,196,52,90
2011,Gravesham 013B,E01024274,1171,786,385,260,29,96
2011,Gravesham 013C,E01024275,1028,800,228,122,36,70
2011,Gravesham 013D,E01024302,1064,688,376,236,44,96
2011,Maidstone 001A,E01024333,1024,825,199,79,37,83
2011,Maidstone 001B,E01024334,771,623,148,70,18,60
2011,Maidstone 001C,E01024335,1191,908,283,173,41,69
2011,Maidstone 001D,E01024338,1095,868,227,129,30,68
2011,Maidstone 001E,E01024347,1218,925,293,175,42,76
2011,Maidstone 002A,E01024353,1352,1018,334,217,42,75
2011,Maidstone 002B,E01024354,1092,808,284,173,26,85
2011,Maidstone 002C,E01024355,1460,1150,310,128,74,108
2011,Maidstone 002D,E01024385,1126,830,296,159,35,102
2011,Maidstone 002E,E01024386,1216,914,302,162,57,83
2011,Maidstone 003A,E01024320,866,643,223,153,26,44
2011,Maidstone 003B,E01024321,1152,745,407,297,33,77
2011,Maidstone 003C,E01024322,812,565,247,177,17,53
2011,Maidstone 003D,E01024323,961,668,293,226,29,38
2011,Maidstone 003E,E01024324,1009,727,282,207,26,49
2011,Maidstone 003F,E01024341,1214,787,427,301,43,83
2011,Maidstone 004A,E01024352,1339,1024,315,109,53,153
2011,Maidstone 004C,E01024382,1763,1237,526,104,50,372
2011,Maidstone 004D,E01024383,1802,1494,308,68,54,186
2011,Maidstone 004E,E01024384,1345,988,357,158,41,158
2011,Maidstone 004F,E01033090,927,726,201,55,34,112
2011,Maidstone 004G,E01033092,991,789,202,48,41,113
2011,Maidstone 005A,E01024330,1152,805,347,261,32,54
2011,Maidstone 005B,E01024336,1250,931,319,189,55,75
2011,Maidstone 005C,E01024337,1080,835,245,153,40,52
2011,Maidstone 005D,E01024348,1046,829,217,121,29,67
2011,Maidstone 005E,E01024351,1122,757,365,247,47,71
2011,Maidstone 006A,E01024339,1440,1083,357,154,83,120
2011,Maidstone 006B,E01024340,1719,1376,343,154,65,124
2011,Maidstone 006C,E01024356,1231,932,299,115,73,111
2011,Maidstone 006E,E01024373,1372,1041,331,138,53,140
2011,Maidstone 006F,E01033087,1134,941,193,39,60,94
2011,Maidstone 006G,E01033091,1331,1072,259,85,77,97
2011,Maidstone 007A,E01024326,1283,873,410,307,44,59
2011,Maidstone 007B,E01024327,1198,893,305,200,33,72
2011,Maidstone 007C,E01024328,1058,726,332,206,38,88
2011,Maidstone 007D,E01024329,1062,752,310,207,44,59
2011,Maidstone 007E,E01024349,1049,891,158,76,30,52
2011,Maidstone 008A,E01024357,1261,1003,258,94,68,96
2011,Maidstone 008B,E01024358,1226,862,364,182,55,127
2011,Maidstone 008C,E01024367,1019,760,259,105,50,104
2011,Maidstone 008E,E01024369,1108,837,271,160,34,77
2011,Maidstone 008F,E01033088,1065,904,161,58,34,69
2011,Maidstone 008G,E01033089,1130,858,272,87,47,138
2011,Maidstone 009A,E01024360,1141,893,248,127,44,77
2011,Maidstone 009B,E01024372,1541,1205,336,101,60,175
2011,Maidstone 009C,E01024374,1191,789,402,93,76,233
2011,Maidstone 009D,E01024401,1099,879,220,102,38,80
2011,Maidstone 009E,E01024403,1331,1055,276,145,30,101
2011,Maidstone 010A,E01024371,1175,863,312,183,33,96
2011,Maidstone 010B,E01024392,1174,808,366,147,63,156
2011,Maidstone 010C,E01024393,1083,759,324,187,29,108
2011,Maidstone 010D,E01024395,1043,748,295,118,49,128
2011,Maidstone 010E,E01024396,1056,751,305,125,36,144
2011,Maidstone 011A,E01024361,1190,854,336,202,38,96
2011,Maidstone 011B,E01024362,1259,943,316,201,34,81
2011,Maidstone 011C,E01024363,1524,1032,492,294,50,148
2011,Maidstone 011D,E01024387,1838,1287,551,352,57,142
2011,Maidstone 012A,E01024331,1025,712,313,208,35,70
2011,Maidstone 012B,E01024394,1045,731,314,208,44,62
2011,Maidstone 012C,E01024402,1058,739,319,224,35,60
2011,Maidstone 012D,E01024404,1119,822,297,202,32,63
2011,Maidstone 012E,E01024405,1490,1070,420,296,40,84
2011,Maidstone 013A,E01024389,1427,857,570,107,64,399
2011,Maidstone 013B,E01024390,946,613,333,120,27,186
2011,Maidstone 013C,E01024391,940,639,301,98,46,157
2011,Maidstone 013D,E01024397,1018,653,365,138,43,184
2011,Maidstone 013E,E01024398,1200,803,397,116,54,227
2011,Maidstone 013F,E01024399,904,578,326,175,27,124
2011,Maidstone 013G,E01024400,924,588,336,218,29,89
2011,Maidstone 014A,E01024325,1663,1049,614,469,47,98
2011,Maidstone 014B,E01024346,936,638,298,185,32,81
2011,Maidstone 014C,E01024377,1218,820,398,233,34,131
2011,Maidstone 014D,E01024378,978,678,300,186,21,93
2011,Maidstone 015A,E01024332,905,646,259,151,37,71
2011,Maidstone 015B,E01024350,1057,831,226,109,46,71
2011,Maidstone 015C,E01024375,1834,1290,544,337,62,145
2011,Maidstone 015D,E01024388,2105,1648,457,187,75,195
2011,Maidstone 015E,E01024410,1157,782,375,233,30,112
2011,Maidstone 016A,E01024342,1198,867,331,185,30,116
2011,Maidstone 016B,E01024343,1037,748,289,182,44,63
2011,Maidstone 016C,E01024344,1018,686,332,251,25,56
2011,Maidstone 016D,E01024376,1712,1221,491,331,45,115
2011,Maidstone 017A,E01024364,1162,784,378,221,31,126
2011,Maidstone 017B,E01024365,1269,882,387,262,31,94
2011,Maidstone 017C,E01024366,1366,938,428,195,45,188
2011,Maidstone 017D,E01024411,948,654,294,108,90,96
2011,Maidstone 018A,E01024345,1140,837,303,170,42,91
2011,Maidstone 018B,E01024379,1278,921,357,169,54,134
2011,Maidstone 018C,E01024380,1215,902,313,171,47,95
2011,Maidstone 018D,E01024381,977,680,297,130,32,135
2011,Maidstone 019A,E01024406,1014,767,247,124,30,93
2011,Maidstone 019B,E01024407,1123,823,300,147,37,116
2011,Maidstone 019C,E01024408,1072,793,279,177,36,66
2011,Maidstone 019D,E01024409,1046,749,297,204,23,70
2011,Sevenoaks 001A,E01024445,989,722,267,166,41,60
2011,Sevenoaks 001B,E01024446,1120,844,276,157,54,65
2011,Sevenoaks 001C,E01024447,951,647,304,204,33,67
2011,Sevenoaks 001D,E01024472,1029,724,305,142,59,104
2011,Sevenoaks 001E,E01024479,1103,788,315,196,37,82
2011,Sevenoaks 002A,E01024476,1054,693,361,114,53,194
2011,Sevenoaks 002B,E01024477,1004,686,318,113,51,154
2011,Sevenoaks 002C,E01024478,1023,720,303,181,30,92
2011,Sevenoaks 002D,E01024480,1133,739,394,191,47,156
2011,Sevenoaks 002E,E01024481,1135,752,383,208,45,130
2011,Sevenoaks 002F,E01024482,1087,781,306,129,33,144
2011,Sevenoaks 003A,E01024421,1393,963,430,265,47,118
2011,Sevenoaks 003B,E01024473,1184,903,281,143,54,84
2011,Sevenoaks 003C,E01024474,955,677,278,178,46,54
2011,Sevenoaks 003D,E01024475,1101,765,336,195,49,92
2011,Sevenoaks 004A,E01024441,1094,703,391,285,36,70
2011,Sevenoaks 004B,E01024442,1117,752,365,249,31,85
2011,Sevenoaks 004C,E01024443,995,641,354,264,28,62
2011,Sevenoaks 004D,E01024444,942,694,248,140,26,82
2011,Sevenoaks 005A,E01024431,1286,935,351,217,43,91
2011,Sevenoaks 005B,E01024432,1089,813,276,163,30,83
2011,Sevenoaks 005C,E01024433,983,733,250,143,31,76
2011,Sevenoaks 005D,E01024434,1444,1107,337,206,43,88
2011,Sevenoaks 007A,E01024435,1156,832,324,179,40,105
2011,Sevenoaks 007B,E01024436,1151,694,457,338,24,95
2011,Sevenoaks 007C,E01024437,1164,797,367,240,36,91
2011,Sevenoaks 007D,E01024438,1104,766,338,219,38,81
2011,Sevenoaks 008A,E01024422,1333,1065,268,122,40,106
2011,Sevenoaks 008B,E01024423,1216,981,235,102,38,95
2011,Sevenoaks 008C,E01024439,1143,808,335,184,45,106
2011,Sevenoaks 008D,E01024440,1391,1018,373,218,46,109
2011,Sevenoaks 008E,E01024452,977,695,282,167,29,86
2011,Sevenoaks 009A,E01024448,845,660,185,107,14,64
2011,Sevenoaks 009B,E01024449,1015,672,343,224,36,83
2011,Sevenoaks 009C,E01024450,1085,776,309,178,44,87
2011,Sevenoaks 009D,E01024453,1080,733,347,210,43,94
2011,Sevenoaks 009E,E01024454,1057,772,285,160,33,92
2011,Sevenoaks 010A,E01024457,814,568,246,113,26,107
2011,Sevenoaks 010B,E01024460,1137,800,337,162,49,126
2011,Sevenoaks 010C,E01024461,1699,1273,426,193,74,159
2011,Sevenoaks 010D,E01024465,1063,829,234,109,25,100
2011,Sevenoaks 010E,E01024466,950,701,249,99,38,112
2011,Sevenoaks 010F,E01024468,1039,778,261,116,38,107
2011,Sevenoaks 011A,E01024416,1127,810,317,170,38,109
2011,Sevenoaks 011B,E01024418,920,614,306,190,46,70
2011,Sevenoaks 011C,E01024424,877,596,281,124,45,112
2011,Sevenoaks 011D,E01024463,1018,688,330,149,61,120
2011,Sevenoaks 011E,E01024464,1127,727,400,184,73,143
2011,Sevenoaks 011F,E01024467,1137,818,319,167,46,106
2011,Sevenoaks 012A,E01024458,1038,639,399,152,119,128
2011,Sevenoaks 012B,E01024459,1105,776,329,146,65,118
2011,Sevenoaks 012C,E01024462,1161,752,409,182,81,146
2011,Sevenoaks 012D,E01024469,1201,947,254,81,42,131
2011,Sevenoaks 012E,E01024470,1004,711,293,132,49,112
2011,Sevenoaks 012F,E01024471,1156,685,471,140,245,86
2011,Sevenoaks 013A,E01024417,1119,829,290,145,31,114
2011,Sevenoaks 013B,E01024419,1282,904,378,209,52,117
2011,Sevenoaks 013C,E01024483,1177,872,305,159,66,80
2011,Sevenoaks 013D,E01024484,892,645,247,151,27,69
2011,Sevenoaks 013E,E01024485,1177,904,273,118,36,119
2011,Sevenoaks 014A,E01024425,1090,830,260,137,28,95
2011,Sevenoaks 014B,E01024426,1341,1008,333,221,33,79
2011,Sevenoaks 014C,E01024427,920,686,234,122,30,82
2011,Sevenoaks 014D,E01024428,925,684,241,139,24,78
2011,Sevenoaks 014E,E01024429,1098,780,318,142,41,135
2011,Sevenoaks 014F,E01024430,1040,750,290,141,18,131
2011,Sevenoaks 015A,E01024420,1520,1105,415,225,41,149
2011,Sevenoaks 015B,E01024451,1598,1149,449,209,88,152
2011,Sevenoaks 015C,E01024455,861,628,233,122,37,74
2011,Sevenoaks 015D,E01024456,890,579,311,169,45,97
2011,Sevenoaks 016A,E01024413,1219,945,274,143,26,105
2011,Sevenoaks 016B,E01024414,1179,949,230,97,45,88
2011,Sevenoaks 016C,E01024415,1060,778,282,201,34,47
2011,Sevenoaks 016D,E01032619,1209,919,290,175,38,77
2011,Shepway 001A,E01024490,1559,1035,524,340,63,121
2011,Shepway 001B,E01024544,1054,701,353,228,32,93
2011,Shepway 001C,E01024545,1088,754,334,223,36,75
2011,Shepway 001D,E01024547,938,641,297,211,32,54
2011,Shepway 002A,E01024492,1118,774,344,167,60,117
2011,Shepway 002B,E01024541,1730,1208,522,220,83,219
2011,Shepway 002C,E01024542,1468,1035,433,253,57,123
2011,Shepway 002E,E01033213,1244,977,267,82,52,133
2011,Shepway 002F,E01033214,1219,925,294,164,41,89
2011,Shepway 003A,E01024496,1070,697,373,137,51,185
2011,Shepway 003B,E01024497,1160,792,368,186,45,137
2011,Shepway 003C,E01024498,1143,703,440,159,57,224
2011,Shepway 003D,E01024503,1207,847,360,193,43,124
2011,Shepway 003E,E01024518,1274,897,377,214,50,113
2011,Shepway 004A,E01024499,1159,808,351,118,48,185
2011,Shepway 004B,E01024500,850,561,289,93,46,150
2011,Shepway 004C,E01024501,1053,750,303,93,52,158
2011,Shepway 004D,E01024502,1004,714,290,77,36,177
2011,Shepway 004E,E01024505,1291,900,391,146,59,186
2011,Shepway 005A,E01024491,1089,790,299,101,90,108
2011,Shepway 005B,E01024493,1023,709,314,133,46,135
2011,Shepway 005C,E01024494,1201,811,390,176,81,133
2011,Shepway 005D,E01024495,1284,902,382,121,57,204
2011,Shepway 005E,E01024520,1019,687,332,176,41,115
2011,Shepway 005F,E01024528,937,639,298,161,35,102
2011,Shepway 006A,E01024511,984,668,316,179,47,90
2011,Shepway 006B,E01024512,1251,904,347,171,57,119
2011,Shepway 006C,E01024513,1174,840,334,173,65,96
2011,Shepway 006D,E01024514,978,707,271,132,49,90
2011,Shepway 006E,E01024515,1068,722,346,240,34,72
2011,Shepway 006F,E01024516,1025,682,343,196,55,92
2011,Shepway 006G,E01024519,1286,1000,286,169,22,95
2011,Shepway 006H,E01024521,1275,912,363,242,30,91
2011,Shepway 008A,E01024523,1062,624,438,340,31,67
2011,Shepway 008B,E01024526,1070,701,369,276,38,55
2011,Shepway 008C,E01024527,914,589,325,243,20,62
2011,Shepway 008D,E01024550,1491,982,509,338,48,123
2011,Shepway 009A,E01024489,1299,756,543,413,21,109
2011,Shepway 009B,E01024530,1080,736,344,212,52,80
2011,Shepway 009C,E01024536,1482,1036,446,253,43,150
2011,Shepway 009D,E01024546,1184,806,378,229,32,117
2011,Shepway 010A,E01024522,965,651,314,202,20,92
2011,Shepway 010B,E01024524,958,589,369,199,30,140
2011,Shepway 010C,E01024525,1050,652,398,261,39,98
2011,Shepway 010D,E01024529,1017,610,407,272,23,112
2011,Shepway 010E,E01024531,1009,620,389,252,33,104
2011,Shepway 011A,E01024486,1473,842,631,381,52,198
2011,Shepway 011B,E01024487,963,561,402,232,27,143
2011,Shepway 011C,E01024488,913,477,436,330,22,84
2011,Shepway 011D,E01024548,905,632,273,134,30,109
2011,Shepway 011E,E01024549,836,576,260,147,20,93
2011,Shepway 012A,E01024537,1267,768,499,303,38,158
2011,Shepway 012B,E01024538,1268,735,533,396,35,102
2011,Shepway 012C,E01024539,1405,936,469,241,34,194
2011,Shepway 012D,E01024540,1137,726,411,256,41,114
2011,Shepway 013A,E01024532,1091,667,424,280,24,120
2011,Shepway 013B,E01024533,871,498,373,242,18,113
2011,Shepway 013C,E01024534,1053,697,356,138,53,165
2011,Shepway 013D,E01024535,1720,1166,554,296,39,219
2011,Shepway 014A,E01024504,1564,1092,472,104,51,317
2011,Shepway 014B,E01024507,1476,980,496,158,64,274
2011,Shepway 014C,E01033212,1206,865,341,86,44,211
2011,Shepway 014D,E01033215,871,571,300,167,18,115
2011,Shepway 015A,E01024508,1453,1057,396,153,32,211
2011,Shepway 015B,E01024509,1122,774,348,212,39,97
2011,Shepway 015C,E01024510,1248,829,419,239,40,140
2011,Shepway 015D,E01024517,1292,894,398,135,66,197
2011,Swale 001A,E01024609,850,527,323,76,38,209
2011,Swale 001B,E01024610,1096,708,388,118,50,220
2011,Swale 001C,E01024611,1056,728,328,73,41,214
2011,Swale 001D,E01024612,1090,732,358,130,60,168
2011,Swale 002A,E01024613,1016,653,363,144,39,180
2011,Swale 002B,E01024614,1019,589,430,152,42,236
2011,Swale 002C,E01024615,1003,556,447,128,46,273
2011,Swale 002D,E01024616,1146,692,454,201,42,211
2011,Swale 003A,E01024585,985,592,393,201,44,148
2011,Swale 003B,E01024587,1112,706,406,283,38,85
2011,Swale 003C,E01024588,1150,704,446,260,38,148
2011,Swale 003D,E01024589,1214,780,434,296,40,98
2011,Swale 004A,E01024595,1092,742,350,214,44,92
2011,Swale 004B,E01024598,1138,809,329,149,48,132
2011,Swale 004D,E01024619,1071,760,311,193,41,77
2011,Swale 004E,E01024621,804,459,345,128,42,175
2011,Swale 004F,E01032653,1117,809,308,168,40,100
2011,Swale 004G,E01032654,1355,1097,258,79,54,125
2011,Swale 005A,E01024594,1016,674,342,211,36,95
2011,Swale 005B,E01024596,1144,762,382,187,40,155
2011,Swale 005C,E01024597,1032,636,396,158,46,192
2011,Swale 005D,E01024620,976,603,373,238,35,100
2011,Swale 006A,E01024580,1240,608,632,337,41,254
2011,Swale 006B,E01024581,997,615,382,190,37,155
2011,Swale 006C,E01024586,1210,814,396,216,47,133
2011,Swale 006D,E01024618,2571,1238,1333,227,89,1017
2011,Swale 007B,E01024576,1255,997,258,126,37,95
2011,Swale 007C,E01024577,996,723,273,120,45,108
2011,Swale 007D,E01024578,1228,967,261,114,39,108
2011,Swale 007E,E01024579,1969,1500,469,117,70,282
2011,Swale 007F,E01024583,1165,852,313,121,61,131
2011,Swale 007G,E01032655,1134,951,183,78,31,74
2011,Swale 007H,E01032656,1074,797,277,140,32,105
2011,Swale 008A,E01024570,1270,807,463,240,60,163
2011,Swale 008B,E01024571,1175,833,342,209,35,98
2011,Swale 008C,E01024572,876,638,238,115,39,84
2011,Swale 008D,E01024573,946,660,286,182,34,70
2011,Swale 008E,E01024575,891,630,261,156,36,69
2011,Swale 009A,E01024554,1828,1307,521,314,58,149
2011,Swale 009B,E01024561,1010,790,220,94,30,96
2011,Swale 009C,E01024567,1929,1449,480,181,59,240
2011,Swale 009D,E01024568,2002,1528,474,240,75,159
2011,Swale 009E,E01024582,1150,832,318,161,42,115
2011,Swale 010A,E01024559,946,699,247,128,32,87
2011,Swale 010B,E01024584,1177,760,417,160,53,204
2011,Swale 010C,E01024590,1087,641,446,113,45,288
2011,Swale 010D,E01024599,1366,979,387,123,46,218
2011,Swale 010E,E01024608,1233,868,365,151,51,163
2011,Swale 011A,E01024591,1315,978,337,128,41,168
2011,Swale 011B,E01024592,938,704,234,147,28,59
2011,Swale 011C,E01024593,992,729,263,102,47,114
2011,Swale 011D,E01024600,1077,713,364,145,50,169
2011,Swale 011E,E01024601,1201,847,354,183,36,135
2011,Swale 012A,E01024560,902,642,260,103,39,118
2011,Swale 012B,E01024562,1080,766,314,150,39,125
2011,Swale 012C,E01024569,1273,924,349,221,34,94
2011,Swale 012D,E01024630,1145,724,421,285,47,89
2011,Swale 012E,E01024632,1144,763,381,289,34,58
2011,Swale 013A,E01024606,988,700,288,155,42,91
2011,Swale 013C,E01024628,1075,753,322,178,43,101
2011,Swale 013D,E01024629,851,619,232,161,24,47
2011,Swale 013E,E01024631,1199,812,387,271,49,67
2011,Swale 013F,E01032735,1167,863,304,187,42,75
2011,Swale 013G,E01032737,1069,808,261,137,43,81
2011,Swale 014A,E01024564,745,497,248,186,20,42
2011,Swale 014B,E01024603,940,690,250,151,28,71
2011,Swale 014C,E01024604,822,592,230,82,35,113
2011,Swale 014D,E01024605,986,686,300,196,26,78
2011,Swale 014E,E01024626,1099,803,296,186,31,79
2011,Swale 014F,E01024627,1334,867,467,199,44,224
2011,Swale 015A,E01024551,1639,1246,393,163,52,178
2011,Swale 015B,E01024552,1317,931,386,160,50,176
2011,Swale 015C,E01024553,1416,1043,373,239,40,94
2011,Swale 015D,E01024563,1107,675,432,159,51,222
2011,Swale 015E,E01024602,1065,771,294,168,37,89
2011,Swale 015F,E01024625,1365,969,396,263,44,89
2011,Swale 016A,E01024565,958,686,272,168,29,75
2011,Swale 016B,E01024566,1075,704,371,190,47,134
2011,Swale 016C,E01024622,1254,875,379,203,43,133
2011,Swale 016D,E01024623,1382,945,437,245,56,136
2011,Swale 016E,E01024624,1317,882,435,218,56,161
2011,Swale 017A,E01024555,988,694,294,187,29,78
2011,Swale 017B,E01024556,872,597,275,162,38,75
2011,Swale 017C,E01024557,1090,748,342,189,45,108
2011,Swale 017D,E01024558,1213,866,347,207,53,87
2011,Thanet 001A,E01024657,1572,1044,528,106,65,357
2011,Thanet 001B,E01024658,1417,893,524,206,61,257
2011,Thanet 001C,E01024659,1036,676,360,148,41,171
2011,Thanet 001D,E01024660,1212,801,411,113,53,245
2011,Thanet 001E,E01024678,1441,899,542,177,37,328
2011,Thanet 002A,E01024653,1072,701,371,269,50,52
2011,Thanet 002B,E01024654,1001,579,422,293,40,89
2011,Thanet 002C,E01024655,1015,613,402,278,35,89
2011,Thanet 002D,E01024656,1183,746,437,283,31,123
2011,Thanet 002E,E01024675,1548,993,555,382,74,99
2011,Thanet 003A,E01024676,1242,770,472,141,31,300
2011,Thanet 003B,E01024677,1195,822,373,96,94,183
2011,Thanet 003C,E01024695,879,644,235,76,47,112
2011,Thanet 003D,E01024697,846,550,296,82,43,171
2011,Thanet 003E,E01024710,904,617,287,93,32,162
2011,Thanet 004A,E01024661,1069,699,370,106,45,219
2011,Thanet 004B,E01024664,1029,701,328,137,41,150
2011,Thanet 004C,E01024665,1038,754,284,137,34,113
2011,Thanet 004D,E01024694,1247,906,341,142,64,135
2011,Thanet 004E,E01024696,962,647,315,187,36,92
2011,Thanet 005A,E01024672,1008,618,390,172,56,162
2011,Thanet 005B,E01024673,1254,861,393,237,44,112
2011,Thanet 005C,E01024674,1173,866,307,163,56,88
2011,Thanet 005D,E01024711,1048,706,342,184,51,107
2011,Thanet 005E,E01024712,1125,768,357,235,40,82
2011,Thanet 006A,E01024633,1067,666,401,168,47,186
2011,Thanet 006B,E01024634,968,669,299,121,44,134
2011,Thanet 006C,E01024662,1082,637,445,244,40,161
2011,Thanet 006D,E01024663,1035,611,424,96,65,263
2011,Thanet 006E,E01024666,1112,653,459,157,52,250
2011,Thanet 007A,E01024641,1027,596,431,269,32,130
2011,Thanet 007B,E01024713,1155,733,422,197,53,172
2011,Thanet 007C,E01024714,1012,572,440,261,38,141
2011,Thanet 007D,E01024715,1336,852,484,262,49,173
2011,Thanet 007E,E01024716,1423,1004,419,217,64,138
2011,Thanet 008A,E01024636,1383,828,555,433,23,99
2011,Thanet 008B,E01024637,1138,618,520,384,42,94
2011,Thanet 008C,E01024638,1064,615,449,311,32,106
2011,Thanet 008D,E01024639,1140,701,439,289,38,112
2011,Thanet 008E,E01024640,1083,609,474,340,29,105
2011,Thanet 009A,E01024635,1144,759,385,247,41,97
2011,Thanet 009B,E01024642,994,549,445,326,40,79
2011,Thanet 009C,E01024644,902,565,337,262,25,50
2011,Thanet 009D,E01024692,1121,744,377,234,52,91
2011,Thanet 009E,E01024693,956,650,306,214,32,60
2011,Thanet 010A,E01024643,924,631,293,159,42,92
2011,Thanet 010B,E01024705,924,607,317,176,44,97
2011,Thanet 010C,E01024706,1026,702,324,208,40,76
2011,Thanet 010D,E01024707,943,671,272,170,38,64
2011,Thanet 010E,E01024708,1092,614,478,319,66,93
2011,Thanet 011A,E01024686,1177,742,435,242,54,139
2011,Thanet 011B,E01024688,1122,668,454,281,33,140
2011,Thanet 011C,E01024689,878,586,292,182,49,61
2011,Thanet 011D,E01024690,1004,609,395,240,50,105
2011,Thanet 011E,E01024691,956,641,315,136,104,75
2011,Thanet 012A,E01024669,1215,910,305,122,56,127
2011,Thanet 012B,E01024698,1047,729,318,160,45,113
2011,Thanet 012C,E01024699,1258,792,466,197,57,212
2011,Thanet 012D,E01024700,1258,888,370,181,50,139
2011,Thanet 012E,E01024709,971,589,382,279,32,71
2011,Thanet 013A,E01024682,1178,733,445,136,49,260
2011,Thanet 013B,E01024683,1149,591,558,190,78,290
2011,Thanet 013C,E01024684,1125,743,382,150,47,185
2011,Thanet 013D,E01024685,1289,802,487,212,64,211
2011,Thanet 013E,E01024687,1031,634,397,121,48,228
2011,Thanet 014A,E01024701,1546,1077,469,299,47,123
2011,Thanet 014B,E01024702,892,562,330,212,29,89
2011,Thanet 014C,E01024703,1258,877,381,256,45,80
2011,Thanet 014D,E01024704,1189,812,377,227,40,110
2011,Thanet 015A,E01024645,1079,758,321,143,59,119
2011,Thanet 015B,E01024647,1166,852,314,115,55,144
2011,Thanet 015C,E01024668,919,579,340,97,135,108
2011,Thanet 015D,E01024670,1087,727,360,141,52,167
2011,Thanet 015E,E01024681,1243,883,360,138,59,163
2011,Thanet 016A,E01024646,1372,925,447,201,43,203
2011,Thanet 016B,E01024648,1081,746,335,159,30,146
2011,Thanet 016C,E01024649,1313,870,443,173,48,222
2011,Thanet 016D,E01024667,1327,791,536,216,45,275
2011,Thanet 016E,E01024671,1236,802,434,216,58,160
2011,Thanet 017A,E01024650,1095,731,364,245,42,77
2011,Thanet 017B,E01024651,1046,656,390,256,36,98
2011,Thanet 017C,E01024652,1350,923,427,294,41,92
2011,Thanet 017D,E01024679,894,510,384,294,28,62
2011,Thanet 017E,E01024680,1134,804,330,213,39,78
2011,Tonbridge and Malling 001A,E01024719,1497,1155,342,168,49,125
2011,Tonbridge and Malling 001B,E01024720,1026,726,300,197,38,65
2011,Tonbridge and Malling 001C,E01024721,967,709,258,168,38,52
2011,Tonbridge and Malling 001D,E01024722,1040,784,256,154,43,59
2011,Tonbridge and Malling 001E,E01024727,2026,1556,470,245,69,156
2011,Tonbridge and Malling 001F,E01024728,1212,904,308,176,34,98
2011,Tonbridge and Malling 002C,E01024771,1344,1002,342,125,43,174
2011,Tonbridge and Malling 002D,E01024772,1250,993,257,147,41,69
2011,Tonbridge and Malling 002E,E01024773,1304,967,337,228,30,79
2011,Tonbridge and Malling 002F,E01024774,1846,1438,408,181,56,171
2011,Tonbridge and Malling 002G,E01032830,1769,1287,482,176,64,242
2011,Tonbridge and Malling 003A,E01024741,1045,677,368,139,52,177
2011,Tonbridge and Malling 003B,E01024761,1624,1208,416,235,65,116
2011,Tonbridge and Malling 003C,E01024762,1586,1276,310,171,40,99
2011,Tonbridge and Malling 003D,E01024763,1029,727,302,199,30,73
2011,Tonbridge and Malling 003E,E01024764,929,684,245,155,25,65
2011,Tonbridge and Malling 003F,E01024765,1066,783,283,191,35,57
2011,Tonbridge and Malling 003G,E01024782,977,756,221,116,41,64
2011,Tonbridge and Malling 003H,E01024785,1075,815,260,152,33,75
2011,Tonbridge and Malling 005A,E01024717,1080,653,427,249,37,141
2011,Tonbridge and Malling 005B,E01024718,1018,743,275,205,27,43
2011,Tonbridge and Malling 005C,E01024735,1144,834,310,214,28,68
2011,Tonbridge and Malling 005D,E01024736,1212,901,311,170,26,115
2011,Tonbridge and Malling 005E,E01024737,1674,1269,405,214,52,139
2011,Tonbridge and Malling 006A,E01024723,1117,776,341,180,35,126
2011,Tonbridge and Malling 006B,E01024724,1353,920,433,247,61,125
2011,Tonbridge and Malling 006C,E01024725,1133,811,322,193,45,84
2011,Tonbridge and Malling 006D,E01024726,1219,871,348,196,51,101
2011,Tonbridge and Malling 006E,E01024755,1444,971,473,254,71,148
2011,Tonbridge and Malling 006F,E01024786,1285,882,403,225,40,138
2011,Tonbridge and Malling 007A,E01024746,801,588,213,113,36,64
2011,Tonbridge and Malling 007C,E01024760,1081,804,277,147,32,98
2011,Tonbridge and Malling 007D,E01024781,1485,1088,397,230,61,106
2011,Tonbridge and Malling 007E,E01032825,1049,840,209,56,39,114
2011,Tonbridge and Malling 007F,E01032826,1078,880,198,79,36,83
2011,Tonbridge and Malling 007G,E01032827,1121,902,219,86,38,95
2011,Tonbridge and Malling 007H,E01032828,847,673,174,84,29,61
2011,Tonbridge and Malling 008A,E01024743,1318,951,367,216,36,115
2011,Tonbridge and Malling 008B,E01024744,1531,1093,438,268,64,106
2011,Tonbridge and Malling 008C,E01024745,1367,938,429,218,111,100
2011,Tonbridge and Malling 008D,E01024747,1097,757,340,160,46,134
2011,Tonbridge and Malling 009A,E01024730,868,578,290,202,27,61
2011,Tonbridge and Malling 009B,E01024731,849,554,295,207,30,58
2011,Tonbridge and Malling 009C,E01024775,1082,716,366,155,33,178
2011,Tonbridge and Malling 009D,E01024776,900,606,294,155,45,94
2011,Tonbridge and Malling 009E,E01024777,890,607,283,151,33,99
2011,Tonbridge and Malling 010A,E01024734,1118,796,322,199,36,87
2011,Tonbridge and Malling 010B,E01024752,1114,825,289,180,36,73
2011,Tonbridge and Malling 010C,E01024753,1127,799,328,160,52,116
2011,Tonbridge and Malling 010D,E01024754,1210,877,333,156,60,117
2011,Tonbridge and Malling 011A,E01024729,1196,795,401,209,61,131
2011,Tonbridge and Malling 011B,E01024748,1028,727,301,199,41,61
2011,Tonbridge and Malling 011C,E01024749,993,711,282,146,31,105
2011,Tonbridge and Malling 011D,E01024750,1008,679,329,218,25,86
2011,Tonbridge and Malling 011E,E01024751,1010,642,368,265,40,63
2011,Tonbridge and Malling 012A,E01024732,1359,953,406,79,264,63
2011,Tonbridge and Malling 012B,E01024733,1223,920,303,134,68,101
2011,Tonbridge and Malling 012C,E01024756,1168,880,288,126,49,113
2011,Tonbridge and Malling 012D,E01024766,1526,1208,318,153,57,108
2011,Tonbridge and Malling 012E,E01024767,1075,767,308,123,46,139
2011,Tonbridge and Malling 012F,E01024768,1187,916,271,147,46,78
2011,Tonbridge and Malling 013A,E01024757,1174,903,271,135,49,87
2011,Tonbridge and Malling 013B,E01024758,1164,910,254,119,48,87
2011,Tonbridge and Malling 013C,E01024778,1174,938,236,103,47,86
2011,Tonbridge and Malling 013D,E01024779,1367,1053,314,141,63,110
2011,Tonbridge and Malling 013E,E01024780,1156,886,270,113,48,109
2011,Tonbridge and Malling 014A,E01024740,1351,968,383,206,51,126
2011,Tonbridge and Malling 014B,E01024742,1193,814,379,167,38,174
2011,Tonbridge and Malling 014C,E01024783,1184,845,339,184,38,117
2011,Tonbridge and Malling 014D,E01024784,988,706,282,163,46,73
2011,Tonbridge and Malling 014E,E01032620,1688,1163,525,335,58,132
2011,Tonbridge and Malling 014F,E01032829,999,705,294,174,33,87
2011,Tunbridge Wells 001A,E01024798,1775,1346,429,227,56,146
2011,Tunbridge Wells 001B,E01024811,914,604,310,200,45,65
2011,Tunbridge Wells 001C,E01024812,911,656,255,130,38,87
2011,Tunbridge Wells 001D,E01024813,1235,982,253,136,26,91
2011,Tunbridge Wells 001E,E01024814,956,696,260,153,48,59
2011,Tunbridge Wells 001F,E01024815,980,717,263,130,35,98
2011,Tunbridge Wells 001G,E01024816,974,719,255,113,49,93
2011,Tunbridge Wells 002A,E01024837,1330,1006,324,129,86,109
2011,Tunbridge Wells 002B,E01024844,1203,942,261,95,47,119
2011,Tunbridge Wells 002C,E01024846,1176,880,296,131,47,118
2011,Tunbridge Wells 002D,E01024849,1189,884,305,142,58,105
2011,Tunbridge Wells 002E,E01024850,935,603,332,193,61,78
2011,Tunbridge Wells 003A,E01024836,1263,975,288,108,57,123
2011,Tunbridge Wells 003B,E01024839,1276,991,285,159,36,90
2011,Tunbridge Wells 003C,E01024845,926,643,283,133,59,91
2011,Tunbridge Wells 003D,E01024847,1191,907,284,113,38,133
2011,Tunbridge Wells 003E,E01024848,849,551,298,167,42,89
2011,Tunbridge Wells 004A,E01024793,1246,881,365,202,55,108
2011,Tunbridge Wells 004B,E01024825,1045,721,324,178,71,75
2011,Tunbridge Wells 004C,E01024826,1075,750,325,206,38,81
2011,Tunbridge Wells 004D,E01024827,1124,795,329,188,36,105
2011,Tunbridge Wells 004E,E01024828,1089,800,289,147,36,106
2011,Tunbridge Wells 005A,E01024840,1351,929,422,115,58,249
2011,Tunbridge Wells 005B,E01024841,1364,957,407,139,52,216
2011,Tunbridge Wells 005C,E01024842,1145,765,380,171,47,162
2011,Tunbridge Wells 005D,E01024843,1070,812,258,61,39,158
2011,Tunbridge Wells 006A,E01024829,1187,898,289,172,51,66
2011,Tunbridge Wells 006B,E01024851,1168,847,321,157,51,113
2011,Tunbridge Wells 006C,E01024852,922,600,322,185,51,86
2011,Tunbridge Wells 006D,E01024853,947,639,308,155,64,89
2011,Tunbridge Wells 006E,E01024854,1123,798,325,155,62,108
2011,Tunbridge Wells 007A,E01024799,1438,1107,331,162,55,114
2011,Tunbridge Wells 007B,E01024800,1155,837,318,167,79,72
2011,Tunbridge Wells 007C,E01024835,1556,1244,312,109,86,117
2011,Tunbridge Wells 007D,E01024838,1233,1012,221,73,54,94
2011,Tunbridge Wells 008A,E01024801,2157,1826,331,109,54,168
2011,Tunbridge Wells 008B,E01024802,1678,1423,255,95,54,106
2011,Tunbridge Wells 008C,E01024823,1390,1095,295,135,53,107
2011,Tunbridge Wells 008D,E01024833,1846,1462,384,122,52,210
2011,Tunbridge Wells 009A,E01024821,1353,973,380,219,32,129
2011,Tunbridge Wells 009B,E01024822,1352,864,488,231,82,175
2011,Tunbridge Wells 009C,E01024824,1075,804,271,155,45,71
2011,Tunbridge Wells 009D,E01024832,1187,942,245,111,35,99
2011,Tunbridge Wells 009E,E01024834,1666,1398,268,89,40,139
2011,Tunbridge Wells 010A,E01024795,1010,682,328,110,54,164
2011,Tunbridge Wells 010B,E01024796,1019,727,292,123,36,133
2011,Tunbridge Wells 010C,E01024830,1298,968,330,164,33,133
2011,Tunbridge Wells 010D,E01024831,1039,782,257,100,42,115
2011,Tunbridge Wells 011A,E01024792,1363,973,390,195,71,124
2011,Tunbridge Wells 011B,E01024794,1172,809,363,169,59,135
2011,Tunbridge Wells 011C,E01024804,1050,730,320,133,85,102
2011,Tunbridge Wells 011D,E01024805,1196,888,308,161,59,88
2011,Tunbridge Wells 011E,E01024806,1305,824,481,163,120,198
2011,Tunbridge Wells 012A,E01024797,1232,833,399,255,52,92
2011,Tunbridge Wells 012B,E01024817,1266,902,364,191,53,120
2011,Tunbridge Wells 012C,E01024818,1199,868,331,182,48,101
2011,Tunbridge Wells 012D,E01024819,1342,1106,236,100,44,92
2011,Tunbridge Wells 012E,E01024820,1150,791,359,183,63,113
2011,Tunbridge Wells 013A,E01024787,897,651,246,103,48,95
2011,Tunbridge Wells 013B,E01024788,1040,741,299,133,51,115
2011,Tunbridge Wells 013C,E01024790,833,529,304,95,133,76
2011,Tunbridge Wells 013D,E01024791,925,622,303,176,50,77
2011,Tunbridge Wells 013E,E01024803,1581,1061,520,308,83,129
2011,Tunbridge Wells 014A,E01024789,1583,970,613,205,258,150
2011,Tunbridge Wells 014B,E01024807,1080,764,316,167,41,108
2011,Tunbridge Wells 014C,E01024808,1157,860,297,166,38,93
2011,Tunbridge Wells 014D,E01024809,1075,750,325,180,58,87
2011,Tunbridge Wells 014E,E01024810,1215,874,341,149,66,126
2011,Cherwell 001A,E01028479,950,716,234,147,20,67
2011,Cherwell 001B,E01028480,1047,766,281,177,29,75
2011,Cherwell 001C,E01028508,798,571,227,134,35,58
2011,Cherwell 001D,E01028509,1124,850,274,189,28,57
2011,Cherwell 002A,E01028441,1771,1410,361,122,53,186
2011,Cherwell 002C,E01028443,1100,909,191,91,27,73
2011,Cherwell 002D,E01028444,1170,910,260,166,34,60
2011,Cherwell 002E,E01032943,1149,963,186,59,37,90
2011,Cherwell 002F,E01032944,1053,873,180,97,18,65
2011,Cherwell 003A,E01028445,1023,783,240,91,30,119
2011,Cherwell 003B,E01028446,1097,780,317,171,35,111
2011,Cherwell 003C,E01028447,942,729,213,81,32,100
2011,Cherwell 003D,E01028448,1055,766,289,123,34,132
2011,Cherwell 004A,E01028435,1228,898,330,115,45,170
2011,Cherwell 004C,E01028437,1144,885,259,112,31,116
2011,Cherwell 004D,E01028438,1283,1046,237,71,40,126
2011,Cherwell 004E,E01028439,1067,902,165,67,34,64
2011,Cherwell 004F,E01028440,1237,984,253,59,40,154
2011,Cherwell 004G,E01032941,997,658,339,120,53,166
2011,Cherwell 004H,E01032942,1108,920,188,17,25,146
2011,Cherwell 005A,E01028449,924,631,293,149,25,119
2011,Cherwell 005B,E01028450,1022,707,315,81,52,182
2011,Cherwell 005C,E01028451,946,722,224,103,29,92
2011,Cherwell 005D,E01028452,956,656,300,99,54,147
2011,Cherwell 005E,E01028453,949,675,274,111,41,122
2011,Cherwell 005F,E01028454,1055,683,372,150,54,168
2011,Cherwell 006A,E01028430,1140,859,281,117,35,129
2011,Cherwell 006B,E01028431,1088,768,320,205,38,77
2011,Cherwell 006C,E01028432,1127,806,321,217,37,67
2011,Cherwell 006D,E01028433,1181,803,378,268,35,75
2011,Cherwell 006E,E01028434,1064,730,334,178,110,46
2011,Cherwell 007A,E01028426,1024,815,209,131,34,44
2011,Cherwell 007B,E01028427,1166,944,222,88,42,92
2011,Cherwell 007C,E01028428,1089,818,271,191,28,52
2011,Cherwell 007D,E01028429,735,526,209,156,18,35
2011,Cherwell 008A,E01028422,1108,827,281,172,29,80
2011,Cherwell 008B,E01028423,1021,699,322,231,32,59
2011,Cherwell 008C,E01028475,1562,1102,460,304,59,97
2011,Cherwell 008D,E01028476,1723,1216,507,260,175,72
2011,Cherwell 009A,E01028474,1154,866,288,173,29,86
2011,Cherwell 009B,E01028485,915,674,241,136,42,63
2011,Cherwell 009C,E01028486,955,677,278,174,35,69
2011,Cherwell 009D,E01028503,859,579,280,198,25,57
2011,Cherwell 009E,E01028504,1114,774,340,168,94,78
2011,Cherwell 010A,E01028481,986,695,291,198,30,63
2011,Cherwell 010B,E01028482,872,641,231,149,33,49
2011,Cherwell 010C,E01028505,1314,975,339,154,74,111
2011,Cherwell 010D,E01028506,1303,973,330,182,49,99
2011,Cherwell 010E,E01028507,1062,768,294,187,37,70
2011,Cherwell 011A,E01028425,1630,1391,239,61,27,151
2011,Cherwell 011B,E01028477,1100,859,241,127,32,82
2011,Cherwell 011C,E01028478,961,777,184,51,32,101
2011,Cherwell 011D,E01028483,925,714,211,125,25,61
2011,Cherwell 011E,E01028484,822,652,170,83,24,63
2011,Cherwell 011F,E01028499,1143,880,263,169,31,63
2011,Cherwell 012A,E01028459,1139,999,140,46,28,66
2011,Cherwell 012B,E01028460,1454,1247,207,58,42,107
2011,Cherwell 012C,E01028461,1321,1158,163,55,28,80
2011,Cherwell 012D,E01028462,1181,953,228,106,25,97
2011,Cherwell 013A,E01028455,1105,929,176,91,28,57
2011,Cherwell 013B,E01028456,1060,761,299,163,34,102
2011,Cherwell 013C,E01028457,1078,840,238,129,47,62
2011,Cherwell 013D,E01028458,1151,956,195,62,26,107
2011,Cherwell 013E,E01028467,1168,903,265,173,19,73
2011,Cherwell 014A,E01028466,1199,864,335,151,35,149
2011,Cherwell 014B,E01028469,1116,791,325,221,33,71
2011,Cherwell 014C,E01028470,1263,939,324,201,30,93
2011,Cherwell 014D,E01028471,959,713,246,104,31,111
2011,Cherwell 014E,E01028472,984,800,184,98,25,61
2011,Cherwell 014F,E01028473,1185,1009,176,82,32,62
2011,Cherwell 015A,E01028463,1824,1610,214,66,42,106
2011,Cherwell 015B,E01028464,1058,915,143,67,23,53
2011,Cherwell 015C,E01028465,1019,904,115,47,22,46
2011,Cherwell 015D,E01028468,1267,934,333,188,37,108
2011,Cherwell 016A,E01028424,1144,869,275,166,32,77
2011,Cherwell 016B,E01028497,1003,746,257,157,29,71
2011,Cherwell 016C,E01028498,1180,888,292,149,50,93
2011,Cherwell 016D,E01028500,1796,840,956,159,30,767
2011,Cherwell 016E,E01028501,914,681,233,146,29,58
2011,Cherwell 016F,E01028502,875,660,215,133,35,47
2011,Cherwell 017A,E01028487,967,780,187,77,40,70
2011,Cherwell 017B,E01028489,1013,692,321,247,39,35
2011,Cherwell 017C,E01028490,862,626,236,147,25,64
2011,Cherwell 017D,E01028491,1072,789,283,171,41,71
2011,Cherwell 017E,E01028494,846,628,218,97,38,83
2011,Cherwell 018A,E01028492,1077,801,276,187,32,57
2011,Cherwell 018B,E01028493,988,716,272,154,42,76
2011,Cherwell 018C,E01028495,972,773,199,103,32,64
2011,Cherwell 018D,E01028496,990,777,213,87,42,84
2011,Cherwell 019A,E01028488,1286,929,357,86,84,187
2011,Cherwell 019B,E01028510,1156,862,294,173,40,81
2011,Cherwell 019C,E01028511,1152,794,358,247,50,61
2011,Cherwell 019D,E01028512,1107,883,224,145,37,42
2011,Oxford 001A,E01028594,1133,787,346,177,88,81
2011,Oxford 001B,E01028595,1017,797,220,118,32,70
2011,Oxford 001C,E01028596,1057,780,277,137,69,71
2011,Oxford 001D,E01028597,1029,747,282,111,79,92
2011,Oxford 002C,E01028591,907,675,232,97,83,52
2011,Oxford 002D,E01028592,1061,666,395,58,292,45
2011,Oxford 002F,E01032554,1481,1067,414,189,127,98
2011,Oxford 002G,E01032555,1558,1083,475,88,223,164
2011,Oxford 003A,E01028565,970,749,221,88,90,43
2011,Oxford 003B,E01028583,1119,514,605,91,457,57
2011,Oxford 003C,E01028584,1908,1361,547,183,170,194
2011,Oxford 003D,E01028585,1229,541,688,57,583,48
2011,Oxford 004A,E01028560,1079,782,297,152,59,86
2011,Oxford 004B,E01028561,1129,809,320,186,71,63
2011,Oxford 004C,E01028562,1169,874,295,96,113,86
2011,Oxford 004D,E01028563,1131,842,289,108,123,58
2011,Oxford 005A,E01028513,1575,1081,494,101,138,255
2011,Oxford 005B,E01028514,1009,702,307,105,56,146
2011,Oxford 005C,E01028516,1272,905,367,141,80,146
2011,Oxford 005D,E01028538,1031,755,276,103,65,108
2011,Oxford 006A,E01028534,744,553,191,74,78,39
2011,Oxford 006B,E01028535,1283,945,338,104,171,63
2011,Oxford 006C,E01028536,1060,738,322,98,138,86
2011,Oxford 006D,E01028537,1278,930,348,101,184,63
2011,Oxford 006E,E01028539,1413,1038,375,100,183,92
2011,Oxford 006F,E01028540,2388,1145,1243,99,1084,60
2011,Oxford 007A,E01028515,1265,985,280,110,65,105
2011,Oxford 007B,E01028571,1210,894,316,129,100,87
2011,Oxford 007C,E01028572,1230,973,257,135,56,66
2011,Oxford 007D,E01028573,1248,947,301,118,117,66
2011,Oxford 007E,E01028574,1002,663,339,157,82,100
2011,Oxford 008A,E01028521,8148,1687,6461,51,6312,98
2011,Oxford 008B,E01028522,3288,895,2393,69,2118,206
2011,Oxford 008E,E01033282,3786,1670,2116,169,1778,169
2011,Oxford 009A,E01028548,1325,1002,323,98,132,93
2011,Oxford 009B,E01028549,1359,999,360,86,187,87
2011,Oxford 009C,E01028550,1212,752,460,66,310,84
2011,Oxford 009D,E01028551,1890,815,1075,88,905,82
2011,Oxford 010A,E01028523,1171,819,352,76,167,109
2011,Oxford 010B,E01028524,1054,732,322,85,72,165
2011,Oxford 010C,E01028525,1423,871,552,113,272,167
2011,Oxford 010D,E01028526,2121,1048,1073,66,956,51
2011,Oxford 011A,E01028579,1488,863,625,44,504,77
2011,Oxford 011B,E01028580,1323,791,532,60,391,81
2011,Oxford 011C,E01028581,1281,772,509,85,375,49
2011,Oxford 011D,E01028582,1193,630,563,75,396,92
2011,Oxford 011E,E01028586,1528,883,645,53,506,86
2011,Oxford 011F,E01028587,1737,1031,706,60,529,117
2011,Oxford 011G,E01028588,1499,670,829,19,759,51
2011,Oxford 012A,E01028541,1171,858,313,82,155,76
2011,Oxford 012B,E01028542,1461,1127,334,85,113,136
2011,Oxford 012C,E01028543,1024,678,346,108,115,123
2011,Oxford 012D,E01028544,1046,722,324,63,210,51
2011,Oxford 013A,E01028531,1837,1361,476,72,307,97
2011,Oxford 013B,E01028532,2130,1474,656,112,313,231
2011,Oxford 013C,E01028533,1674,1209,465,77,164,224
2011,Oxford 013D,E01028556,1378,1057,321,91,83,147
2011,Oxford 013E,E01028557,1618,1129,489,117,232,140
2011,Oxford 013F,E01028558,1280,975,305,128,70,107
2011,Oxford 013G,E01028559,1344,1039,305,98,87,120
2011,Oxford 014A,E01028545,1337,958,379,72,209,98
2011,Oxford 014B,E01028546,1417,955,462,138,119,205
2011,Oxford 014C,E01028547,1813,1285,528,57,347,124
2011,Oxford 015A,E01028527,1258,968,290,119,62,109
2011,Oxford 015B,E01028528,1148,868,280,67,88,125
2011,Oxford 015C,E01028529,1113,817,296,93,43,160
2011,Oxford 015D,E01028530,1239,935,304,104,72,128
2011,Oxford 015E,E01028575,1148,814,334,178,60,96
2011,Oxford 015F,E01028578,1161,899,262,108,51,103
2011,Oxford 016A,E01028552,1160,806,354,117,51,186
2011,Oxford 016B,E01028553,1394,1009,385,92,47,246
2011,Oxford 016C,E01028554,1016,760,256,132,42,82
2011,Oxford 016D,E01028555,1200,945,255,110,42,103
2011,Oxford 016E,E01028576,978,658,320,66,56,198
2011,Oxford 016F,E01028577,1367,926,441,147,69,225
2011,Oxford 017A,E01028517,934,721,213,61,27,125
2011,Oxford 017B,E01028518,1114,735,379,141,46,192
2011,Oxford 017C,E01028519,1001,721,280,98,54,128
2011,Oxford 017D,E01028567,1238,892,346,115,62,169
2011,Oxford 018A,E01028520,1124,760,364,113,57,194
2011,Oxford 018B,E01028568,1032,669,363,120,41,202
2011,Oxford 018C,E01028569,1134,816,318,52,67,199
2011,Oxford 018D,E01028570,1337,1119,218,39,53,126
2011,South Oxfordshire 001A,E01028666,1155,972,183,115,29,39
2011,South Oxfordshire 001B,E01028667,1037,896,141,66,25,50
2011,South Oxfordshire 001C,E01028668,1014,821,193,121,33,39
2011,South Oxfordshire 001D,E01028669,968,770,198,123,26,49
2011,South Oxfordshire 002A,E01028638,1038,770,268,149,45,74
2011,South Oxfordshire 002B,E01028639,1053,775,278,95,117,66
2011,South Oxfordshire 002C,E01028640,1080,766,314,144,96,74
2011,South Oxfordshire 002D,E01028683,1029,762,267,181,37,49
2011,South Oxfordshire 003A,E01028670,1013,725,288,185,33,70
2011,South Oxfordshire 003B,E01028671,932,693,239,113,31,95
2011,South Oxfordshire 003C,E01028672,1202,855,347,225,44,78
2011,South Oxfordshire 003D,E01028673,928,746,182,93,32,57
2011,South Oxfordshire 004A,E01028646,849,641,208,107,36,65
2011,South Oxfordshire 004B,E01028647,1187,903,284,160,49,75
2011,South Oxfordshire 004C,E01028681,967,703,264,179,38,47
2011,South Oxfordshire 004D,E01028682,855,607,248,165,23,60
2011,South Oxfordshire 004E,E01028684,1072,830,242,147,40,55
2011,South Oxfordshire 005A,E01028598,1782,1334,448,254,51,143
2011,South Oxfordshire 005B,E01028613,1072,839,233,135,41,57
2011,South Oxfordshire 005C,E01028614,1115,835,280,174,29,77
2011,South Oxfordshire 005D,E01028615,1129,787,342,255,34,53
2011,South Oxfordshire 005E,E01028616,1076,825,251,152,21,78
2011,South Oxfordshire 006A,E01028604,1090,817,273,119,24,130
2011,South Oxfordshire 006B,E01028605,1107,795,312,160,34,118
2011,South Oxfordshire 006C,E01028607,982,736,246,150,26,70
2011,South Oxfordshire 006D,E01028641,909,618,291,195,28,68
2011,South Oxfordshire 006E,E01028657,968,749,219,134,20,65
2011,South Oxfordshire 006F,E01028658,937,652,285,132,43,110
2011,South Oxfordshire 007A,E01028600,1062,789,273,177,37,59
2011,South Oxfordshire 007B,E01028603,864,666,198,111,29,58
2011,South Oxfordshire 007C,E01028606,1222,847,375,232,55,88
2011,South Oxfordshire 007D,E01028609,961,732,229,145,32,52
2011,South Oxfordshire 007E,E01028610,1156,874,282,184,27,71
2011,South Oxfordshire 008A,E01028678,1120,793,327,194,35,98
2011,South Oxfordshire 008B,E01028679,1576,1177,399,229,42,128
2011,South Oxfordshire 008C,E01028680,1196,877,319,203,37,79
2011,South Oxfordshire 009A,E01028625,1445,1295,150,52,35,63
2011,South Oxfordshire 009B,E01028626,1239,1109,130,49,27,54
2011,South Oxfordshire 009C,E01028627,1095,949,146,52,30,64
2011,South Oxfordshire 009D,E01028628,1112,945,167,59,42,66
2011,South Oxfordshire 009E,E01028629,1114,966,148,44,32,72
2011,South Oxfordshire 010A,E01028621,993,763,230,71,32,127
2011,South Oxfordshire 010B,E01028622,898,643,255,167,32,56
2011,South Oxfordshire 010C,E01028623,1209,954,255,133,38,84
2011,South Oxfordshire 010D,E01028624,1016,752,264,167,29,68
2011,South Oxfordshire 011A,E01028599,1021,751,270,188,30,52
2011,South Oxfordshire 011B,E01028601,1560,1354,206,114,28,64
2011,South Oxfordshire 011C,E01028602,1019,892,127,33,23,71
2011,South Oxfordshire 011D,E01028620,2127,1398,729,253,69,407
2011,South Oxfordshire 012A,E01028608,859,610,249,143,45,61
2011,South Oxfordshire 012B,E01028617,1288,1000,288,160,35,93
2011,South Oxfordshire 012C,E01028674,949,686,263,190,16,57
2011,South Oxfordshire 012D,E01028675,879,678,201,103,27,71
2011,South Oxfordshire 012E,E01028676,1448,1135,313,131,62,120
2011,South Oxfordshire 012F,E01028677,1046,785,261,150,26,85
2011,South Oxfordshire 013A,E01028630,1227,1061,166,46,40,80
2011,South Oxfordshire 013B,E01028631,824,637,187,99,26,62
2011,South Oxfordshire 013C,E01028632,1076,825,251,96,33,122
2011,South Oxfordshire 013D,E01028633,1142,916,226,86,30,110
2011,South Oxfordshire 014A,E01028634,937,721,216,138,33,45
2011,South Oxfordshire 014B,E01028635,1099,818,281,150,27,104
2011,South Oxfordshire 014C,E01028636,838,598,240,101,36,103
2011,South Oxfordshire 014D,E01028637,1167,909,258,170,29,59
2011,South Oxfordshire 015A,E01028618,1295,980,315,182,31,102
2011,South Oxfordshire 015B,E01028619,1312,954,358,225,37,96
2011,South Oxfordshire 015C,E01028644,1127,780,347,245,31,71
2011,South Oxfordshire 015D,E01028648,816,639,177,102,25,50
2011,South Oxfordshire 015E,E01028649,1139,838,301,144,42,115
2011,South Oxfordshire 016A,E01028650,1358,964,394,221,48,125
2011,South Oxfordshire 016B,E01028651,1113,758,355,224,27,104
2011,South Oxfordshire 016C,E01028652,1425,1010,415,269,40,106
2011,South Oxfordshire 017A,E01028653,979,782,197,89,23,85
2011,South Oxfordshire 017B,E01028654,1108,803,305,151,56,98
2011,South Oxfordshire 017C,E01028655,1274,996,278,164,39,75
2011,South Oxfordshire 017D,E01028656,869,556,313,195,33,85
2011,South Oxfordshire 018A,E01028611,832,609,223,135,28,60
2011,South Oxfordshire 018B,E01028642,883,625,258,153,29,76
2011,South Oxfordshire 018C,E01028643,967,668,299,183,36,80
2011,South Oxfordshire 018D,E01028645,933,593,340,241,38,61
2011,South Oxfordshire 018E,E01028685,890,648,242,159,22,61
2011,South Oxfordshire 018F,E01028686,984,692,292,119,109,64
2011,South Oxfordshire 019A,E01028612,889,638,251,153,21,77
2011,South Oxfordshire 019B,E01028660,1248,935,313,173,35,105
2011,South Oxfordshire 019C,E01028661,1198,743,455,197,165,93
2011,South Oxfordshire 019D,E01028662,932,618,314,198,31,85
2011,South Oxfordshire 020A,E01028659,1163,835,328,185,50,93
2011,South Oxfordshire 020B,E01028663,1046,790,256,143,32,81
2011,South Oxfordshire 020C,E01028664,873,609,264,177,29,58
2011,South Oxfordshire 020D,E01028665,909,630,279,196,30,53
2011,Vale of White Horse 001A,E01028708,1291,983,308,173,52,83
2011,Vale of White Horse 001B,E01028709,1210,879,331,190,79,62
2011,Vale of White Horse 001C,E01028710,1170,864,306,178,55,73
2011,Vale of White Horse 001D,E01028711,1161,880,281,173,35,73
2011,Vale of White Horse 002A,E01028733,903,635,268,171,37,60
2011,Vale of White Horse 002B,E01028734,1087,847,240,171,35,34
2011,Vale of White Horse 002C,E01028735,1165,865,300,188,32,80
2011,Vale of White Horse 002D,E01028740,1109,871,238,121,46,71
2011,Vale of White Horse 002E,E01028741,1176,855,321,95,180,46
2011,Vale of White Horse 002F,E01028742,1126,839,287,147,57,83
2011,Vale of White Horse 003A,E01028738,1648,1458,190,49,28,113
2011,Vale of White Horse 003B,E01028739,1220,908,312,213,25,74
2011,Vale of White Horse 003C,E01028743,1054,529,525,157,327,41
2011,Vale of White Horse 003D,E01028744,926,669,257,176,36,45
2011,Vale of White Horse 003E,E01028750,1044,744,300,182,30,88
2011,Vale of White Horse 003F,E01028751,1079,775,304,178,55,71
2011,Vale of White Horse 003G,E01028752,1201,885,316,190,40,86
2011,Vale of White Horse 004A,E01028693,1177,894,283,167,38,78
2011,Vale of White Horse 004B,E01028694,1161,987,174,81,40,53
2011,Vale of White Horse 004C,E01028701,1115,862,253,133,35,85
2011,Vale of White Horse 004D,E01028705,997,767,230,164,31,35
2011,Vale of White Horse 004E,E01028706,1192,938,254,176,40,38
2011,Vale of White Horse 004F,E01028707,1191,981,210,111,40,59
2011,Vale of White Horse 005A,E01028688,944,793,151,81,20,50
2011,Vale of White Horse 005B,E01028689,1124,904,220,92,50,78
2011,Vale of White Horse 005C,E01028695,1124,857,267,185,32,50
2011,Vale of White Horse 005D,E01028699,1135,824,311,199,49,63
2011,Vale of White Horse 006B,E01028696,973,658,315,143,101,71
2011,Vale of White Horse 006C,E01028697,1062,840,222,98,38,86
2011,Vale of White Horse 006D,E01028698,1146,924,222,119,35,68
2011,Vale of White Horse 006E,E01028700,1096,818,278,116,39,123
2011,Vale of White Horse 006F,E01028703,1270,985,285,134,39,112
2011,Vale of White Horse 006G,E01033305,1008,848,160,60,21,79
2011,Vale of White Horse 006H,E01033306,1185,924,261,143,38,80
2011,Vale of White Horse 007A,E01028726,1633,1124,509,325,59,125
2011,Vale of White Horse 007B,E01028736,1717,1323,394,261,55,78
2011,Vale of White Horse 007C,E01028737,1707,1229,478,283,53,142
2011,Vale of White Horse 008A,E01028690,1222,904,318,188,29,101
2011,Vale of White Horse 008B,E01028691,1028,716,312,187,31,94
2011,Vale of White Horse 008C,E01028692,933,631,302,89,37,176
2011,Vale of White Horse 008D,E01028702,993,754,239,173,22,44
2011,Vale of White Horse 008E,E01028704,1302,978,324,168,51,105
2011,Vale of White Horse 009A,E01028716,1351,1083,268,110,43,115
2011,Vale of White Horse 009B,E01028717,1138,841,297,137,43,117
2011,Vale of White Horse 009C,E01028718,1072,817,255,107,33,115
2011,Vale of White Horse 009D,E01028719,1184,838,346,239,35,72
2011,Vale of White Horse 009E,E01028749,1718,1276,442,275,36,131
2011,Vale of White Horse 010A,E01028714,1662,1263,399,258,45,96
2011,Vale of White Horse 010B,E01028731,903,654,249,145,37,67
2011,Vale of White Horse 010C,E01028732,921,710,211,94,27,90
2011,Vale of White Horse 010D,E01028753,1009,741,268,153,33,82
2011,Vale of White Horse 010E,E01028754,987,740,247,131,44,72
2011,Vale of White Horse 011A,E01028721,1012,839,173,92,34,47
2011,Vale of White Horse 011B,E01028722,1162,841,321,203,38,80
2011,Vale of White Horse 011C,E01028723,1006,683,323,217,27,79
2011,Vale of White Horse 011D,E01028724,996,774,222,141,34,47
2011,Vale of White Horse 011E,E01028725,1118,909,209,85,35,89
2011,Vale of White Horse 014A,E01028755,1149,829,320,197,37,86
2011,Vale of White Horse 014B,E01028756,1712,1365,347,195,42,110
2011,Vale of White Horse 014C,E01028758,1064,755,309,214,41,54
2011,Vale of White Horse 014D,E01028759,1140,863,277,150,37,90
2011,Vale of White Horse 014E,E01028760,927,703,224,125,29,70
2011,Vale of White Horse 014F,E01028761,986,752,234,129,34,71
2011,Vale of White Horse 015A,E01028712,1435,1012,423,282,49,92
2011,Vale of White Horse 015B,E01028727,1165,850,315,195,41,79
2011,Vale of White Horse 015C,E01028728,821,581,240,125,26,89
2011,Vale of White Horse 015D,E01028729,782,616,166,104,23,39
2011,Vale of White Horse 015E,E01028730,1173,911,262,150,34,78
2011,Vale of White Horse 015F,E01028757,988,730,258,125,34,99
2011,Vale of White Horse 016E,E01028713,1788,1279,509,290,56,163
2011,Vale of White Horse 016F,E01028715,982,746,236,129,32,75
2011,Vale of White Horse 016G,E01028720,1595,1183,412,249,44,119
2011,Vale of White Horse 016A,E01028745,1001,761,240,139,33,68
2011,Vale of White Horse 016B,E01028746,916,631,285,190,33,62
2011,Vale of White Horse 016C,E01028747,861,651,210,70,22,118
2011,Vale of White Horse 016D,E01028748,748,534,214,77,37,100
2011,West Oxfordshire 001A,E01028780,1459,1123,336,223,38,75
2011,West Oxfordshire 001B,E01028781,894,661,233,122,26,85
2011,West Oxfordshire 001C,E01028782,1130,856,274,178,30,66
2011,West Oxfordshire 001D,E01028783,1123,842,281,150,50,81
2011,West Oxfordshire 002A,E01028795,1146,888,258,142,25,91
2011,West Oxfordshire 002B,E01028796,912,642,270,144,59,67
2011,West Oxfordshire 002C,E01028797,800,627,173,108,20,45
2011,West Oxfordshire 002D,E01028806,1463,1092,371,231,41,99
2011,West Oxfordshire 003A,E01028763,1374,985,389,249,38,102
2011,West Oxfordshire 003B,E01028776,1401,1035,366,222,45,99
2011,West Oxfordshire 003C,E01028798,1404,1028,376,255,29,92
2011,West Oxfordshire 004B,E01028804,900,650,250,164,28,58
2011,West Oxfordshire 004D,E01028823,891,707,184,117,25,42
2011,West Oxfordshire 004E,E01028824,1057,816,241,158,28,55
2011,West Oxfordshire 004F,E01028825,811,610,201,136,21,44
2011,West Oxfordshire 004G,E01032954,1940,1428,512,296,96,120
2011,West Oxfordshire 005A,E01028777,800,605,195,112,35,48
2011,West Oxfordshire 005B,E01028778,1043,761,282,192,30,60
2011,West Oxfordshire 005C,E01028779,821,612,209,132,18,59
2011,West Oxfordshire 005D,E01028799,1429,1021,408,269,44,95
2011,West Oxfordshire 006A,E01028788,1174,880,294,197,36,61
2011,West Oxfordshire 006B,E01028789,1054,775,279,194,41,44
2011,West Oxfordshire 006C,E01028790,862,628,234,147,39,48
2011,West Oxfordshire 006D,E01028791,1129,816,313,233,29,51
2011,West Oxfordshire 007A,E01028784,1577,1187,390,252,52,86
2011,West Oxfordshire 007B,E01028792,782,598,184,128,13,43
2011,West Oxfordshire 007C,E01028793,1108,851,257,139,36,82
2011,West Oxfordshire 007D,E01028794,1050,798,252,154,23,75
2011,West Oxfordshire 008A,E01028810,1051,889,162,91,27,44
2011,West Oxfordshire 008B,E01028811,985,742,243,107,35,101
2011,West Oxfordshire 008D,E01028813,934,702,232,96,41,95
2011,West Oxfordshire 008E,E01028814,1054,817,237,147,33,57
2011,West Oxfordshire 008F,E01028815,961,703,258,186,38,34
2011,West Oxfordshire 008G,E01032947,1301,1122,179,47,30,102
2011,West Oxfordshire 008H,E01032948,1317,1067,250,135,34,81
2011,West Oxfordshire 008I,E01032952,1017,805,212,137,26,49
2011,West Oxfordshire 009A,E01028809,879,607,272,137,25,110
2011,West Oxfordshire 009B,E01028820,1005,840,165,82,37,46
2011,West Oxfordshire 009C,E01028821,1108,921,187,71,31,85
2011,West Oxfordshire 009D,E01028822,1094,926,168,91,30,47
2011,West Oxfordshire 010A,E01028807,1617,1273,344,182,55,107
2011,West Oxfordshire 010B,E01028808,1245,936,309,191,40,78
2011,West Oxfordshire 010C,E01028816,1038,841,197,125,21,51
2011,West Oxfordshire 010D,E01028817,1113,861,252,152,35,65
2011,West Oxfordshire 010E,E01028818,1203,937,266,153,31,82
2011,West Oxfordshire 010F,E01028819,1091,743,348,195,40,113
2011,West Oxfordshire 011A,E01028785,1142,876,266,174,38,54
2011,West Oxfordshire 011B,E01028786,925,634,291,212,33,46
2011,West Oxfordshire 011C,E01028787,932,670,262,147,23,92
2011,West Oxfordshire 011D,E01028800,935,714,221,124,34,63
2011,West Oxfordshire 012A,E01028762,1311,1002,309,166,45,98
2011,West Oxfordshire 012B,E01028766,1440,1104,336,210,33,93
2011,West Oxfordshire 012C,E01028767,1300,833,467,302,61,104
2011,West Oxfordshire 013D,E01028772,1313,1086,227,145,32,50
2011,West Oxfordshire 013E,E01032949,1101,974,127,30,36,61
2011,West Oxfordshire 013F,E01032950,1272,1123,149,54,26,69
2011,West Oxfordshire 013G,E01032951,1380,1170,210,68,44,98
2011,West Oxfordshire 013H,E01032953,1599,1303,296,132,38,126
2011,West Oxfordshire 014A,E01028771,1086,796,290,165,28,97
2011,West Oxfordshire 014B,E01028773,1016,763,253,155,29,69
2011,West Oxfordshire 014C,E01028774,2149,1946,203,79,32,92
2011,West Oxfordshire 014D,E01028775,1019,812,207,135,29,43
2011,West Oxfordshire 015A,E01028764,1268,945,323,210,34,79
2011,West Oxfordshire 015B,E01028765,1380,992,388,222,40,126
2011,West Oxfordshire 015C,E01028801,1002,754,248,138,25,85
2011,West Oxfordshire 015D,E01028802,1046,755,291,181,38,72
2011,Elmbridge 001A,E01030330,1145,844,301,164,48,89
2011,Elmbridge 001B,E01030331,1160,896,264,139,40,85
2011,Elmbridge 001C,E01030332,1029,741,288,130,51,107
2011,Elmbridge 001D,E01030333,1068,774,294,165,45,84
2011,Elmbridge 002A,E01030326,1258,967,291,129,57,105
2011,Elmbridge 002B,E01030327,1157,848,309,143,56,110
2011,Elmbridge 002C,E01030328,1174,884,290,157,56,77
2011,Elmbridge 002D,E01030329,1069,797,272,151,49,72
2011,Elmbridge 003A,E01030334,1074,801,273,129,49,95
2011,Elmbridge 003B,E01030335,1323,1002,321,160,60,101
2011,Elmbridge 003C,E01030336,1347,1034,313,110,45,158
2011,Elmbridge 003D,E01030337,1135,828,307,139,37,131
2011,Elmbridge 004A,E01030361,1449,1168,281,145,32,104
2011,Elmbridge 004B,E01030362,867,610,257,110,43,104
2011,Elmbridge 004C,E01030363,1361,1059,302,136,32,134
2011,Elmbridge 004D,E01030364,1172,921,251,64,36,151
2011,Elmbridge 005A,E01030350,1172,886,286,152,46,88
2011,Elmbridge 005B,E01030351,1081,866,215,101,31,83
2011,Elmbridge 005C,E01030352,1042,800,242,122,46,74
2011,Elmbridge 005D,E01030353,1046,813,233,107,41,85
2011,Elmbridge 006A,E01030322,1312,1001,311,111,74,126
2011,Elmbridge 006B,E01030323,974,677,297,139,52,106
2011,Elmbridge 006C,E01030324,1117,886,231,113,38,80
2011,Elmbridge 006D,E01030325,1087,784,303,150,57,96
2011,Elmbridge 007A,E01030357,1130,849,281,158,29,94
2011,Elmbridge 007B,E01030358,1047,793,254,149,36,69
2011,Elmbridge 007C,E01030359,1645,1304,341,149,45,147
2011,Elmbridge 007D,E01030360,1140,808,332,127,66,139
2011,Elmbridge 008A,E01030354,1063,786,277,79,56,142
2011,Elmbridge 008B,E01030355,996,776,220,118,18,84
2011,Elmbridge 008C,E01030356,925,727,198,83,29,86
2011,Elmbridge 008D,E01030365,1115,870,245,118,55,72
2011,Elmbridge 008E,E01030368,1115,827,288,162,32,94
2011,Elmbridge 009A,E01030319,1181,870,311,150,59,102
2011,Elmbridge 009B,E01030320,1157,915,242,88,67,87
2011,Elmbridge 009C,E01030321,1060,799,261,131,60,70
2011,Elmbridge 009D,E01030369,1531,1117,414,190,83,141
2011,Elmbridge 009E,E01030370,1110,857,253,102,59,92
2011,Elmbridge 010A,E01030313,1109,863,246,123,41,82
2011,Elmbridge 010B,E01030314,1067,791,276,151,40,85
2011,Elmbridge 010C,E01030366,1356,1056,300,155,55,90
2011,Elmbridge 010D,E01030367,1154,808,346,178,51,117
2011,Elmbridge 011A,E01030338,1120,783,337,165,51,121
2011,Elmbridge 011B,E01030339,1018,778,240,141,25,74
2011,Elmbridge 011C,E01030340,1009,735,274,141,51,82
2011,Elmbridge 011D,E01030341,1247,870,377,204,46,127
2011,Elmbridge 012A,E01030371,1107,826,281,120,45,116
2011,Elmbridge 012B,E01030372,853,650,203,80,36,87
2011,Elmbridge 012C,E01030373,1099,861,238,111,35,92
2011,Elmbridge 012D,E01030374,1172,900,272,143,31,98
2011,Elmbridge 012E,E01030375,1239,989,250,113,43,94
2011,Elmbridge 012F,E01030376,926,681,245,113,39,93
2011,Elmbridge 013A,E01030307,1169,828,341,137,50,154
2011,Elmbridge 013B,E01030308,1108,737,371,168,56,147
2011,Elmbridge 013C,E01030309,1054,673,381,170,63,148
2011,Elmbridge 013D,E01030310,1343,1003,340,103,58,179
2011,Elmbridge 014A,E01030311,1067,764,303,153,47,103
2011,Elmbridge 014B,E01030312,980,781,199,88,32,79
2011,Elmbridge 014C,E01030315,1143,888,255,125,47,83
2011,Elmbridge 014D,E01030316,1127,769,358,166,70,122
2011,Elmbridge 014E,E01030317,1197,898,299,171,34,94
2011,Elmbridge 014F,E01030318,869,519,350,196,50,104
2011,Elmbridge 015A,E01030296,1217,847,370,208,67,95
2011,Elmbridge 015B,E01030297,1503,1034,469,199,80,190
2011,Elmbridge 015C,E01030298,1030,741,289,141,41,107
2011,Elmbridge 015D,E01030299,1158,853,305,150,48,107
2011,Elmbridge 016A,E01030346,1053,718,335,121,55,159
2011,Elmbridge 016B,E01030347,1194,945,249,92,47,110
2011,Elmbridge 016C,E01030348,1190,832,358,163,69,126
2011,Elmbridge 016D,E01030349,1160,797,363,183,45,135
2011,Elmbridge 017A,E01030300,1132,828,304,162,25,117
2011,Elmbridge 017B,E01030301,1019,645,374,150,63,161
2011,Elmbridge 017C,E01030302,1090,788,302,173,43,86
2011,Elmbridge 017D,E01030304,1190,896,294,116,33,145
2011,Elmbridge 017E,E01030305,1072,633,439,142,110,187
2011,Elmbridge 017F,E01030306,1020,578,442,120,152,170
2011,Elmbridge 018A,E01030303,1187,756,431,177,62,192
2011,Elmbridge 018B,E01030342,1094,692,402,148,82,172
2011,Elmbridge 018C,E01030343,1169,838,331,125,67,139
2011,Elmbridge 018D,E01030344,1040,648,392,132,83,177
2011,Elmbridge 018E,E01030345,1142,817,325,152,53,120
2011,Epsom and Ewell 001A,E01030386,1104,787,317,163,68,86
2011,Epsom and Ewell 001B,E01030387,1234,981,253,121,56,76
2011,Epsom and Ewell 001C,E01030388,971,695,276,161,39,76
2011,Epsom and Ewell 001D,E01030389,1097,836,261,137,47,77
2011,Epsom and Ewell 001E,E01030393,1401,963,438,303,49,86
2011,Epsom and Ewell 002A,E01030394,1278,965,313,171,63,79
2011,Epsom and Ewell 002B,E01030399,1528,1177,351,195,34,122
2011,Epsom and Ewell 002C,E01030400,1129,813,316,88,57,171
2011,Epsom and Ewell 002D,E01030414,958,702,256,113,41,102
2011,Epsom and Ewell 003A,E01030377,1653,1230,423,263,45,115
2011,Epsom and Ewell 003B,E01030378,1149,852,297,184,42,71
2011,Epsom and Ewell 003C,E01030406,1195,906,289,153,63,73
2011,Epsom and Ewell 003D,E01030407,1014,716,298,197,36,65
2011,Epsom and Ewell 003E,E01030408,1318,985,333,204,50,79
2011,Epsom and Ewell 004A,E01030395,1245,826,419,308,39,72
2011,Epsom and Ewell 004B,E01030413,1466,1164,302,112,54,136
2011,Epsom and Ewell 004C,E01030415,1200,940,260,136,45,79
2011,Epsom and Ewell 004D,E01030416,978,720,258,168,35,55
2011,Epsom and Ewell 005A,E01030383,1887,1393,494,118,91,285
2011,Epsom and Ewell 005B,E01030384,1917,1537,380,132,73,175
2011,Epsom and Ewell 005C,E01030401,1783,1346,437,241,57,139
2011,Epsom and Ewell 005D,E01030402,928,682,246,103,36,107
2011,Epsom and Ewell 007A,E01030385,1192,868,324,132,71,121
2011,Epsom and Ewell 007B,E01030391,1360,1048,312,156,65,91
2011,Epsom and Ewell 007C,E01030403,1057,798,259,152,47,60
2011,Epsom and Ewell 007D,E01030404,1104,800,304,179,45,80
2011,Epsom and Ewell 007E,E01030409,1134,791,343,135,112,96
2011,Epsom and Ewell 007F,E01030410,1070,810,260,64,118,78
2011,Epsom and Ewell 008A,E01030381,986,697,289,159,49,81
2011,Epsom and Ewell 008B,E01030411,1656,1171,485,133,183,169
2011,Epsom and Ewell 008C,E01030412,1390,1079,311,142,75,94
2011,Epsom and Ewell 008D,E01030419,1162,841,321,174,55,92
2011,Epsom and Ewell 009A,E01030379,1111,684,427,113,236,78
2011,Epsom and Ewell 009B,E01030380,965,671,294,182,44,68
2011,Epsom and Ewell 009C,E01030405,1167,900,267,141,47,79
2011,Epsom and Ewell 009D,E01030417,925,636,289,167,47,75
2011,Epsom and Ewell 009E,E01030418,1095,821,274,149,43,82
2011,Epsom and Ewell 009F,E01030420,850,621,229,106,61,62
2011,Epsom and Ewell 010A,E01030382,1039,745,294,159,55,80
2011,Epsom and Ewell 010B,E01030390,1291,959,332,183,43,106
2011,Epsom and Ewell 010C,E01030392,1334,978,356,210,57,89
2011,Epsom and Ewell 010D,E01030396,1273,890,383,216,67,100
2011,Epsom and Ewell 010E,E01030398,1266,908,358,218,73,67
2011,Epsom and Ewell 010F,E01032624,1310,912,398,239,72,87
2011,Guildford 001A,E01030440,1123,761,362,201,40,121
2011,Guildford 001B,E01030458,905,677,228,123,22,83
2011,Guildford 001C,E01030459,1065,621,444,114,25,305
2011,Guildford 001D,E01030475,919,689,230,129,34,67
2011,Guildford 001E,E01030476,900,656,244,157,34,53
2011,Guildford 001F,E01030477,1172,846,326,174,41,111
2011,Guildford 002A,E01030465,1037,762,275,161,31,83
2011,Guildford 002B,E01030466,1141,729,412,301,26,85
2011,Guildford 002C,E01030473,1241,930,311,151,58,102
2011,Guildford 002D,E01030474,1463,1264,199,21,40,138
2011,Guildford 003A,E01030441,883,624,259,160,33,66
2011,Guildford 003B,E01030442,1054,637,417,225,68,124
2011,Guildford 003C,E01030443,890,602,288,154,46,88
2011,Guildford 003D,E01030444,1042,732,310,189,34,87
2011,Guildford 003E,E01030445,950,640,310,174,45,91
2011,Guildford 003F,E01030446,974,674,300,140,75,85
2011,Guildford 003G,E01030447,962,702,260,143,41,76
2011,Guildford 004A,E01030426,1104,877,227,86,32,109
2011,Guildford 004B,E01030427,1106,876,230,145,27,58
2011,Guildford 004C,E01030428,858,646,212,137,22,53
2011,Guildford 004D,E01030429,1149,954,195,97,21,77
2011,Guildford 004E,E01030430,1114,825,289,200,24,65
2011,Guildford 005A,E01030499,1086,809,277,180,36,61
2011,Guildford 005B,E01030500,1176,841,335,173,82,80
2011,Guildford 005C,E01030501,1222,975,247,129,44,74
2011,Guildford 005D,E01030502,930,677,253,147,60,46
2011,Guildford 005E,E01030503,1061,771,290,83,68,139
2011,Guildford 005F,E01030504,780,558,222,157,23,42
2011,Guildford 006A,E01030485,1370,1054,316,79,123,114
2011,Guildford 006B,E01030487,1285,987,298,90,149,59
2011,Guildford 006C,E01030488,1737,1216,521,136,271,114
2011,Guildford 006D,E01030489,1825,1473,352,113,97,142
2011,Guildford 007A,E01030481,1259,957,302,103,65,134
2011,Guildford 007B,E01030482,1063,819,244,88,59,97
2011,Guildford 007C,E01030483,1005,714,291,115,44,132
2011,Guildford 007D,E01030484,1286,982,304,113,51,140
2011,Guildford 008A,E01030434,1237,1032,205,83,44,78
2011,Guildford 008B,E01030435,1201,867,334,163,64,107
2011,Guildford 008C,E01030462,1180,864,316,163,64,89
2011,Guildford 008D,E01030463,1154,890,264,151,49,64
2011,Guildford 008E,E01030464,1133,879,254,82,57,115
2011,Guildford 009A,E01030486,1246,995,251,116,73,62
2011,Guildford 009B,E01030493,992,721,271,91,99,81
2011,Guildford 009C,E01030495,1450,978,472,124,287,61
2011,Guildford 009D,E01030498,1084,819,265,102,107,56
2011,Guildford 010A,E01030424,1056,794,262,128,28,106
2011,Guildford 010B,E01030431,1087,769,318,220,22,76
2011,Guildford 010C,E01030432,1117,815,302,144,18,140
2011,Guildford 010D,E01030433,1238,965,273,111,29,133
2011,Guildford 011A,E01030436,1616,1278,338,143,85,110
2011,Guildford 011B,E01030437,1245,886,359,177,75,107
2011,Guildford 011C,E01030439,1194,839,355,189,80,86
2011,Guildford 011D,E01030460,1054,779,275,154,46,75
2011,Guildford 011E,E01030461,1094,804,290,163,46,81
2011,Guildford 012A,E01030470,2658,1331,1327,85,1193,49
2011,Guildford 012B,E01030494,1205,809,396,120,144,132
2011,Guildford 012C,E01030496,1215,812,403,81,200,122
2011,Guildford 012D,E01030497,1196,815,381,77,110,194
2011,Guildford 013A,E01030438,1173,886,287,114,69,104
2011,Guildford 013B,E01030450,1947,1569,378,63,171,144
2011,Guildford 013C,E01030451,1568,1233,335,56,148,131
2011,Guildford 013D,E01030453,1197,969,228,82,66,80
2011,Guildford 013E,E01030455,1301,992,309,115,93,101
2011,Guildford 013F,E01030457,1352,1094,258,47,90,121
2011,Guildford 014A,E01030421,1124,842,282,194,24,64
2011,Guildford 014B,E01030422,1118,890,228,124,18,86
2011,Guildford 014C,E01030423,1226,927,299,165,29,105
2011,Guildford 014D,E01030425,1212,942,270,167,35,68
2011,Guildford 015A,E01030452,1690,1197,493,76,323,94
2011,Guildford 015B,E01030467,1171,846,325,170,74,81
2011,Guildford 015C,E01030468,3262,1324,1938,63,1829,46
2011,Guildford 015D,E01030469,1039,717,322,119,123,80
2011,Guildford 016A,E01030448,1124,807,317,159,66,92
2011,Guildford 016B,E01030449,975,703,272,108,84,80
2011,Guildford 016C,E01030454,1214,899,315,132,67,116
2011,Guildford 016D,E01030456,1001,646,355,198,56,101
2011,Guildford 017A,E01030471,880,594,286,178,36,72
2011,Guildford 017B,E01030472,900,657,243,130,20,93
2011,Guildford 017C,E01030478,1319,911,408,193,105,110
2011,Guildford 017D,E01030479,1249,975,274,130,39,105
2011,Guildford 017E,E01030480,1231,885,346,211,42,93
2011,Guildford 018A,E01030490,1154,828,326,173,46,107
2011,Guildford 018B,E01030491,1345,959,386,193,59,134
2011,Guildford 018C,E01030492,1493,1059,434,241,58,135
2011,Mole Valley 001A,E01030506,960,704,256,163,41,52
2011,Mole Valley 001B,E01030508,936,581,355,185,101,69
2011,Mole Valley 001C,E01030509,746,537,209,131,26,52
2011,Mole Valley 001D,E01030513,961,687,274,148,41,85
2011,Mole Valley 001E,E01030514,973,701,272,164,36,72
2011,Mole Valley 002A,E01030505,1118,824,294,160,32,102
2011,Mole Valley 002B,E01030507,873,652,221,130,37,54
2011,Mole Valley 002C,E01030511,1012,736,276,174,39,63
2011,Mole Valley 002D,E01030512,1063,738,325,186,42,97
2011,Mole Valley 003A,E01030548,1386,1091,295,88,50,157
2011,Mole Valley 003B,E01030549,1406,1149,257,116,40,101
2011,Mole Valley 003C,E01030550,1296,988,308,154,29,125
2011,Mole Valley 003D,E01030551,1160,856,304,113,36,155
2011,Mole Valley 004A,E01030510,1120,809,311,202,52,57
2011,Mole Valley 004B,E01030552,1013,783,230,85,82,63
2011,Mole Valley 004C,E01030553,1256,848,408,213,60,135
2011,Mole Valley 004D,E01030554,787,510,277,152,42,83
2011,Mole Valley 005A,E01030539,1285,973,312,178,45,89
2011,Mole Valley 005B,E01030540,1437,900,537,352,67,118
2011,Mole Valley 005C,E01030541,958,684,274,166,35,73
2011,Mole Valley 005D,E01030542,880,697,183,107,29,47
2011,Mole Valley 005E,E01030543,1083,816,267,142,57,68
2011,Mole Valley 006A,E01030516,845,564,281,174,24,83
2011,Mole Valley 006B,E01030517,1107,770,337,229,35,73
2011,Mole Valley 006C,E01030518,907,551,356,262,42,52
2011,Mole Valley 006D,E01030519,1076,769,307,176,43,88
2011,Mole Valley 007A,E01030520,965,663,302,187,26,89
2011,Mole Valley 007B,E01030521,1179,829,350,206,37,107
2011,Mole Valley 007C,E01030522,882,599,283,192,28,63
2011,Mole Valley 007D,E01030523,805,548,257,176,20,61
2011,Mole Valley 008A,E01030524,1498,973,525,367,34,124
2011,Mole Valley 008B,E01030525,1092,811,281,189,40,52
2011,Mole Valley 008C,E01030526,918,682,236,140,33,63
2011,Mole Valley 008D,E01030527,1146,816,330,187,39,104
2011,Mole Valley 009A,E01030532,1110,890,220,117,29,74
2011,Mole Valley 009B,E01030533,973,734,239,124,57,58
2011,Mole Valley 009C,E01030534,891,688,203,118,19,66
2011,Mole Valley 009D,E01030556,1442,1003,439,230,129,80
2011,Mole Valley 010A,E01030535,1296,1042,254,137,35,82
2011,Mole Valley 010B,E01030536,1273,933,340,184,49,107
2011,Mole Valley 010C,E01030537,1181,831,350,210,48,92
2011,Mole Valley 010D,E01030538,1203,977,226,105,35,86
2011,Mole Valley 011A,E01030544,1129,850,279,184,28,67
2011,Mole Valley 011B,E01030545,1184,949,235,144,24,67
2011,Mole Valley 011C,E01030546,1186,913,273,145,41,87
2011,Mole Valley 011D,E01030547,1142,809,333,149,49,135
2011,Mole Valley 012A,E01030529,1228,923,305,166,48,91
2011,Mole Valley 012B,E01030555,1269,908,361,205,53,103
2011,Mole Valley 012C,E01030557,1405,1018,387,218,43,126
2011,Mole Valley 012D,E01030558,1550,1126,424,253,41,130
2011,Mole Valley 013A,E01030515,1392,971,421,263,51,107
2011,Mole Valley 013B,E01030528,1052,783,269,174,32,63
2011,Mole Valley 013C,E01030530,937,643,294,181,34,79
2011,Mole Valley 013D,E01030531,1806,1340,466,218,59,189
2011,Reigate and Banstead 001A,E01030603,1106,825,281,160,45,76
2011,Reigate and Banstead 001B,E01030604,1108,820,288,182,41,65
2011,Reigate and Banstead 001C,E01030605,1023,804,219,100,44,75
2011,Reigate and Banstead 001D,E01030607,1313,955,358,220,63,75
2011,Reigate and Banstead 002A,E01030559,869,589,280,179,30,71
2011,Reigate and Banstead 002B,E01030560,1028,745,283,184,23,76
2011,Reigate and Banstead 002C,E01030561,896,620,276,186,23,67
2011,Reigate and Banstead 002D,E01030562,961,751,210,110,27,73
2011,Reigate and Banstead 002E,E01030563,1699,783,916,123,46,747
2011,Reigate and Banstead 002F,E01030564,981,731,250,149,30,71
2011,Reigate and Banstead 003A,E01030606,944,632,312,184,54,74
2011,Reigate and Banstead 003B,E01030641,1114,806,308,167,45,96
2011,Reigate and Banstead 003C,E01030642,1101,794,307,189,35,83
2011,Reigate and Banstead 003D,E01030644,955,670,285,197,37,51
2011,Reigate and Banstead 004A,E01030565,1007,713,294,163,33,98
2011,Reigate and Banstead 004B,E01030566,1099,872,227,128,40,59
2011,Reigate and Banstead 004C,E01030567,1195,822,373,220,44,109
2011,Reigate and Banstead 004D,E01030568,1144,843,301,160,55,86
2011,Reigate and Banstead 004E,E01030569,1936,1569,367,157,76,134
2011,Reigate and Banstead 005A,E01030608,968,676,292,115,42,135
2011,Reigate and Banstead 005B,E01030609,1018,804,214,78,37,99
2011,Reigate and Banstead 005C,E01030640,1120,879,241,108,24,109
2011,Reigate and Banstead 005D,E01030643,949,712,237,127,29,81
2011,Reigate and Banstead 006A,E01030635,1092,826,266,136,39,91
2011,Reigate and Banstead 006B,E01030636,909,629,280,146,69,65
2011,Reigate and Banstead 006C,E01030637,918,667,251,146,50,55
2011,Reigate and Banstead 006D,E01030638,1098,789,309,181,58,70
2011,Reigate and Banstead 006E,E01030639,989,672,317,193,43,81
2011,Reigate and Banstead 007A,E01030589,1282,869,413,214,64,135
2011,Reigate and Banstead 007B,E01030590,1384,1037,347,213,48,86
2011,Reigate and Banstead 007C,E01030591,985,725,260,140,45,75
2011,Reigate and Banstead 007D,E01030592,1398,986,412,267,42,103
2011,Reigate and Banstead 008A,E01030599,1110,795,315,87,46,182
2011,Reigate and Banstead 008B,E01030600,1081,837,244,113,40,91
2011,Reigate and Banstead 008C,E01030601,1095,820,275,90,49,136
2011,Reigate and Banstead 008D,E01030602,1295,999,296,141,34,121
2011,Reigate and Banstead 009A,E01030598,1160,833,327,177,44,106
2011,Reigate and Banstead 009B,E01030623,1452,1072,380,197,50,133
2011,Reigate and Banstead 009C,E01030624,857,626,231,114,28,89
2011,Reigate and Banstead 009D,E01030625,1027,690,337,138,106,93
2011,Reigate and Banstead 009E,E01030626,734,502,232,138,36,58
2011,Reigate and Banstead 009F,E01030627,1204,995,209,111,36,62
2011,Reigate and Banstead 010A,E01030615,1156,872,284,78,50,156
2011,Reigate and Banstead 010B,E01030616,1099,791,308,197,43,68
2011,Reigate and Banstead 010C,E01030617,1211,916,295,186,38,71
2011,Reigate and Banstead 010D,E01030618,1377,1092,285,109,66,110
2011,Reigate and Banstead 010E,E01030619,1022,727,295,121,38,136
2011,Reigate and Banstead 010F,E01030622,1402,1110,292,117,41,134
2011,Reigate and Banstead 011A,E01030610,917,697,220,89,33,98
2011,Reigate and Banstead 011B,E01030611,1993,1663,330,123,65,142
2011,Reigate and Banstead 011C,E01030612,1996,1708,288,100,53,135
2011,Reigate and Banstead 011D,E01030613,1491,1264,227,70,46,111
2011,Reigate and Banstead 011E,E01030614,1210,948,262,137,39,86
2011,Reigate and Banstead 012A,E01030593,1038,806,232,102,36,94
2011,Reigate and Banstead 012B,E01030596,1042,747,295,139,42,114
2011,Reigate and Banstead 012C,E01030597,1098,875,223,115,38,70
2011,Reigate and Banstead 012D,E01030620,1235,989,246,132,40,74
2011,Reigate and Banstead 012E,E01030621,1012,751,261,104,41,116
2011,Reigate and Banstead 013A,E01030594,1205,867,338,160,42,136
2011,Reigate and Banstead 013B,E01030595,1028,806,222,113,42,67
2011,Reigate and Banstead 013C,E01030630,1134,808,326,189,41,96
2011,Reigate and Banstead 013D,E01030631,1052,820,232,109,22,101
2011,Reigate and Banstead 014A,E01030570,1195,906,289,153,34,102
2011,Reigate and Banstead 014B,E01030571,1159,890,269,144,36,89
2011,Reigate and Banstead 014C,E01030572,1615,1298,317,137,44,136
2011,Reigate and Banstead 014D,E01030573,1235,965,270,122,49,99
2011,Reigate and Banstead 014E,E01030574,1343,1106,237,101,40,96
2011,Reigate and Banstead 015A,E01030628,1092,782,310,180,32,98
2011,Reigate and Banstead 015B,E01030629,896,660,236,136,16,84
2011,Reigate and Banstead 015C,E01030632,982,745,237,141,31,65
2011,Reigate and Banstead 015D,E01030633,970,706,264,149,31,84
2011,Reigate and Banstead 015E,E01030634,984,739,245,111,27,107
2011,Reigate and Banstead 016A,E01030584,1216,938,278,171,43,64
2011,Reigate and Banstead 016B,E01030585,1227,948,279,184,27,68
2011,Reigate and Banstead 016C,E01030586,1229,954,275,131,46,98
2011,Reigate and Banstead 016D,E01030587,1049,806,243,125,40,78
2011,Reigate and Banstead 016E,E01030588,1062,746,316,131,39,146
2011,Reigate and Banstead 017A,E01030580,1431,1207,224,100,30,94
2011,Reigate and Banstead 017B,E01030581,958,713,245,155,26,64
2011,Reigate and Banstead 017C,E01030582,935,793,142,61,26,55
2011,Reigate and Banstead 017D,E01030583,1109,848,261,159,28,74
2011,Reigate and Banstead 018A,E01030575,1603,1331,272,107,47,118
2011,Reigate and Banstead 018B,E01030576,1280,1013,267,135,27,105
2011,Reigate and Banstead 018C,E01030577,1256,996,260,162,30,68
2011,Reigate and Banstead 018D,E01030578,1063,804,259,124,32,103
2011,Reigate and Banstead 018E,E01030579,962,679,283,141,21,121
2011,Runnymede 001A,E01030667,1107,813,294,106,118,70
2011,Runnymede 001B,E01030668,1376,957,419,103,239,77
2011,Runnymede 001C,E01030669,1277,804,473,97,314,62
2011,Runnymede 001D,E01030670,1201,736,465,95,321,49
2011,Runnymede 002A,E01030671,2691,970,1721,66,1594,61
2011,Runnymede 002B,E01030672,1904,1097,807,171,502,134
2011,Runnymede 002C,E01030673,748,543,205,92,54,59
2011,Runnymede 002D,E01030674,1046,648,398,130,191,77
2011,Runnymede 002E,E01030675,1077,680,397,93,219,85
2011,Runnymede 002F,E01030676,1073,567,506,86,345,75
2011,Runnymede 003A,E01030663,1096,815,281,127,38,116
2011,Runnymede 003B,E01030664,1197,877,320,135,59,126
2011,Runnymede 003C,E01030665,1129,920,209,67,48,94
2011,Runnymede 003D,E01030666,1314,1054,260,137,40,83
2011,Runnymede 003E,E01030687,907,740,167,105,33,29
2011,Runnymede 003F,E01030688,1081,869,212,119,28,65
2011,Runnymede 004A,E01030656,1153,889,264,112,36,116
2011,Runnymede 004B,E01030658,1025,718,307,228,14,65
2011,Runnymede 004C,E01030685,1069,776,293,122,118,53
2011,Runnymede 004D,E01030686,1085,778,307,195,36,76
2011,Runnymede 005A,E01030689,1034,772,262,122,54,86
2011,Runnymede 005B,E01030690,1193,823,370,151,55,164
2011,Runnymede 005C,E01030691,1083,703,380,198,51,131
2011,Runnymede 005D,E01030692,888,582,306,137,46,123
2011,Runnymede 006A,E01030652,1193,906,287,123,42,122
2011,Runnymede 006B,E01030653,1037,822,215,99,33,83
2011,Runnymede 006C,E01030654,1083,893,190,99,17,74
2011,Runnymede 006D,E01030657,1072,810,262,118,30,114
2011,Runnymede 006E,E01030659,1178,915,263,135,45,83
2011,Runnymede 007A,E01030647,1176,841,335,222,28,85
2011,Runnymede 007B,E01030648,1149,907,242,124,30,88
2011,Runnymede 007C,E01030649,1206,959,247,121,24,102
2011,Runnymede 007D,E01030650,916,674,242,106,27,109
2011,Runnymede 007E,E01030651,1009,755,254,151,27,76
2011,Runnymede 007F,E01030655,1190,903,287,170,39,78
2011,Runnymede 007G,E01030662,1060,791,269,144,49,76
2011,Runnymede 008A,E01030677,1197,946,251,132,40,79
2011,Runnymede 008B,E01030678,970,759,211,97,29,85
2011,Runnymede 008C,E01030679,906,671,235,149,20,66
2011,Runnymede 008D,E01030680,1090,805,285,191,42,52
2011,Runnymede 009A,E01030645,1309,960,349,162,44,143
2011,Runnymede 009B,E01030646,1553,1249,304,175,38,91
2011,Runnymede 009C,E01030660,1528,1209,319,179,51,89
2011,Runnymede 009D,E01030661,1186,830,356,242,33,81
2011,Runnymede 009E,E01030684,1115,865,250,136,24,90
2011,Runnymede 010A,E01030681,1167,892,275,160,29,86
2011,Runnymede 010B,E01030682,961,770,191,106,30,55
2011,Runnymede 010C,E01030683,1017,809,208,117,28,63
2011,Runnymede 010D,E01030693,857,620,237,158,19,60
2011,Runnymede 010E,E01030694,978,747,231,112,40,79
2011,Runnymede 010F,E01030695,920,635,285,198,34,53
2011,Runnymede 010G,E01030696,1016,742,274,171,31,72
2011,Spelthorne 001A,E01030743,1150,841,309,172,44,93
2011,Spelthorne 001B,E01030744,1238,936,302,119,39,144
2011,Spelthorne 001C,E01030745,1143,836,307,111,52,144
2011,Spelthorne 001D,E01030747,1081,835,246,110,39,97
2011,Spelthorne 002A,E01030709,1106,875,231,99,33,99
2011,Spelthorne 002B,E01030710,1193,923,270,99,34,137
2011,Spelthorne 002C,E01030711,1245,910,335,140,40,155
2011,Spelthorne 002D,E01030746,1114,790,324,144,38,142
2011,Spelthorne 003A,E01030707,1228,964,264,146,35,83
2011,Spelthorne 003B,E01030708,1217,940,277,146,52,79
2011,Spelthorne 003C,E01030712,1010,791,219,120,34,65
2011,Spelthorne 003D,E01030713,927,736,191,99,33,59
2011,Spelthorne 003E,E01030714,1153,803,350,126,44,180
2011,Spelthorne 003F,E01030715,1128,869,259,147,46,66
2011,Spelthorne 003G,E01030716,1121,832,289,189,35,65
2011,Spelthorne 004A,E01030734,1157,950,207,97,40,70
2011,Spelthorne 004B,E01030735,1175,924,251,138,34,79
2011,Spelthorne 004C,E01030736,1473,1200,273,100,39,134
2011,Spelthorne 004D,E01030737,1097,849,248,121,40,87
2011,Spelthorne 004E,E01030738,1126,899,227,85,34,108
2011,Spelthorne 005A,E01030701,1087,823,264,143,39,82
2011,Spelthorne 005B,E01030702,803,576,227,96,37,94
2011,Spelthorne 005C,E01030703,1119,830,289,191,28,70
2011,Spelthorne 005D,E01030704,1046,759,287,195,32,60
2011,Spelthorne 005E,E01030705,1191,916,275,171,24,80
2011,Spelthorne 005F,E01030706,1069,838,231,148,21,62
2011,Spelthorne 006A,E01030697,1156,872,284,178,32,74
2011,Spelthorne 006B,E01030698,1190,928,262,141,37,84
2011,Spelthorne 006C,E01030699,1069,750,319,192,27,100
2011,Spelthorne 006D,E01030700,1292,1015,277,146,27,104
2011,Spelthorne 006E,E01030725,1339,1106,233,85,36,112
2011,Spelthorne 007A,E01030729,1133,847,286,151,41,94
2011,Spelthorne 007B,E01030739,1127,807,320,138,44,138
2011,Spelthorne 007C,E01030740,1237,875,362,188,39,135
2011,Spelthorne 007D,E01030741,1326,1043,283,127,49,107
2011,Spelthorne 008A,E01030748,1263,948,315,144,51,120
2011,Spelthorne 008B,E01030749,1058,803,255,105,38,112
2011,Spelthorne 008C,E01030750,1169,915,254,100,53,101
2011,Spelthorne 008D,E01030751,1192,934,258,118,48,92
2011,Spelthorne 008E,E01030752,1149,867,282,111,44,127
2011,Spelthorne 009A,E01030726,1217,928,289,183,38,68
2011,Spelthorne 009B,E01030727,1376,1069,307,194,31,82
2011,Spelthorne 009C,E01030728,1226,883,343,251,31,61
2011,Spelthorne 009D,E01030742,1377,1044,333,214,31,88
2011,Spelthorne 010A,E01030753,1234,904,330,225,45,60
2011,Spelthorne 010B,E01030754,1073,786,287,191,34,62
2011,Spelthorne 010C,E01030755,1367,1034,333,173,36,124
2011,Spelthorne 010D,E01030756,1232,913,319,198,41,80
2011,Spelthorne 011A,E01030717,1192,868,324,208,35,81
2011,Spelthorne 011B,E01030718,977,740,237,128,32,77
2011,Spelthorne 011C,E01030719,1080,758,322,173,46,103
2011,Spelthorne 011D,E01030720,1098,772,326,198,54,74
2011,Spelthorne 012A,E01030721,1079,798,281,163,34,84
2011,Spelthorne 012B,E01030722,1182,921,261,161,28,72
2011,Spelthorne 012C,E01030723,1176,874,302,197,34,71
2011,Spelthorne 012D,E01030724,1088,822,266,127,36,103
2011,Spelthorne 013A,E01030730,1268,880,388,299,35,54
2011,Spelthorne 013B,E01030731,1333,995,338,203,52,83
2011,Spelthorne 013C,E01030732,1116,785,331,239,26,66
2011,Spelthorne 013D,E01030733,1128,838,290,188,29,73
2011,Surrey Heath 001A,E01030763,918,662,256,163,27,66
2011,Surrey Heath 001B,E01030764,889,615,274,156,37,81
2011,Surrey Heath 001C,E01030765,975,706,269,156,29,84
2011,Surrey Heath 001D,E01030809,1036,787,249,160,18,71
2011,Surrey Heath 001E,E01030810,1032,720,312,193,39,80
2011,Surrey Heath 001F,E01030811,1067,787,280,160,37,83
2011,Surrey Heath 002A,E01030757,1225,1010,215,112,30,73
2011,Surrey Heath 002B,E01030758,820,649,171,117,14,40
2011,Surrey Heath 002C,E01030759,1089,820,269,140,33,96
2011,Surrey Heath 002D,E01030760,939,708,231,150,19,62
2011,Surrey Heath 003A,E01030778,1349,982,367,234,50,83
2011,Surrey Heath 003B,E01030779,1244,920,324,224,28,72
2011,Surrey Heath 003C,E01030780,1207,938,269,162,48,59
2011,Surrey Heath 003D,E01030781,1129,901,228,137,21,70
2011,Surrey Heath 004A,E01030786,1253,902,351,134,38,179
2011,Surrey Heath 004B,E01030787,981,771,210,80,32,98
2011,Surrey Heath 004C,E01030788,956,687,269,105,42,122
2011,Surrey Heath 004D,E01030801,1211,956,255,80,42,133
2011,Surrey Heath 004E,E01030802,1229,908,321,175,45,101
2011,Surrey Heath 005A,E01030796,972,718,254,153,30,71
2011,Surrey Heath 005B,E01030797,1039,814,225,116,48,61
2011,Surrey Heath 005C,E01030798,1068,706,362,218,54,90
2011,Surrey Heath 005D,E01030799,1028,721,307,187,53,67
2011,Surrey Heath 005E,E01030800,1155,858,297,149,45,103
2011,Surrey Heath 006A,E01030761,1615,1031,584,161,48,375
2011,Surrey Heath 006B,E01030762,1411,1155,256,127,44,85
2011,Surrey Heath 006C,E01030806,1138,866,272,143,65,64
2011,Surrey Heath 006D,E01030807,1019,731,288,140,62,86
2011,Surrey Heath 006E,E01030808,1134,871,263,149,39,75
2011,Surrey Heath 007A,E01030774,1015,812,203,98,34,71
2011,Surrey Heath 007B,E01030775,1064,747,317,216,37,64
2011,Surrey Heath 007C,E01030776,1223,904,319,209,45,65
2011,Surrey Heath 007D,E01030777,1172,932,240,124,35,81
2011,Surrey Heath 008A,E01030793,1120,834,286,78,40,168
2011,Surrey Heath 008B,E01030794,1179,891,288,120,41,127
2011,Surrey Heath 008C,E01030795,1474,1160,314,187,34,93
2011,Surrey Heath 008D,E01030803,1300,1024,276,130,42,104
2011,Surrey Heath 008E,E01030804,1274,934,340,205,45,90
2011,Surrey Heath 008F,E01030805,1168,835,333,126,58,149
2011,Surrey Heath 009A,E01030789,1096,778,318,208,50,60
2011,Surrey Heath 009B,E01030790,1200,926,274,161,45,68
2011,Surrey Heath 009C,E01030791,1237,922,315,227,40,48
2011,Surrey Heath 009D,E01030792,998,709,289,180,44,65
2011,Surrey Heath 010A,E01030766,1195,908,287,159,38,90
2011,Surrey Heath 010B,E01030767,1113,847,266,124,36,106
2011,Surrey Heath 010C,E01030768,1007,754,253,145,38,70
2011,Surrey Heath 010D,E01030769,1161,869,292,179,54,59
2011,Surrey Heath 011A,E01030770,1130,887,243,154,32,57
2011,Surrey Heath 011B,E01030771,986,755,231,135,44,52
2011,Surrey Heath 011C,E01030772,1087,797,290,148,46,96
2011,Surrey Heath 011D,E01030773,1069,871,198,128,26,44
2011,Surrey Heath 012A,E01030782,1140,844,296,180,37,79
2011,Surrey Heath 012B,E01030783,1188,946,242,140,37,65
2011,Surrey Heath 012C,E01030784,1749,1464,285,91,55,139
2011,Surrey Heath 012D,E01030785,1092,766,326,208,35,83
2011,Tandridge 002A,E01030855,1402,962,440,296,59,85
2011,Tandridge 002B,E01030856,1054,764,290,171,37,82
2011,Tandridge 002C,E01030859,1476,1194,282,132,56,94
2011,Tandridge 002D,E01030860,1529,1241,288,131,35,122
2011,Tandridge 003A,E01030844,1305,988,317,138,52,127
2011,Tandridge 003B,E01030845,906,724,182,82,36,64
2011,Tandridge 003C,E01030846,1062,750,312,193,45,74
2011,Tandridge 003D,E01030857,1542,1224,318,124,56,138
2011,Tandridge 003E,E01030858,1584,1186,398,183,63,152
2011,Tandridge 004A,E01030828,1016,662,354,145,129,80
2011,Tandridge 004B,E01030829,1034,780,254,140,27,87
2011,Tandridge 004C,E01030830,941,723,218,114,41,63
2011,Tandridge 004D,E01030850,1517,1196,321,137,36,148
2011,Tandridge 004E,E01030851,1527,1162,365,165,73,127
2011,Tandridge 004F,E01030861,1502,940,562,264,173,125
2011,Tandridge 005A,E01030820,1237,846,391,234,55,102
2011,Tandridge 005B,E01030847,1091,742,349,191,50,108
2011,Tandridge 005C,E01030848,1543,1197,346,175,68,103
2011,Tandridge 006A,E01030831,1602,1129,473,284,76,113
2011,Tandridge 006B,E01030832,941,636,305,174,34,97
2011,Tandridge 006C,E01030836,1015,751,264,137,56,71
2011,Tandridge 006D,E01030837,986,741,245,128,47,70
2011,Tandridge 006E,E01030838,942,686,256,149,35,72
2011,Tandridge 006F,E01030839,970,667,303,155,51,97
2011,Tandridge 007A,E01030840,1019,759,260,120,47,93
2011,Tandridge 007B,E01030841,861,609,252,154,39,59
2011,Tandridge 007C,E01030842,1279,958,321,144,43,134
2011,Tandridge 007D,E01030843,1088,813,275,135,46,94
2011,Tandridge 008A,E01030812,1142,841,301,161,39,101
2011,Tandridge 008B,E01030813,1151,862,289,151,42,96
2011,Tandridge 008C,E01030814,920,655,265,133,43,89
2011,Tandridge 008D,E01030815,1065,780,285,140,43,102
2011,Tandridge 009A,E01030824,992,736,256,115,28,113
2011,Tandridge 009B,E01030825,984,709,275,167,31,77
2011,Tandridge 009C,E01030826,1020,763,257,123,40,94
2011,Tandridge 009D,E01030827,1157,873,284,169,30,85
2011,Tandridge 010A,E01030821,1710,1249,461,198,160,103
2011,Tandridge 010B,E01030822,1307,950,357,215,45,97
2011,Tandridge 010C,E01030833,871,634,237,155,19,63
2011,Tandridge 010D,E01030834,1028,762,266,145,28,93
2011,Tandridge 010E,E01030835,1066,789,277,163,40,74
2011,Tandridge 011A,E01030816,1169,859,310,169,53,88
2011,Tandridge 011B,E01030817,1039,779,260,174,41,45
2011,Tandridge 011C,E01030818,898,640,258,156,32,70
2011,Tandridge 011D,E01030819,1134,824,310,162,30,118
2011,Tandridge 011E,E01030823,1547,1089,458,301,57,100
2011,Tandridge 012A,E01030852,1387,1027,360,181,51,128
2011,Tandridge 012B,E01030853,1195,871,324,172,54,98
2011,Tandridge 012C,E01030854,1329,969,360,207,67,86
2011,Tandridge 012D,E01032571,1375,1001,374,238,43,93
2011,Waverley 001A,E01030890,1082,794,288,149,40,99
2011,Waverley 001B,E01030902,956,721,235,173,25,37
2011,Waverley 001C,E01030903,1165,928,237,131,29,77
2011,Waverley 001D,E01030904,983,692,291,198,22,71
2011,Waverley 002A,E01030891,1145,884,261,179,28,54
2011,Waverley 002B,E01030892,951,713,238,131,39,68
2011,Waverley 002C,E01030899,1191,908,283,176,35,72
2011,Waverley 002D,E01030900,903,637,266,179,24,63
2011,Waverley 002E,E01030901,1012,723,289,85,64,140
2011,Waverley 003A,E01030884,1130,794,336,145,83,108
2011,Waverley 003B,E01030885,1072,657,415,92,262,61
2011,Waverley 003C,E01030886,906,660,246,114,55,77
2011,Waverley 003D,E01030893,1385,1037,348,141,65,142
2011,Waverley 003E,E01030895,1110,828,282,77,116,89
2011,Waverley 004A,E01030881,924,591,333,198,43,92
2011,Waverley 004B,E01030883,908,626,282,126,46,110
2011,Waverley 004C,E01030888,1037,750,287,140,41,106
2011,Waverley 004D,E01030894,1099,739,360,195,56,109
2011,Waverley 005A,E01030911,1111,809,302,185,25,92
2011,Waverley 005B,E01030912,941,738,203,107,18,78
2011,Waverley 005C,E01030913,892,675,217,101,24,92
2011,Waverley 005D,E01030920,1102,887,215,117,23,75
2011,Waverley 005E,E01030921,1172,916,256,139,29,88
2011,Waverley 006A,E01030882,916,666,250,147,27,76
2011,Waverley 006B,E01030887,903,660,243,148,37,58
2011,Waverley 006C,E01030889,993,724,269,118,48,103
2011,Waverley 006D,E01030896,862,666,196,83,29,84
2011,Waverley 006E,E01030897,946,694,252,123,44,85
2011,Waverley 007A,E01030916,1281,1062,219,115,24,80
2011,Waverley 007B,E01030917,857,729,128,60,13,55
2011,Waverley 007C,E01030918,809,603,206,128,20,58
2011,Waverley 007D,E01030919,1326,673,653,188,404,61
2011,Waverley 007E,E01030922,1075,847,228,141,21,66
2011,Waverley 008A,E01030863,1300,884,416,222,63,131
2011,Waverley 008B,E01030865,1073,698,375,168,103,104
2011,Waverley 008C,E01030866,1082,802,280,157,33,90
2011,Waverley 008D,E01030940,1200,835,365,186,49,130
2011,Waverley 009A,E01030898,1095,779,316,187,41,88
2011,Waverley 009B,E01030905,1131,841,290,140,54,96
2011,Waverley 009C,E01030906,1192,872,320,182,52,86
2011,Waverley 009D,E01030907,856,556,300,167,61,72
2011,Waverley 010A,E01030914,972,675,297,82,28,187
2011,Waverley 010B,E01030915,1160,907,253,132,41,80
2011,Waverley 010C,E01030923,1014,720,294,166,39,89
2011,Waverley 010D,E01030924,904,698,206,109,37,60
2011,Waverley 010E,E01030925,1123,858,265,143,41,81
2011,Waverley 011A,E01030877,813,532,281,169,27,85
2011,Waverley 011B,E01030878,1085,759,326,208,40,78
2011,Waverley 011C,E01030937,1133,890,243,124,37,82
2011,Waverley 011D,E01030938,904,648,256,142,23,91
2011,Waverley 011E,E01030939,832,634,198,119,26,53
2011,Waverley 012A,E01030864,1057,708,349,153,52,144
2011,Waverley 012B,E01030879,800,572,228,122,24,82
2011,Waverley 012C,E01030941,1049,693,356,130,151,75
2011,Waverley 012D,E01030942,1018,727,291,141,50,100
2011,Waverley 012E,E01030943,896,677,219,114,27,78
2011,Waverley 013A,E01030870,1164,783,381,264,53,64
2011,Waverley 013B,E01030871,1219,909,310,186,44,80
2011,Waverley 013C,E01030872,1191,870,321,182,33,106
2011,Waverley 013D,E01030873,992,727,265,149,41,75
2011,Waverley 013E,E01030874,1144,672,472,174,235,63
2011,Waverley 013F,E01030875,957,731,226,135,24,67
2011,Waverley 013G,E01030876,891,557,334,257,23,54
2011,Waverley 015A,E01030862,1184,820,364,241,32,91
2011,Waverley 015B,E01030867,1022,740,282,171,28,83
2011,Waverley 015C,E01030868,929,663,266,151,47,68
2011,Waverley 015D,E01030869,859,630,229,110,32,87
2011,Waverley 015E,E01030880,1647,952,695,267,306,122
2011,Waverley 016A,E01030930,1032,725,307,151,32,124
2011,Waverley 016B,E01030931,1137,822,315,185,29,101
2011,Waverley 016C,E01030932,1046,781,265,126,38,101
2011,Waverley 016D,E01030933,1180,844,336,186,31,119
2011,Waverley 017A,E01030926,1061,773,288,142,34,112
2011,Waverley 017B,E01030927,967,759,208,97,27,84
2011,Waverley 017C,E01030928,1244,966,278,119,40,119
2011,Waverley 017D,E01030929,980,708,272,100,69,103
2011,Waverley 018A,E01030908,1195,808,387,158,59,170
2011,Waverley 018B,E01030909,885,631,254,136,42,76
2011,Waverley 018C,E01030910,857,586,271,167,31,73
2011,Waverley 018D,E01030934,1033,763,270,144,32,94
2011,Waverley 018E,E01030935,950,709,241,111,43,87
2011,Waverley 018F,E01032626,1017,724,293,159,39,95
2011,Woking 001A,E01030946,950,713,237,119,25,93
2011,Woking 001B,E01030947,1054,824,230,125,34,71
2011,Woking 001C,E01030948,1134,923,211,122,31,58
2011,Woking 001D,E01030949,1236,1015,221,110,16,95
2011,Woking 001E,E01030950,1127,872,255,140,30,85
2011,Woking 002A,E01030996,1080,757,323,196,36,91
2011,Woking 002B,E01030998,1290,799,491,319,52,120
2011,Woking 002C,E01031002,1224,845,379,216,43,120
2011,Woking 002D,E01031003,1213,881,332,173,32,127
2011,Woking 002E,E01031004,1523,1209,314,181,27,106
2011,Woking 003A,E01030963,1067,702,365,215,57,93
2011,Woking 003B,E01030964,1332,1000,332,169,40,123
2011,Woking 003C,E01030965,1060,749,311,170,53,88
2011,Woking 003D,E01030966,993,747,246,103,40,103
2011,Woking 003E,E01030967,1113,809,304,189,39,76
2011,Woking 003F,E01030968,940,684,256,121,36,99
2011,Woking 004A,E01030980,1296,933,363,65,65,233
2011,Woking 004B,E01030981,1154,767,387,87,66,234
2011,Woking 004C,E01030982,1363,1033,330,74,52,204
2011,Woking 004D,E01030983,1389,1027,362,70,68,224
2011,Woking 004E,E01030984,1367,1016,351,80,62,209
2011,Woking 004F,E01030985,1109,755,354,81,50,223
2011,Woking 005A,E01030951,1005,805,200,99,21,80
2011,Woking 005B,E01030952,987,684,303,80,37,186
2011,Woking 005C,E01030953,1127,860,267,150,34,83
2011,Woking 005D,E01030956,1044,855,189,64,35,90
2011,Woking 005E,E01030957,954,778,176,60,22,94
2011,Woking 005F,E01030958,1151,921,230,105,48,77
2011,Woking 005G,E01030959,742,589,153,80,18,55
2011,Woking 006A,E01030988,1478,1133,345,138,68,139
2011,Woking 006B,E01030989,1222,937,285,123,52,110
2011,Woking 006C,E01030990,1028,668,360,186,55,119
2011,Woking 006D,E01030997,1078,735,343,252,31,60
2011,Woking 007A,E01030974,1189,931,258,108,43,107
2011,Woking 007B,E01030975,1044,804,240,120,38,82
2011,Woking 007C,E01030976,1121,887,234,114,36,84
2011,Woking 007D,E01030977,1314,968,346,185,27,134
2011,Woking 007E,E01030979,1547,1268,279,86,56,137
2011,Woking 008A,E01030954,1744,1412,332,123,80,129
2011,Woking 008B,E01030969,1027,782,245,120,38,87
2011,Woking 008C,E01030970,1054,779,275,136,39,100
2011,Woking 008D,E01030991,1428,1147,281,137,33,111
2011,Woking 008E,E01030993,1927,1601,326,108,48,170
2011,Woking 009A,E01030960,1310,1092,218,98,39,81
2011,Woking 009B,E01030961,1334,1017,317,197,45,75
2011,Woking 009C,E01030962,1303,981,322,153,39,130
2011,Woking 009D,E01031000,1145,843,302,166,32,104
2011,Woking 010A,E01030955,1069,803,266,158,25,83
2011,Woking 010B,E01030992,1249,977,272,129,43,100
2011,Woking 010C,E01030999,968,621,347,160,54,133
2011,Woking 010D,E01031001,1244,955,289,158,41,90
2011,Woking 011A,E01030971,1347,1001,346,154,56,136
2011,Woking 011B,E01030972,1305,999,306,126,64,116
2011,Woking 011C,E01030973,1284,932,352,175,45,132
2011,Woking 011D,E01030994,1284,1013,271,128,37,106
2011,Woking 011E,E01030995,998,785,213,78,42,93
2011,Woking 012A,E01030944,1006,743,263,126,42,95
2011,Woking 012B,E01030945,826,652,174,93,28,53
2011,Woking 012C,E01030978,1066,808,258,109,41,108
2011,Woking 012D,E01030986,744,528,216,136,30,50
2011,Woking 012E,E01030987,1015,698,317,199,43,75
2011,Adur 001A,E01031349,989,697,292,194,32,66
2011,Adur 001B,E01031350,892,662,230,94,31,105
2011,Adur 001C,E01031351,1075,780,295,179,34,82
2011,Adur 001D,E01031352,1035,695,340,216,29,95
2011,Adur 001E,E01031370,995,740,255,122,21,112
2011,Adur 001F,E01031374,1083,788,295,167,30,98
2011,Adur 002A,E01031338,874,641,233,162,23,48
2011,Adur 002B,E01031339,875,672,203,141,23,39
2011,Adur 002C,E01031340,1088,764,324,246,34,44
2011,Adur 002D,E01031365,1046,764,282,185,26,71
2011,Adur 002E,E01031367,952,683,269,213,22,34
2011,Adur 003A,E01031345,1116,822,294,195,26,73
2011,Adur 003B,E01031353,983,577,406,172,177,57
2011,Adur 003C,E01031354,908,634,274,184,21,69
2011,Adur 003D,E01031355,1147,831,316,180,45,91
2011,Adur 003E,E01031359,1002,767,235,125,33,77
2011,Adur 004A,E01031347,1154,801,353,138,53,162
2011,Adur 004B,E01031348,1152,807,345,118,46,181
2011,Adur 004C,E01031366,976,705,271,98,41,132
2011,Adur 004D,E01031371,862,566,296,124,24,148
2011,Adur 004E,E01031372,846,557,289,127,36,126
2011,Adur 004F,E01031373,1053,776,277,147,26,104
2011,Adur 004G,E01031375,1034,758,276,189,23,64
2011,Adur 005A,E01031356,1694,1308,386,230,51,105
2011,Adur 005B,E01031357,1634,1290,344,186,42,116
2011,Adur 005C,E01031364,1134,804,330,164,34,132
2011,Adur 005D,E01031368,903,653,250,170,21,59
2011,Adur 005E,E01031369,866,593,273,187,26,60
2011,Adur 006A,E01031344,1011,687,324,163,36,125
2011,Adur 006B,E01031346,1018,702,316,211,17,88
2011,Adur 006C,E01031361,1068,717,351,150,46,155
2011,Adur 006D,E01031362,932,720,212,129,35,48
2011,Adur 006E,E01031363,1145,726,419,300,30,89
2011,Adur 007A,E01031358,1059,703,356,168,45,143
2011,Adur 007B,E01031360,1119,771,348,170,39,139
2011,Adur 007C,E01031376,911,588,323,236,18,69
2011,Adur 007D,E01031378,976,706,270,169,18,83
2011,Adur 008A,E01031341,938,638,300,129,43,128
2011,Adur 008B,E01031342,1126,699,427,318,17,92
2011,Adur 008C,E01031343,991,714,277,177,24,76
2011,Adur 008D,E01031377,1119,805,314,165,28,121
2011,Adur 008E,E01031379,1079,743,336,237,24,75
2011,Arun 001A,E01031390,941,640,301,189,40,72
2011,Arun 001B,E01031391,1091,803,288,203,17,68
2011,Arun 001C,E01031392,1074,758,316,202,29,85
2011,Arun 001D,E01031465,1027,695,332,200,47,85
2011,Arun 002A,E01031386,1066,771,295,183,26,86
2011,Arun 002B,E01031387,1093,732,361,257,30,74
2011,Arun 002C,E01031425,984,631,353,255,30,68
2011,Arun 002D,E01031426,879,604,275,176,25,74
2011,Arun 003A,E01031393,1257,888,369,249,41,79
2011,Arun 003B,E01031394,1237,945,292,143,40,109
2011,Arun 003C,E01031395,1114,807,307,196,36,75
2011,Arun 003D,E01031396,1365,1016,349,204,48,97
2011,Arun 003E,E01031397,1226,902,324,206,45,73
2011,Arun 003F,E01031466,989,679,310,185,29,96
2011,Arun 004A,E01031427,942,615,327,127,33,167
2011,Arun 004B,E01031429,993,656,337,105,39,193
2011,Arun 004C,E01031430,1023,721,302,160,18,124
2011,Arun 004D,E01031467,1278,883,395,218,51,126
2011,Arun 004E,E01031468,1694,1303,391,187,47,157
2011,Arun 005A,E01031388,1842,1368,474,277,49,148
2011,Arun 005B,E01031389,1483,940,543,412,40,91
2011,Arun 005C,E01031414,1048,703,345,223,29,93
2011,Arun 005D,E01031415,949,573,376,260,35,81
2011,Arun 005E,E01031459,1246,833,413,219,56,138
2011,Arun 006A,E01031470,1466,863,603,212,36,355
2011,Arun 006B,E01031471,969,742,227,145,25,57
2011,Arun 006C,E01031472,1102,751,351,220,32,99
2011,Arun 006D,E01031473,860,599,261,132,28,101
2011,Arun 007A,E01031407,1139,883,256,141,41,74
2011,Arun 007B,E01031408,1430,1067,363,206,37,120
2011,Arun 007C,E01031410,945,700,245,139,32,74
2011,Arun 007D,E01031462,1038,739,299,196,27,76
2011,Arun 007E,E01031463,1084,768,316,225,23,68
2011,Arun 007F,E01031464,1009,622,387,288,18,81
2011,Arun 008A,E01031412,975,609,366,295,24,47
2011,Arun 008B,E01031422,979,483,496,413,23,60
2011,Arun 008C,E01031423,1128,699,429,314,39,76
2011,Arun 008D,E01031424,865,495,370,301,14,55
2011,Arun 009A,E01031398,1074,754,320,201,34,85
2011,Arun 009B,E01031399,1171,705,466,358,42,66
2011,Arun 009C,E01031409,992,689,303,150,33,120
2011,Arun 009D,E01031455,970,630,340,188,43,109
2011,Arun 009E,E01031461,1201,748,453,356,18,79
2011,Arun 009F,E01031469,1194,796,398,246,36,116
2011,Arun 010A,E01031411,900,447,453,372,20,61
2011,Arun 010B,E01031413,854,551,303,227,25,51
2011,Arun 010C,E01031457,1047,592,455,379,18,58
2011,Arun 010D,E01031458,1172,598,574,487,16,71
2011,Arun 010E,E01031460,1079,583,496,384,17,95
2011,Arun 011A,E01031400,1192,854,338,194,14,130
2011,Arun 011B,E01031428,1160,891,269,129,34,106
2011,Arun 011C,E01031454,1641,1167,474,188,55,231
2011,Arun 011D,E01031456,1291,866,425,185,51,189
2011,Arun 012A,E01031401,1106,818,288,177,28,83
2011,Arun 012B,E01031402,1208,864,344,236,24,84
2011,Arun 012C,E01031403,1023,747,276,163,29,84
2011,Arun 012D,E01031405,983,748,235,148,30,57
2011,Arun 012E,E01031406,961,729,232,107,44,81
2011,Arun 013A,E01031417,1139,797,342,216,34,92
2011,Arun 013B,E01031438,1141,825,316,192,38,86
2011,Arun 013C,E01031439,1263,760,503,381,30,92
2011,Arun 013D,E01031440,1114,633,481,358,22,101
2011,Arun 014A,E01031404,845,574,271,82,45,144
2011,Arun 014B,E01031433,1057,658,399,223,72,104
2011,Arun 014C,E01031434,1220,892,328,138,59,131
2011,Arun 014D,E01031441,1162,790,372,176,42,154
2011,Arun 014E,E01031442,1162,881,281,127,45,109
2011,Arun 015A,E01031416,1149,719,430,289,41,100
2011,Arun 015B,E01031418,1201,791,410,311,33,66
2011,Arun 015C,E01031419,1123,760,363,255,31,77
2011,Arun 015D,E01031420,1085,686,399,283,30,86
2011,Arun 015E,E01031421,1167,758,409,298,43,68
2011,Arun 016A,E01031443,981,742,239,103,38,98
2011,Arun 016B,E01031444,1213,908,305,110,60,135
2011,Arun 016C,E01031450,918,629,289,96,47,146
2011,Arun 016D,E01031451,1044,717,327,149,30,148
2011,Arun 016E,E01031452,1040,720,320,160,50,110
2011,Arun 017A,E01031431,1353,1037,316,135,125,56
2011,Arun 017B,E01031432,1469,1052,417,171,61,185
2011,Arun 017C,E01031435,1247,845,402,206,48,148
2011,Arun 017D,E01031436,1380,977,403,160,45,198
2011,Arun 017E,E01031437,1479,1033,446,203,38,205
2011,Arun 017F,E01031453,1164,792,372,186,42,144
2011,Arun 018A,E01031380,1091,622,469,384,26,59
2011,Arun 018B,E01031381,1039,656,383,291,24,68
2011,Arun 018C,E01031382,1169,709,460,385,20,55
2011,Arun 018D,E01031383,1082,605,477,407,21,49
2011,Arun 018E,E01031384,1164,721,443,348,25,70
2011,Arun 019A,E01031385,1027,659,368,244,22,102
2011,Arun 019B,E01031445,1059,585,474,380,21,73
2011,Arun 019C,E01031446,926,614,312,243,14,55
2011,Arun 019D,E01031447,1066,635,431,338,22,71
2011,Arun 019E,E01031448,1133,710,423,323,16,84
2011,Arun 019F,E01031449,1150,818,332,176,44,112
2011,Chichester 001A,E01031502,1077,789,288,149,25,114
2011,Chichester 001B,E01031503,1098,801,297,126,30,141
2011,Chichester 001C,E01031504,1436,1026,410,234,37,139
2011,Chichester 001D,E01031519,1021,688,333,172,29,132
2011,Chichester 002A,E01031517,1308,917,391,266,44,81
2011,Chichester 002B,E01031518,1106,749,357,222,32,103
2011,Chichester 002C,E01031544,922,678,244,126,36,82
2011,Chichester 002D,E01031545,864,623,241,159,21,61
2011,Chichester 003A,E01031508,1451,1017,434,250,50,134
2011,Chichester 003B,E01031520,914,636,278,154,45,79
2011,Chichester 003C,E01031521,834,589,245,139,25,81
2011,Chichester 003D,E01031536,832,568,264,155,23,86
2011,Chichester 004A,E01031497,941,667,274,174,27,73
2011,Chichester 004C,E01031511,999,674,325,242,22,61
2011,Chichester 004D,E01031512,1375,983,392,217,44,131
2011,Chichester 004F,E01032717,1771,1245,526,353,35,138
2011,Chichester 005A,E01031478,817,541,276,161,67,48
2011,Chichester 005B,E01031479,759,503,256,153,30,73
2011,Chichester 005C,E01031498,793,547,246,138,29,79
2011,Chichester 005D,E01031514,1116,763,353,223,27,103
2011,Chichester 005E,E01031515,1130,817,313,165,35,113
2011,Chichester 005F,E01031516,1068,720,348,209,33,106
2011,Chichester 006A,E01031477,1589,1103,486,267,82,137
2011,Chichester 006B,E01031485,1010,625,385,298,49,38
2011,Chichester 006C,E01031487,1054,617,437,282,81,74
2011,Chichester 006D,E01031509,1739,1276,463,263,68,132
2011,Chichester 007A,E01031506,906,628,278,192,35,51
2011,Chichester 007B,E01031507,1027,707,320,186,41,93
2011,Chichester 007C,E01031531,927,656,271,188,27,56
2011,Chichester 007D,E01031533,796,583,213,116,28,69
2011,Chichester 007E,E01031543,1656,1151,505,304,56,145
2011,Chichester 008A,E01031482,1170,880,290,86,92,112
2011,Chichester 008B,E01031483,1804,1263,541,142,177,222
2011,Chichester 008C,E01031486,1404,881,523,222,255,46
2011,Chichester 008D,E01031488,1473,1016,457,121,229,107
2011,Chichester 008E,E01031494,1090,712,378,165,63,150
2011,Chichester 008F,E01031495,1118,811,307,175,71,61
2011,Chichester 009A,E01031475,920,654,266,181,30,55
2011,Chichester 009B,E01031476,1015,661,354,262,34,58
2011,Chichester 009C,E01031532,1198,1025,173,69,20,84
2011,Chichester 009D,E01031534,1234,830,404,282,33,89
2011,Chichester 009E,E01031535,1098,755,343,229,30,84
2011,Chichester 010A,E01031480,1042,786,256,94,51,111
2011,Chichester 010B,E01031481,1156,816,340,170,61,109
2011,Chichester 010C,E01031484,1342,941,401,199,100,102
2011,Chichester 010D,E01031490,1304,838,466,214,174,78
2011,Chichester 010E,E01031491,1356,1014,342,184,73,85
2011,Chichester 011A,E01031474,1023,748,275,170,33,72
2011,Chichester 011B,E01031493,1167,763,404,245,63,96
2011,Chichester 011C,E01031496,1573,1184,389,273,42,74
2011,Chichester 011D,E01031505,1612,1186,426,289,51,86
2011,Chichester 012A,E01031489,1117,833,284,159,65,60
2011,Chichester 012B,E01031492,1068,734,334,156,64,114
2011,Chichester 012C,E01031513,1599,1130,469,299,41,129
2011,Chichester 012D,E01031530,930,635,295,180,37,78
2011,Chichester 012E,E01031538,1113,816,297,130,51,116
2011,Chichester 012F,E01031539,818,636,182,84,25,73
2011,Chichester 013A,E01031499,1304,920,384,245,42,97
2011,Chichester 013B,E01031500,1344,881,463,318,47,98
2011,Chichester 013C,E01031501,936,616,320,222,29,69
2011,Chichester 013D,E01031529,856,612,244,150,23,71
2011,Chichester 013E,E01031540,924,529,395,289,25,81
2011,Chichester 013F,E01031541,876,543,333,248,14,71
2011,Chichester 013G,E01031542,1251,830,421,295,41,85
2011,Chichester 014A,E01031522,1340,914,426,251,41,134
2011,Chichester 014B,E01031523,1106,684,422,298,37,87
2011,Chichester 014C,E01031524,1036,573,463,373,17,73
2011,Chichester 014D,E01031525,1003,667,336,244,30,62
2011,Chichester 014E,E01031526,920,574,346,255,17,74
2011,Chichester 014F,E01031527,1075,647,428,312,25,91
2011,Chichester 014G,E01031528,986,677,309,210,24,75
2011,Crawley 001A,E01031573,1121,817,304,103,40,161
2011,Crawley 001B,E01031574,1299,971,328,115,62,151
2011,Crawley 001C,E01031575,1365,993,372,89,54,229
2011,Crawley 001D,E01031576,1090,768,322,115,50,157
2011,Crawley 001E,E01031577,998,695,303,113,46,144
2011,Crawley 002A,E01031586,1271,1028,243,108,27,108
2011,Crawley 002B,E01031587,1301,998,303,175,39,89
2011,Crawley 002C,E01031588,1081,835,246,138,31,77
2011,Crawley 002D,E01031590,1236,991,245,136,40,69
2011,Crawley 002E,E01031593,1076,862,214,121,32,61
2011,Crawley 003A,E01031570,979,769,210,99,29,82
2011,Crawley 003B,E01031571,1122,851,271,116,37,118
2011,Crawley 003C,E01031572,996,716,280,106,36,138
2011,Crawley 003D,E01031609,1130,809,321,140,30,151
2011,Crawley 003E,E01031610,1245,947,298,127,36,135
2011,Crawley 004A,E01031583,1550,1251,299,92,48,159
2011,Crawley 004B,E01031584,1193,914,279,110,35,134
2011,Crawley 004C,E01031585,1228,920,308,137,46,125
2011,Crawley 004D,E01031601,871,650,221,99,31,91
2011,Crawley 004F,E01032835,1161,1015,146,27,13,106
2011,Crawley 004G,E01032836,1192,908,284,127,33,124
2011,Crawley 005A,E01031589,1252,954,298,149,58,91
2011,Crawley 005B,E01031591,1319,1057,262,108,46,108
2011,Crawley 005C,E01031594,984,701,283,135,33,115
2011,Crawley 005D,E01031600,998,748,250,124,27,99
2011,Crawley 005E,E01031603,1096,856,240,101,43,96
2011,Crawley 006A,E01031564,1087,810,277,156,30,91
2011,Crawley 006B,E01031565,1488,1102,386,162,59,165
2011,Crawley 006C,E01031566,1181,856,325,174,43,108
2011,Crawley 006D,E01031567,973,717,256,134,35,87
2011,Crawley 006E,E01031568,1059,877,182,68,18,96
2011,Crawley 007A,E01031596,1290,973,317,103,51,163
2011,Crawley 007B,E01031597,1104,811,293,169,40,84
2011,Crawley 007C,E01031598,1215,872,343,123,39,181
2011,Crawley 007D,E01031599,1315,1037,278,120,42,116
2011,Crawley 007E,E01031608,1357,1077,280,109,41,130
2011,Crawley 008A,E01031578,1352,1143,209,88,49,72
2011,Crawley 008B,E01031580,1650,1394,256,95,46,115
2011,Crawley 008C,E01031581,1251,1071,180,77,36,67
2011,Crawley 008D,E01031592,1523,1196,327,192,45,90
2011,Crawley 009A,E01031560,1071,739,332,194,35,103
2011,Crawley 009B,E01031561,1069,776,293,186,29,78
2011,Crawley 009C,E01031562,916,641,275,143,25,107
2011,Crawley 009D,E01031563,923,705,218,131,41,46
2011,Crawley 009E,E01031579,1182,993,189,56,31,102
2011,Crawley 009F,E01031582,1360,1188,172,50,26,96
2011,Crawley 010A,E01031547,1002,783,219,59,34,126
2011,Crawley 010B,E01031548,1188,920,268,69,35,164
2011,Crawley 010C,E01031549,1080,862,218,43,49,126
2011,Crawley 010D,E01031550,1105,875,230,51,53,126
2011,Crawley 010E,E01031569,1140,840,300,137,26,137
2011,Crawley 011A,E01031595,1191,897,294,128,38,128
2011,Crawley 011B,E01031604,1107,848,259,129,28,102
2011,Crawley 011C,E01031605,1058,790,268,116,32,120
2011,Crawley 011D,E01031606,1020,743,277,140,32,105
2011,Crawley 011E,E01031607,975,720,255,125,35,95
2011,Crawley 012A,E01031546,1087,856,231,53,58,120
2011,Crawley 012B,E01031551,1141,925,216,47,44,125
2011,Crawley 012C,E01031553,1098,852,246,44,57,145
2011,Crawley 012D,E01031554,1312,1043,269,89,43,137
2011,Crawley 012E,E01031555,1119,795,324,99,62,163
2011,Crawley 013A,E01031552,1413,1038,375,138,42,195
2011,Crawley 013B,E01031556,1200,950,250,52,51,147
2011,Crawley 013C,E01031557,1410,1218,192,71,14,107
2011,Crawley 013D,E01031558,1103,717,386,128,45,213
2011,Crawley 013E,E01031559,1079,821,258,75,45,138
2011,Horsham 001A,E01031670,1174,900,274,139,33,102
2011,Horsham 001B,E01031671,1263,928,335,169,32,134
2011,Horsham 001C,E01031673,1167,892,275,127,26,122
2011,Horsham 001D,E01031676,2004,1534,470,261,60,149
2011,Horsham 002A,E01031644,1066,835,231,139,26,66
2011,Horsham 002B,E01031645,1069,837,232,120,48,64
2011,Horsham 002C,E01031646,1137,902,235,101,44,90
2011,Horsham 002D,E01031647,875,659,216,106,29,81
2011,Horsham 002E,E01031649,865,704,161,102,14,45
2011,Horsham 002F,E01031650,960,741,219,118,45,56
2011,Horsham 002G,E01031666,1157,825,332,245,29,58
2011,Horsham 002H,E01031668,1054,754,300,216,26,58
2011,Horsham 003A,E01031620,1173,918,255,122,41,92
2011,Horsham 003B,E01031648,1210,902,308,172,34,102
2011,Horsham 003C,E01031651,1185,922,263,124,39,100
2011,Horsham 003D,E01031658,1500,1080,420,234,48,138
2011,Horsham 003E,E01031689,1114,863,251,129,39,83
2011,Horsham 004A,E01031654,1100,809,291,191,42,58
2011,Horsham 004B,E01031655,1082,900,182,76,28,78
2011,Horsham 004C,E01031667,1133,816,317,200,29,88
2011,Horsham 004D,E01031669,1128,875,253,110,31,112
2011,Horsham 004E,E01031672,1272,1037,235,122,29,84
2011,Horsham 005A,E01031657,1512,983,529,229,68,232
2011,Horsham 005B,E01031659,1104,813,291,154,63,74
2011,Horsham 005C,E01031674,983,649,334,162,93,79
2011,Horsham 005D,E01031675,996,735,261,161,25,75
2011,Horsham 006A,E01031636,1510,1130,380,185,35,160
2011,Horsham 006B,E01031652,1203,874,329,125,56,148
2011,Horsham 006C,E01031653,1240,1004,236,103,39,94
2011,Horsham 006D,E01031656,1246,966,280,108,45,127
2011,Horsham 006E,E01031688,915,675,240,140,19,81
2011,Horsham 006F,E01031691,1158,870,288,198,27,63
2011,Horsham 007A,E01031619,1162,962,200,110,36,54
2011,Horsham 007B,E01031637,1342,999,343,161,42,140
2011,Horsham 007C,E01031638,1336,1089,247,148,34,65
2011,Horsham 007D,E01031690,1046,716,330,218,25,87
2011,Horsham 008A,E01031639,1352,1003,349,207,42,100
2011,Horsham 008B,E01031640,1314,873,441,317,48,76
2011,Horsham 008C,E01031660,895,630,265,183,28,54
2011,Horsham 008D,E01031661,1199,841,358,230,37,91
2011,Horsham 008E,E01031679,1224,727,497,110,333,54
2011,Horsham 009A,E01031677,1059,799,260,145,28,87
2011,Horsham 009B,E01031678,1180,929,251,127,39,85
2011,Horsham 009C,E01031680,1011,817,194,113,32,49
2011,Horsham 009D,E01031681,1055,853,202,88,36,78
2011,Horsham 009E,E01031682,878,764,114,53,27,34
2011,Horsham 009F,E01031683,1109,895,214,112,35,67
2011,Horsham 010A,E01031611,1230,884,346,197,40,109
2011,Horsham 010B,E01031612,1522,1180,342,198,35,109
2011,Horsham 010C,E01031613,1477,1108,369,230,44,95
2011,Horsham 010D,E01031614,1354,1025,329,135,46,148
2011,Horsham 010E,E01031615,1084,775,309,225,27,57
2011,Horsham 011A,E01031632,1169,868,301,160,32,109
2011,Horsham 011B,E01031633,962,698,264,164,26,74
2011,Horsham 011C,E01031634,891,713,178,90,28,60
2011,Horsham 011D,E01031635,1066,836,230,129,32,69
2011,Horsham 012A,E01031621,1215,636,579,480,25,74
2011,Horsham 012B,E01031623,1276,838,438,316,38,84
2011,Horsham 012C,E01031627,1373,951,422,309,42,71
2011,Horsham 012D,E01031664,1176,793,383,255,46,82
2011,Horsham 013A,E01031626,1053,734,319,210,18,91
2011,Horsham 013B,E01031630,1172,764,408,286,27,95
2011,Horsham 013C,E01031631,1047,647,400,268,21,111
2011,Horsham 013D,E01031662,1107,843,264,158,34,72
2011,Horsham 013E,E01031663,1298,931,367,192,41,134
2011,Horsham 013F,E01031665,900,608,292,185,21,86
2011,Horsham 014A,E01031618,1011,733,278,169,32,77
2011,Horsham 014B,E01031641,1071,711,360,238,40,82
2011,Horsham 014C,E01031642,1309,919,390,245,44,101
2011,Horsham 014D,E01031643,1085,745,340,192,29,119
2011,Horsham 014E,E01031687,1222,849,373,154,97,122
2011,Horsham 015A,E01031622,1200,923,277,180,31,66
2011,Horsham 015B,E01031624,1134,847,287,158,31,98
2011,Horsham 015C,E01031625,1068,801,267,165,39,63
2011,Horsham 015D,E01031628,934,661,273,143,33,97
2011,Horsham 015E,E01031629,1067,692,375,284,21,70
2011,Horsham 016A,E01031616,1178,884,294,193,39,62
2011,Horsham 016B,E01031617,1755,1215,540,360,78,102
2011,Horsham 016C,E01031684,1053,766,287,192,32,63
2011,Horsham 016D,E01031685,1151,796,355,252,33,70
2011,Horsham 016E,E01031686,991,637,354,279,25,50
2011,Mid Sussex 001A,E01031731,1388,993,395,162,60,173
2011,Mid Sussex 001B,E01031732,1296,1012,284,122,46,116
2011,Mid Sussex 001C,E01031733,1279,1011,268,133,48,87
2011,Mid Sussex 001D,E01031734,1261,980,281,175,51,55
2011,Mid Sussex 001E,E01031741,1238,992,246,135,24,87
2011,Mid Sussex 001F,E01031742,1278,1021,257,157,21,79
2011,Mid Sussex 001G,E01031743,1258,984,274,127,25,122
2011,Mid Sussex 002A,E01031718,1396,1096,300,175,39,86
2011,Mid Sussex 002B,E01031719,1296,1001,295,188,38,69
2011,Mid Sussex 002C,E01031720,1023,748,275,173,34,68
2011,Mid Sussex 002D,E01031722,1011,690,321,78,167,76
2011,Mid Sussex 003A,E01031695,1088,810,278,166,36,76
2011,Mid Sussex 003B,E01031696,964,702,262,147,41,74
2011,Mid Sussex 003C,E01031729,1384,1010,374,255,42,77
2011,Mid Sussex 003D,E01031730,1389,1199,190,86,34,70
2011,Mid Sussex 003E,E01031735,1309,978,331,215,39,77
2011,Mid Sussex 004A,E01031736,1217,836,381,239,37,105
2011,Mid Sussex 004B,E01031737,1108,854,254,129,36,89
2011,Mid Sussex 004C,E01031738,852,608,244,172,26,46
2011,Mid Sussex 004D,E01031739,1319,1006,313,207,39,67
2011,Mid Sussex 004E,E01031740,962,722,240,140,35,65
2011,Mid Sussex 005A,E01031721,1056,688,368,279,23,66
2011,Mid Sussex 005B,E01031723,1086,751,335,204,34,97
2011,Mid Sussex 005C,E01031724,1063,870,193,114,35,44
2011,Mid Sussex 005D,E01031725,1090,794,296,207,27,62
2011,Mid Sussex 006A,E01031694,1392,930,462,162,198,102
2011,Mid Sussex 006B,E01031764,1007,709,298,178,32,88
2011,Mid Sussex 006C,E01031765,1158,826,332,154,48,130
2011,Mid Sussex 006D,E01031766,1619,1167,452,253,60,139
2011,Mid Sussex 007A,E01031692,1535,1221,314,145,39,130
2011,Mid Sussex 007B,E01031693,1282,944,338,174,36,128
2011,Mid Sussex 007C,E01031697,873,649,224,118,24,82
2011,Mid Sussex 007D,E01031727,1224,844,380,213,48,119
2011,Mid Sussex 008A,E01031758,1070,824,246,147,33,66
2011,Mid Sussex 008B,E01031760,1270,958,312,180,44,88
2011,Mid Sussex 008C,E01031772,1114,796,318,200,32,86
2011,Mid Sussex 008D,E01031773,1332,893,439,278,50,111
2011,Mid Sussex 008E,E01031774,1108,748,360,245,36,79
2011,Mid Sussex 008F,E01031775,1150,748,402,289,40,73
2011,Mid Sussex 009A,E01031751,1972,1632,340,171,58,111
2011,Mid Sussex 009B,E01031759,1210,909,301,182,42,77
2011,Mid Sussex 009C,E01031761,1533,1242,291,157,37,97
2011,Mid Sussex 009E,E01032837,845,623,222,110,29,83
2011,Mid Sussex 009F,E01032838,984,849,135,41,22,72
2011,Mid Sussex 009G,E01032839,872,659,213,140,20,53
2011,Mid Sussex 010A,E01031752,976,706,270,89,26,155
2011,Mid Sussex 010B,E01031753,963,732,231,122,32,77
2011,Mid Sussex 010C,E01031754,1149,907,242,125,43,74
2011,Mid Sussex 010D,E01031755,939,743,196,104,22,70
2011,Mid Sussex 010E,E01031757,1112,852,260,142,25,93
2011,Mid Sussex 011A,E01031726,1041,779,262,134,49,79
2011,Mid Sussex 011B,E01031728,1399,956,443,259,71,113
2011,Mid Sussex 011C,E01031749,1071,822,249,160,26,63
2011,Mid Sussex 011D,E01031750,1083,813,270,128,34,108
2011,Mid Sussex 011E,E01031756,1374,1013,361,204,41,116
2011,Mid Sussex 011F,E01031763,1242,838,404,263,43,98
2011,Mid Sussex 012A,E01031699,1258,1063,195,84,43,68
2011,Mid Sussex 012B,E01031700,1219,989,230,106,50,74
2011,Mid Sussex 012C,E01031701,1335,1055,280,141,40,99
2011,Mid Sussex 012D,E01031714,1034,793,241,132,37,72
2011,Mid Sussex 013A,E01031704,1253,969,284,188,28,68
2011,Mid Sussex 013B,E01031706,1243,904,339,211,42,86
2011,Mid Sussex 013C,E01031711,1279,1011,268,151,40,77
2011,Mid Sussex 013D,E01031712,1049,818,231,99,31,101
2011,Mid Sussex 013E,E01031713,1035,717,318,218,31,69
2011,Mid Sussex 014A,E01031705,1166,920,246,105,43,98
2011,Mid Sussex 014B,E01031707,1156,819,337,202,32,103
2011,Mid Sussex 014C,E01031708,1247,997,250,109,35,106
2011,Mid Sussex 014D,E01031709,1177,846,331,165,43,123
2011,Mid Sussex 014E,E01031716,842,627,215,104,19,92
2011,Mid Sussex 014F,E01031717,1015,823,192,89,25,78
2011,Mid Sussex 015A,E01031702,1083,763,320,205,50,65
2011,Mid Sussex 015B,E01031703,1187,761,426,268,80,78
2011,Mid Sussex 015C,E01031710,1003,760,243,174,26,43
2011,Mid Sussex 015D,E01031715,1120,940,180,87,29,64
2011,Mid Sussex 016A,E01031698,1197,911,286,137,69,80
2011,Mid Sussex 016B,E01031767,1080,715,365,152,86,127
2011,Mid Sussex 016C,E01031769,1223,952,271,137,28,106
2011,Mid Sussex 016D,E01031770,1199,914,285,161,38,86
2011,Mid Sussex 016E,E01031771,1112,847,265,104,45,116
2011,Mid Sussex 017A,E01031744,1050,746,304,216,35,53
2011,Mid Sussex 017B,E01031745,1203,858,345,237,31,77
2011,Mid Sussex 017C,E01031746,1154,884,270,130,39,101
2011,Mid Sussex 017D,E01031747,948,648,300,228,25,47
2011,Mid Sussex 017E,E01031748,874,601,273,178,39,56
2011,Mid Sussex 017F,E01031768,1001,686,315,233,32,50
2011,Worthing 001A,E01031793,952,658,294,218,16,60
2011,Worthing 001B,E01031820,1162,657,505,406,34,65
2011,Worthing 001C,E01031821,1164,792,372,253,25,94
2011,Worthing 001D,E01031828,952,629,323,248,24,51
2011,Worthing 001E,E01031829,1113,724,389,266,39,84
2011,Worthing 002A,E01031822,1100,786,314,217,40,57
2011,Worthing 002B,E01031825,1154,747,407,314,21,72
2011,Worthing 002C,E01031826,994,752,242,136,19,87
2011,Worthing 002D,E01031827,1022,742,280,158,30,92
2011,Worthing 002E,E01031839,1233,912,321,169,38,114
2011,Worthing 003A,E01031792,959,667,292,169,30,93
2011,Worthing 003B,E01031794,917,556,361,258,25,78
2011,Worthing 003C,E01031795,1079,803,276,99,33,144
2011,Worthing 003D,E01031818,1538,1132,406,172,64,170
2011,Worthing 003E,E01031830,1106,722,384,185,39,160
2011,Worthing 004A,E01031778,1108,826,282,158,26,98
2011,Worthing 004B,E01031797,933,715,218,143,25,50
2011,Worthing 004C,E01031800,1049,813,236,153,30,53
2011,Worthing 004D,E01031823,1010,752,258,164,41,53
2011,Worthing 004E,E01031824,981,717,264,171,38,55
2011,Worthing 005A,E01031776,1144,945,199,104,28,67
2011,Worthing 005B,E01031777,1209,907,302,155,47,100
2011,Worthing 005C,E01031780,1116,873,243,120,46,77
2011,Worthing 005D,E01031781,1168,906,262,131,37,94
2011,Worthing 005E,E01031798,1165,905,260,101,44,115
2011,Worthing 006A,E01031783,1025,690,335,134,39,162
2011,Worthing 006B,E01031785,1053,766,287,145,30,112
2011,Worthing 006C,E01031786,1103,816,287,134,29,124
2011,Worthing 006D,E01031817,1209,950,259,97,44,118
2011,Worthing 006E,E01031819,898,621,277,71,39,167
2011,Worthing 007A,E01031782,1160,738,422,299,27,96
2011,Worthing 007B,E01031784,1291,920,371,214,39,118
2011,Worthing 007C,E01031836,1203,851,352,155,37,160
2011,Worthing 007D,E01031838,1129,859,270,151,34,85
2011,Worthing 007E,E01031840,1239,916,323,213,33,77
2011,Worthing 008A,E01031791,1500,1088,412,146,59,207
2011,Worthing 008B,E01031796,1140,877,263,100,38,125
2011,Worthing 008C,E01031799,1104,799,305,118,66,121
2011,Worthing 008D,E01031801,1279,994,285,102,50,133
2011,Worthing 008E,E01031837,1412,1145,267,112,47,108
2011,Worthing 009A,E01031779,898,594,304,93,40,171
2011,Worthing 009B,E01031831,1158,893,265,128,22,115
2011,Worthing 009C,E01031832,1202,797,405,270,18,117
2011,Worthing 009D,E01031833,1182,866,316,114,40,162
2011,Worthing 009E,E01031834,1165,845,320,142,40,138
2011,Worthing 010A,E01031790,1303,878,425,188,32,205
2011,Worthing 010B,E01031807,1069,715,354,218,24,112
2011,Worthing 010C,E01031809,1158,874,284,161,25,98
2011,Worthing 010D,E01031810,1175,925,250,112,36,102
2011,Worthing 010E,E01031811,1007,718,289,102,23,164
2011,Worthing 011A,E01031787,1435,1121,314,125,38,151
2011,Worthing 011B,E01031788,1509,1160,349,138,47,164
2011,Worthing 011C,E01031789,1512,1121,391,163,51,177
2011,Worthing 011D,E01031808,1124,856,268,91,27,150
2011,Worthing 011E,E01031835,1456,1112,344,143,48,153
2011,Worthing 012A,E01031812,1049,753,296,215,23,58
2011,Worthing 012B,E01031813,1252,940,312,176,39,97
2011,Worthing 012C,E01031814,1123,762,361,259,34,68
2011,Worthing 012D,E01031815,1058,727,331,242,29,60
2011,Worthing 012E,E01031816,1122,875,247,119,44,84
2011,Worthing 013A,E01031802,1008,571,437,364,12,61
2011,Worthing 013B,E01031803,1041,687,354,262,34,58
2011,Worthing 013C,E01031804,1095,701,394,302,25,67
2011,Worthing 013D,E01031805,1023,646,377,300,25,52
2011,Worthing 013E,E01031806,1141,825,316,140,51,125
2011,Bath and North East Somerset 001A,E01014399,1200,859,341,199,45,97
2011,Bath and North East Somerset 001B,E01014400,1397,1028,369,236,41,92
2011,Bath and North East Somerset 001C,E01014401,1145,793,352,176,40,136
2011,Bath and North East Somerset 002A,E01014402,1216,884,332,211,27,94
2011,Bath and North East Somerset 002B,E01014403,1092,765,327,214,28,85
2011,Bath and North East Somerset 002C,E01014404,1117,772,345,170,38,137
2011,Bath and North East Somerset 003A,E01014395,904,593,311,252,18,41
2011,Bath and North East Somerset 003B,E01014396,963,690,273,158,44,71
2011,Bath and North East Somerset 003C,E01014397,906,655,251,172,36,43
2011,Bath and North East Somerset 003D,E01014398,1020,720,300,198,44,58
2011,Bath and North East Somerset 004A,E01014409,1130,800,330,174,52,104
2011,Bath and North East Somerset 004B,E01014410,1244,933,311,194,59,58
2011,Bath and North East Somerset 004C,E01014411,1525,1164,361,180,79,102
2011,Bath and North East Somerset 005A,E01014477,1032,703,329,217,44,68
2011,Bath and North East Somerset 005B,E01014478,816,588,228,99,49,80
2011,Bath and North East Somerset 005C,E01014479,932,633,299,175,51,73
2011,Bath and North East Somerset 005D,E01014480,873,645,228,114,37,77
2011,Bath and North East Somerset 006A,E01014465,1141,867,274,120,76,78
2011,Bath and North East Somerset 006B,E01014466,975,703,272,69,90,113
2011,Bath and North East Somerset 006C,E01014467,1321,978,343,135,124,84
2011,Bath and North East Somerset 006D,E01014468,1269,906,363,97,201,65
2011,Bath and North East Somerset 007A,E01014370,1442,878,564,135,276,153
2011,Bath and North East Somerset 007B,E01014371,1510,1040,470,146,216,108
2011,Bath and North East Somerset 007C,E01014372,1776,1249,527,155,224,148
2011,Bath and North East Somerset 007D,E01014412,1121,835,286,123,101,62
2011,Bath and North East Somerset 007E,E01014413,1071,648,423,204,156,63
2011,Bath and North East Somerset 007F,E01014414,1305,882,423,95,182,146
2011,Bath and North East Somerset 008A,E01014427,1052,752,300,92,155,53
2011,Bath and North East Somerset 008B,E01014428,1002,737,265,121,78,66
2011,Bath and North East Somerset 008C,E01014429,1112,862,250,109,75,66
2011,Bath and North East Somerset 008D,E01014430,1027,717,310,206,45,59
2011,Bath and North East Somerset 009A,E01014405,1572,1125,447,156,197,94
2011,Bath and North East Somerset 009C,E01014407,1076,609,467,73,271,123
2011,Bath and North East Somerset 009E,E01033080,1940,1293,647,126,350,171
2011,Bath and North East Somerset 010A,E01014373,1106,860,246,124,40,82
2011,Bath and North East Somerset 010B,E01014374,948,648,300,207,26,67
2011,Bath and North East Somerset 010C,E01014375,935,674,261,159,38,64
2011,Bath and North East Somerset 010D,E01014376,1058,712,346,238,46,62
2011,Bath and North East Somerset 010E,E01014377,941,596,345,232,54,59
2011,Bath and North East Somerset 010G,E01033078,1337,874,463,217,162,84
2011,Bath and North East Somerset 010H,E01033079,842,612,230,126,34,70
2011,Bath and North East Somerset 011A,E01014461,855,606,249,85,61,103
2011,Bath and North East Somerset 011B,E01014462,1024,704,320,93,66,161
2011,Bath and North East Somerset 011C,E01014463,1001,637,364,147,40,177
2011,Bath and North East Somerset 011D,E01014464,954,626,328,91,62,175
2011,Bath and North East Somerset 012A,E01014380,2943,900,2043,186,1797,60
2011,Bath and North East Somerset 012B,E01014381,1071,615,456,164,231,61
2011,Bath and North East Somerset 012C,E01014481,1275,751,524,76,407,41
2011,Bath and North East Somerset 012D,E01014482,923,562,361,178,127,56
2011,Bath and North East Somerset 012E,E01014483,1194,738,456,121,259,76
2011,Bath and North East Somerset 012F,E01014484,1366,761,605,96,456,53
2011,Bath and North East Somerset 013A,E01014473,1359,786,573,100,408,65
2011,Bath and North East Somerset 013B,E01014474,982,632,350,106,183,61
2011,Bath and North East Somerset 013C,E01014475,1944,1080,864,93,709,62
2011,Bath and North East Somerset 013D,E01014476,1195,774,421,91,294,36
2011,Bath and North East Somerset 014A,E01014435,1394,688,706,89,571,46
2011,Bath and North East Somerset 014B,E01014436,1256,735,521,118,352,51
2011,Bath and North East Somerset 014C,E01014437,1020,717,303,105,84,114
2011,Bath and North East Somerset 014D,E01014438,987,663,324,86,137,101
2011,Bath and North East Somerset 015A,E01014455,944,680,264,121,45,98
2011,Bath and North East Somerset 015B,E01014456,1114,781,333,161,95,77
2011,Bath and North East Somerset 015C,E01014457,1050,749,301,199,56,46
2011,Bath and North East Somerset 015D,E01014458,937,603,334,94,76,164
2011,Bath and North East Somerset 016A,E01014391,1072,798,274,180,31,63
2011,Bath and North East Somerset 016B,E01014392,779,542,237,148,38,51
2011,Bath and North East Somerset 016C,E01014452,1003,681,322,227,30,65
2011,Bath and North East Somerset 016D,E01014453,875,601,274,180,42,52
2011,Bath and North East Somerset 016E,E01014454,996,711,285,217,28,40
2011,Bath and North East Somerset 016F,E01014459,1032,697,335,178,31,126
2011,Bath and North East Somerset 016G,E01014460,874,605,269,218,17,34
2011,Bath and North East Somerset 017A,E01014415,1498,1089,409,153,176,80
2011,Bath and North East Somerset 017B,E01014416,1176,821,355,204,79,72
2011,Bath and North East Somerset 017C,E01014417,1306,888,418,235,85,98
2011,Bath and North East Somerset 018A,E01014387,855,572,283,118,99,66
2011,Bath and North East Somerset 018B,E01014388,886,602,284,161,67,56
2011,Bath and North East Somerset 018C,E01014389,953,615,338,163,113,62
2011,Bath and North East Somerset 018D,E01014390,1070,714,356,114,57,185
2011,Bath and North East Somerset 019A,E01014431,929,665,264,117,76,71
2011,Bath and North East Somerset 019B,E01014432,940,642,298,121,84,93
2011,Bath and North East Somerset 019C,E01014433,952,733,219,59,56,104
2011,Bath and North East Somerset 019D,E01014434,1396,1048,348,187,79,82
2011,Bath and North East Somerset 020A,E01014385,995,715,280,148,48,84
2011,Bath and North East Somerset 020B,E01014386,850,624,226,137,33,56
2011,Bath and North East Somerset 020C,E01014419,885,656,229,125,36,68
2011,Bath and North East Somerset 020D,E01014446,852,617,235,141,42,52
2011,Bath and North East Somerset 020E,E01014447,982,723,259,161,33,65
2011,Bath and North East Somerset 021A,E01014382,1728,1203,525,347,65,113
2011,Bath and North East Somerset 021B,E01014383,757,528,229,163,29,37
2011,Bath and North East Somerset 021C,E01014384,958,679,279,154,47,78
2011,Bath and North East Somerset 021D,E01014418,1033,736,297,179,36,82
2011,Bath and North East Somerset 022A,E01014379,1900,1237,663,247,297,119
2011,Bath and North East Somerset 022B,E01014442,1268,971,297,167,43,87
2011,Bath and North East Somerset 022C,E01014443,1175,881,294,179,50,65
2011,Bath and North East Somerset 022D,E01014444,1099,878,221,111,29,81
2011,Bath and North East Somerset 022E,E01014445,1142,825,317,143,40,134
2011,Bath and North East Somerset 023A,E01014393,950,706,244,156,29,59
2011,Bath and North East Somerset 023B,E01014394,1224,918,306,199,28,79
2011,Bath and North East Somerset 023C,E01014439,1188,816,372,214,26,132
2011,Bath and North East Somerset 023D,E01014440,1428,1105,323,164,48,111
2011,Bath and North East Somerset 023E,E01014441,1189,835,354,242,39,73
2011,Bath and North East Somerset 024A,E01014448,1116,781,335,171,32,132
2011,Bath and North East Somerset 024B,E01014449,1039,846,193,83,43,67
2011,Bath and North East Somerset 024C,E01014450,934,634,300,132,47,121
2011,Bath and North East Somerset 024D,E01014451,952,723,229,124,37,68
2011,Bath and North East Somerset 025A,E01014420,1156,890,266,137,33,96
2011,Bath and North East Somerset 025B,E01014421,1030,797,233,135,43,55
2011,Bath and North East Somerset 025C,E01014422,1076,763,313,218,38,57
2011,Bath and North East Somerset 025D,E01014423,997,745,252,130,34,88
2011,Bath and North East Somerset 026A,E01014469,852,622,230,116,29,85
2011,Bath and North East Somerset 026B,E01014470,1192,975,217,124,31,62
2011,Bath and North East Somerset 026C,E01014471,1171,909,262,132,33,97
2011,Bath and North East Somerset 026D,E01014472,1013,781,232,131,38,63
2011,Bath and North East Somerset 027A,E01014424,1257,880,377,259,35,83
2011,Bath and North East Somerset 027B,E01014425,1433,984,449,292,47,110
2011,Bath and North East Somerset 027C,E01014426,958,675,283,151,38,94
2011,Bournemouth 001A,E01015301,1041,703,338,203,27,108
2011,Bournemouth 001B,E01015303,1081,690,391,213,41,137
2011,Bournemouth 001C,E01015305,1050,725,325,138,43,144
2011,Bournemouth 001D,E01015306,1170,742,428,204,47,177
2011,Bournemouth 002A,E01015302,1331,877,454,271,38,145
2011,Bournemouth 002B,E01015304,1150,769,381,172,32,177
2011,Bournemouth 002C,E01015308,1252,898,354,150,37,167
2011,Bournemouth 002D,E01015311,949,543,406,333,14,59
2011,Bournemouth 003A,E01015332,1074,720,354,245,41,68
2011,Bournemouth 003B,E01015333,1108,812,296,202,33,61
2011,Bournemouth 003C,E01015334,1062,706,356,205,38,113
2011,Bournemouth 003D,E01015335,1211,883,328,192,39,97
2011,Bournemouth 003E,E01015337,1253,923,330,153,63,114
2011,Bournemouth 004A,E01015343,1050,731,319,147,44,128
2011,Bournemouth 004B,E01015349,1049,760,289,148,31,110
2011,Bournemouth 004C,E01015351,1082,873,209,104,32,73
2011,Bournemouth 004D,E01015352,1062,844,218,96,27,95
2011,Bournemouth 004E,E01015353,808,568,240,124,24,92
2011,Bournemouth 004F,E01015354,1220,939,281,137,42,102
2011,Bournemouth 005A,E01015307,975,610,365,120,46,199
2011,Bournemouth 005B,E01015309,1013,653,360,103,45,212
2011,Bournemouth 005C,E01015312,825,561,264,99,36,129
2011,Bournemouth 005D,E01015313,959,613,346,106,61,179
2011,Bournemouth 005E,E01015359,1195,789,406,184,53,169
2011,Bournemouth 006A,E01015320,1260,940,320,167,79,74
2011,Bournemouth 006B,E01015323,1135,864,271,128,63,80
2011,Bournemouth 006C,E01015324,1142,890,252,108,61,83
2011,Bournemouth 006D,E01015325,1212,946,266,135,43,88
2011,Bournemouth 006E,E01015350,977,719,258,166,28,64
2011,Bournemouth 007A,E01015310,1130,758,372,149,62,161
2011,Bournemouth 007B,E01015336,1216,857,359,195,66,98
2011,Bournemouth 007C,E01015355,1232,871,361,170,76,115
2011,Bournemouth 007D,E01015357,1147,735,412,179,76,157
2011,Bournemouth 007E,E01015358,1427,941,486,192,174,120
2011,Bournemouth 008A,E01015338,1208,713,495,198,53,244
2011,Bournemouth 008B,E01015339,1127,805,322,142,39,141
2011,Bournemouth 008C,E01015340,1107,747,360,256,30,74
2011,Bournemouth 008D,E01015341,1013,678,335,126,43,166
2011,Bournemouth 009A,E01015321,1403,923,480,127,213,140
2011,Bournemouth 009B,E01015356,1353,895,458,145,225,88
2011,Bournemouth 009C,E01015374,1963,1149,814,78,568,168
2011,Bournemouth 009D,E01015375,1605,876,729,103,527,99
2011,Bournemouth 009E,E01015377,1294,891,403,83,207,113
2011,Bournemouth 010A,E01015322,1216,912,304,151,49,104
2011,Bournemouth 010B,E01015330,1281,941,340,156,68,116
2011,Bournemouth 010C,E01015342,1147,840,307,188,39,80
2011,Bournemouth 010D,E01015373,1328,960,368,69,202,97
2011,Bournemouth 010E,E01015378,1367,986,381,83,212,86
2011,Bournemouth 011A,E01015314,1061,783,278,179,33,66
2011,Bournemouth 011B,E01015315,1430,1010,420,249,70,101
2011,Bournemouth 011C,E01015318,1217,921,296,136,59,101
2011,Bournemouth 011D,E01015319,1046,816,230,107,52,71
2011,Bournemouth 012A,E01015344,1296,838,458,249,106,103
2011,Bournemouth 012B,E01015346,1317,840,477,117,225,135
2011,Bournemouth 012C,E01015348,1400,865,535,254,166,115
2011,Bournemouth 012D,E01015360,1436,859,577,115,371,91
2011,Bournemouth 013A,E01015326,1545,1132,413,90,192,131
2011,Bournemouth 013B,E01015331,1831,1381,450,100,190,160
2011,Bournemouth 013C,E01015345,1524,1050,474,97,257,120
2011,Bournemouth 013D,E01015376,1450,954,496,78,342,76
2011,Bournemouth 014A,E01015316,1150,820,330,213,32,85
2011,Bournemouth 014B,E01015317,1131,816,315,165,45,105
2011,Bournemouth 014C,E01015361,999,771,228,108,35,85
2011,Bournemouth 014D,E01015362,876,624,252,54,50,148
2011,Bournemouth 014E,E01015363,1218,939,279,103,49,127
2011,Bournemouth 015A,E01015292,1322,940,382,117,108,157
2011,Bournemouth 015B,E01015293,1144,843,301,96,67,138
2011,Bournemouth 015C,E01015294,1492,1109,383,88,98,197
2011,Bournemouth 015D,E01015327,1528,1093,435,83,199,153
2011,Bournemouth 015E,E01015329,1335,1022,313,104,122,87
2011,Bournemouth 016A,E01015272,1236,802,434,234,116,84
2011,Bournemouth 016B,E01015273,1551,1103,448,105,150,193
2011,Bournemouth 016C,E01015275,1415,936,479,139,192,148
2011,Bournemouth 016D,E01015276,1245,895,350,99,70,181
2011,Bournemouth 016E,E01015277,1493,1082,411,122,119,170
2011,Bournemouth 017A,E01015283,1615,1214,401,80,212,109
2011,Bournemouth 017C,E01015286,1421,992,429,242,70,117
2011,Bournemouth 017D,E01015287,1949,1092,857,144,623,90
2011,Bournemouth 017E,E01015328,1426,1049,377,151,79,147
2011,Bournemouth 017F,E01033242,819,613,206,36,69,101
2011,Bournemouth 017G,E01033285,930,728,202,64,55,83
2011,Bournemouth 018A,E01015274,1311,979,332,142,72,118
2011,Bournemouth 018B,E01015297,937,650,287,181,30,76
2011,Bournemouth 018C,E01015364,1127,787,340,208,44,88
2011,Bournemouth 018D,E01015365,1322,960,362,125,77,160
2011,Bournemouth 018E,E01015366,1221,815,406,206,71,129
2011,Bournemouth 019B,E01015279,1499,1087,412,95,96,221
2011,Bournemouth 019C,E01015280,1640,1116,524,101,98,325
2011,Bournemouth 019D,E01015281,1378,903,475,108,84,283
2011,Bournemouth 019E,E01015282,1719,1159,560,106,72,382
2011,Bournemouth 019F,E01033241,912,689,223,91,36,96
2011,Bournemouth 019G,E01033283,915,683,232,119,47,66
2011,Bournemouth 020A,E01015295,1022,647,375,296,25,54
2011,Bournemouth 020B,E01015296,1242,851,391,256,18,117
2011,Bournemouth 020C,E01015298,1010,529,481,397,19,65
2011,Bournemouth 020D,E01015299,1178,870,308,206,29,73
2011,Bournemouth 020E,E01015300,1090,777,313,211,26,76
2011,Bournemouth 021A,E01015285,2341,1450,891,142,606,143
2011,Bournemouth 021B,E01015288,1521,1089,432,94,151,187
2011,Bournemouth 021C,E01015289,1543,1102,441,162,132,147
2011,Bournemouth 021D,E01015290,1462,1007,455,132,134,189
2011,Bournemouth 021E,E01015291,1410,953,457,282,59,116
2011,Bournemouth 023A,E01015371,1315,998,317,96,61,160
2011,Bournemouth 023B,E01015372,1184,890,294,188,28,78
2011,Bournemouth 023C,E01033286,863,646,217,117,50,50
2011,Bournemouth 023D,E01033288,804,620,184,130,20,34
2011,Bournemouth 024A,E01015367,1781,1376,405,106,151,148
2011,Bournemouth 024B,E01015368,1177,797,380,283,33,64
2011,Bournemouth 024C,E01015369,1223,829,394,249,33,112
2011,Bournemouth 024D,E01015370,1319,1057,262,147,36,79
2011,Bristol 001A,E01014601,1140,763,377,181,37,159
2011,Bristol 001B,E01014602,1280,857,423,148,49,226
2011,Bristol 001C,E01014603,1585,1183,402,171,68,163
2011,Bristol 001E,E01014605,1109,681,428,151,32,245
2011,Bristol 001G,E01032516,1390,993,397,220,54,123
2011,Bristol 001H,E01032517,1076,749,327,127,39,161
2011,Bristol 002A,E01014688,1160,751,409,125,57,227
2011,Bristol 002B,E01014689,1028,607,421,112,48,261
2011,Bristol 002C,E01014690,1395,1019,376,145,50,181
2011,Bristol 002D,E01014691,1267,849,418,192,61,165
2011,Bristol 002E,E01014692,1147,814,333,105,47,181
2011,Bristol 002F,E01014693,1080,803,277,187,28,62
2011,Bristol 002G,E01014694,1201,807,394,155,64,175
2011,Bristol 003A,E01014497,1098,748,350,145,36,169
2011,Bristol 003B,E01014498,1063,759,304,104,21,179
2011,Bristol 003C,E01014638,1087,686,401,129,57,215
2011,Bristol 003D,E01014639,989,640,349,84,41,224
2011,Bristol 003E,E01014640,1024,688,336,124,51,161
2011,Bristol 004A,E01014631,867,622,245,147,35,63
2011,Bristol 004B,E01014632,1143,827,316,122,90,104
2011,Bristol 004C,E01014633,1127,834,293,143,47,103
2011,Bristol 004D,E01014636,1017,643,374,135,53,186
2011,Bristol 005A,E01014630,1624,1156,468,113,134,221
2011,Bristol 005B,E01014634,1429,1074,355,105,192,58
2011,Bristol 005C,E01014659,1476,1002,474,97,138,239
2011,Bristol 005D,E01014661,1176,792,384,123,77,184
2011,Bristol 006A,E01014616,971,706,265,162,36,67
2011,Bristol 006B,E01014719,1007,769,238,136,34,68
2011,Bristol 006C,E01014720,1106,787,319,181,34,104
2011,Bristol 006D,E01014721,1035,749,286,171,25,90
2011,Bristol 007A,E01014641,1050,692,358,204,59,95
2011,Bristol 007B,E01014642,1020,737,283,140,50,93
2011,Bristol 007C,E01014643,962,661,301,123,56,122
2011,Bristol 007D,E01014644,1090,789,301,126,47,128
2011,Bristol 008A,E01014492,1074,717,357,179,26,152
2011,Bristol 008B,E01014493,1079,804,275,106,43,126
2011,Bristol 008C,E01014494,1119,827,292,169,41,82
2011,Bristol 008D,E01014495,1194,871,323,188,21,114
2011,Bristol 008E,E01014496,1206,957,249,103,32,114
2011,Bristol 008F,E01014499,1145,858,287,112,38,137
2011,Bristol 009A,E01014715,1113,826,287,178,48,61
2011,Bristol 009B,E01014716,980,717,263,188,36,39
2011,Bristol 009C,E01014717,948,610,338,153,133,52
2011,Bristol 009D,E01014718,1012,708,304,197,48,59
2011,Bristol 010A,E01014510,1513,1158,355,98,176,81
2011,Bristol 010B,E01014635,1488,1140,348,128,122,98
2011,Bristol 010C,E01014637,1139,879,260,75,142,43
2011,Bristol 010D,E01014662,1198,897,301,95,86,120
2011,Bristol 011A,E01014615,1011,721,290,188,51,51
2011,Bristol 011B,E01014617,975,739,236,157,37,42
2011,Bristol 011C,E01014618,1007,704,303,198,47,58
2011,Bristol 011D,E01014620,964,660,304,181,51,72
2011,Bristol 012A,E01014571,1229,845,384,110,149,125
2011,Bristol 012B,E01014577,1157,811,346,177,78,91
2011,Bristol 012C,E01014586,1048,711,337,190,44,103
2011,Bristol 012D,E01014587,947,622,325,147,55,123
2011,Bristol 013A,E01014588,1735,977,758,169,384,205
2011,Bristol 013B,E01014589,941,584,357,91,59,207
2011,Bristol 013C,E01014590,1338,858,480,112,195,173
2011,Bristol 013D,E01014591,1272,901,371,196,70,105
2011,Bristol 013E,E01014592,1202,864,338,143,93,102
2011,Bristol 014A,E01014660,1114,735,379,132,69,178
2011,Bristol 014B,E01014663,1055,707,348,132,48,168
2011,Bristol 014C,E01014664,1188,808,380,125,73,182
2011,Bristol 014D,E01014665,1382,995,387,145,83,159
2011,Bristol 015A,E01014709,850,589,261,174,38,49
2011,Bristol 015B,E01014710,1073,623,450,110,282,58
2011,Bristol 015C,E01014711,861,574,287,200,36,51
2011,Bristol 015D,E01014712,838,580,258,131,48,79
2011,Bristol 015E,E01014713,930,647,283,192,41,50
2011,Bristol 015F,E01014714,2513,945,1568,173,1324,71
2011,Bristol 016A,E01014507,1318,1041,277,70,156,51
2011,Bristol 016B,E01014508,1421,908,513,64,133,316
2011,Bristol 016C,E01014509,1698,1413,285,52,158,75
2011,Bristol 016D,E01014511,1063,836,227,58,104,65
2011,Bristol 016E,E01014512,1136,866,270,99,83,88
2011,Bristol 016F,E01014513,1140,892,248,124,59,65
2011,Bristol 016G,E01014514,1539,1248,291,88,121,82
2011,Bristol 017A,E01014619,1121,819,302,132,99,71
2011,Bristol 017B,E01014621,1050,797,253,89,82,82
2011,Bristol 017C,E01014666,1270,959,311,140,90,81
2011,Bristol 017D,E01014667,1204,963,241,78,106,57
2011,Bristol 017E,E01014672,1600,1200,400,131,186,83
2011,Bristol 018A,E01014624,1203,829,374,146,52,176
2011,Bristol 018D,E01014629,982,649,333,92,69,172
2011,Bristol 018E,E01032518,1224,782,442,127,69,246
2011,Bristol 018F,E01032519,840,621,219,96,47,76
2011,Bristol 019A,E01014572,1442,1074,368,80,98,190
2011,Bristol 019B,E01014573,1435,1029,406,139,132,135
2011,Bristol 019C,E01014575,1146,774,372,106,77,189
2011,Bristol 019D,E01014576,1415,1072,343,155,52,136
2011,Bristol 020A,E01014487,1713,1278,435,84,264,87
2011,Bristol 020B,E01014491,1540,1218,322,81,151,90
2011,Bristol 020C,E01014668,1246,976,270,81,135,54
2011,Bristol 020D,E01014669,1217,913,304,62,178,64
2011,Bristol 020E,E01014670,1220,913,307,74,170,63
2011,Bristol 020F,E01014671,1382,976,406,58,272,76
2011,Bristol 021A,E01014622,1108,811,297,106,52,139
2011,Bristol 021B,E01014623,1172,883,289,110,46,133
2011,Bristol 021C,E01014626,1416,976,440,158,74,208
2011,Bristol 021D,E01014627,1586,1220,366,144,52,170
2011,Bristol 022A,E01014557,1402,869,533,80,403,50
2011,Bristol 022B,E01014558,1718,999,719,38,597,84
2011,Bristol 022C,E01014559,1680,1128,552,109,379,64
2011,Bristol 022D,E01014560,1484,1034,450,94,293,63
2011,Bristol 022E,E01014562,1678,935,743,39,649,55
2011,Bristol 023A,E01014485,1393,1092,301,97,71,133
2011,Bristol 023B,E01014486,1777,1300,477,99,120,258
2011,Bristol 023C,E01014488,1614,1264,350,84,113,153
2011,Bristol 023D,E01014489,2032,1540,492,59,237,196
2011,Bristol 023F,E01033347,945,750,195,23,70,102
2011,Bristol 023G,E01033348,842,614,228,17,87,124
2011,Bristol 023H,E01033366,916,612,304,44,91,169
2011,Bristol 025A,E01014539,1596,969,627,98,437,92
2011,Bristol 025C,E01014561,1482,1040,442,86,286,70
2011,Bristol 025D,E01014563,1647,1126,521,38,406,77
2011,Bristol 025E,E01033342,1772,830,942,22,818,102
2011,Bristol 025F,E01033367,1094,783,311,31,113,167
2011,Bristol 026A,E01014551,1644,1026,618,38,527,53
2011,Bristol 026B,E01014552,1652,1070,582,71,445,66
2011,Bristol 026C,E01014553,1536,1084,452,63,336,53
2011,Bristol 026D,E01014554,1536,1106,430,47,319,64
2011,Bristol 026E,E01014556,1403,1093,310,91,175,44
2011,Bristol 027A,E01014673,1297,1013,284,122,30,132
2011,Bristol 027B,E01014674,1164,886,278,124,37,117
2011,Bristol 027C,E01014675,1120,857,263,115,31,117
2011,Bristol 027D,E01014676,1092,815,277,155,29,93
2011,Bristol 028A,E01014682,1116,816,300,153,32,115
2011,Bristol 028B,E01014683,1245,922,323,145,37,141
2011,Bristol 028C,E01014685,1083,734,349,102,64,183
2011,Bristol 028D,E01014686,1172,845,327,139,40,148
2011,Bristol 028E,E01014687,1109,838,271,113,33,125
2011,Bristol 029A,E01014565,1222,882,340,110,61,169
2011,Bristol 029B,E01014566,1297,1027,270,91,35,144
2011,Bristol 029C,E01014567,1480,1193,287,87,52,148
2011,Bristol 029D,E01014681,1595,1218,377,149,57,171
2011,Bristol 029E,E01014684,1340,1055,285,91,45,149
2011,Bristol 030A,E01014544,1156,698,458,100,313,45
2011,Bristol 030B,E01014545,1357,985,372,128,191,53
2011,Bristol 030C,E01014546,1324,952,372,75,270,27
2011,Bristol 030D,E01014547,1435,1110,325,125,152,48
2011,Bristol 032A,E01014538,1833,832,1001,34,934,33
2011,Bristol 032B,E01014540,2393,1457,936,83,681,172
2011,Bristol 032C,E01014542,2182,1195,987,50,869,68
2011,Bristol 032E,E01033344,1525,777,748,44,628,76
2011,Bristol 032F,E01033345,1288,732,556,36,481,39
2011,Bristol 032G,E01033350,939,750,189,79,60,50
2011,Bristol 033A,E01014677,1169,955,214,129,18,67
2011,Bristol 033B,E01014678,1154,869,285,164,29,92
2011,Bristol 033C,E01014679,1155,879,276,156,36,84
2011,Bristol 033D,E01014680,950,716,234,162,28,44
2011,Bristol 034A,E01014548,1428,1035,393,102,207,84
2011,Bristol 034B,E01014549,1006,640,366,92,199,75
2011,Bristol 034C,E01014550,1918,1303,615,145,399,71
2011,Bristol 034D,E01014555,1738,944,794,53,664,77
2011,Bristol 035A,E01014528,1174,984,190,97,30,63
2011,Bristol 035B,E01014529,1054,791,263,78,44,141
2011,Bristol 035C,E01014530,1094,894,200,97,21,82
2011,Bristol 035D,E01014531,1301,1074,227,91,43,93
2011,Bristol 035E,E01014532,1109,870,239,105,30,104
2011,Bristol 035F,E01014537,1286,996,290,131,39,120
2011,Bristol 036A,E01014695,1295,913,382,148,77,157
2011,Bristol 036B,E01014696,1308,1094,214,69,66,79
2011,Bristol 036C,E01014698,1502,1247,255,82,83,90
2011,Bristol 036D,E01014699,1157,890,267,79,60,128
2011,Bristol 036E,E01014700,1214,976,238,123,50,65
2011,Bristol 036F,E01014701,1379,1160,219,77,69,73
2011,Bristol 037A,E01014730,1323,1050,273,75,48,150
2011,Bristol 037B,E01014731,1309,1076,233,71,38,124
2011,Bristol 037C,E01014732,1360,1134,226,53,51,122
2011,Bristol 037D,E01014735,1327,1070,257,126,40,91
2011,Bristol 038A,E01014523,985,690,295,165,29,101
2011,Bristol 038B,E01014524,1062,783,279,153,42,84
2011,Bristol 038C,E01014525,1184,955,229,123,23,83
2011,Bristol 038D,E01014526,1063,758,305,130,29,146
2011,Bristol 038E,E01014527,982,714,268,157,23,88
2011,Bristol 039A,E01014500,1171,907,264,122,37,105
2011,Bristol 039B,E01014502,1310,957,353,154,34,165
2011,Bristol 039E,E01033359,1125,873,252,42,43,167
2011,Bristol 039F,E01033361,1048,735,313,151,45,117
2011,Bristol 039G,E01033362,914,785,129,33,35,61
2011,Bristol 039H,E01033364,1263,1073,190,86,23,81
2011,Bristol 040A,E01014729,1029,687,342,89,68,185
2011,Bristol 040B,E01014733,1381,1155,226,56,60,110
2011,Bristol 040C,E01014734,1220,1032,188,67,35,86
2011,Bristol 040D,E01014736,1434,1082,352,111,62,179
2011,Bristol 041A,E01014501,1240,787,453,262,42,149
2011,Bristol 041B,E01014504,1196,968,228,103,52,73
2011,Bristol 041C,E01014505,1430,1211,219,92,41,86
2011,Bristol 041D,E01014506,1144,904,240,138,40,62
2011,Bristol 042A,E01014645,1111,797,314,152,43,119
2011,Bristol 042B,E01014646,1144,802,342,161,43,138
2011,Bristol 042C,E01014648,1211,962,249,93,38,118
2011,Bristol 042D,E01014649,1198,928,270,137,34,99
2011,Bristol 042E,E01014651,1234,956,278,137,38,103
2011,Bristol 043A,E01014533,1146,904,242,109,35,98
2011,Bristol 043B,E01014534,1251,1039,212,98,33,81
2011,Bristol 043C,E01014535,1410,1076,334,183,51,100
2011,Bristol 043D,E01014536,1032,699,333,137,34,162
2011,Bristol 044A,E01014578,1184,829,355,142,45,168
2011,Bristol 044B,E01014583,973,594,379,101,40,238
2011,Bristol 044C,E01014585,1164,665,499,108,65,326
2011,Bristol 044D,E01014647,1142,760,382,100,44,238
2011,Bristol 044E,E01014650,1108,788,320,138,37,145
2011,Bristol 045A,E01014579,976,685,291,127,41,123
2011,Bristol 045B,E01014580,1071,611,460,174,49,237
2011,Bristol 045C,E01014581,1047,609,438,127,38,273
2011,Bristol 045D,E01014582,959,612,347,110,37,200
2011,Bristol 045E,E01014584,923,611,312,80,47,185
2011,Bristol 046A,E01014518,1228,955,273,120,35,118
2011,Bristol 046B,E01014519,929,655,274,154,30,90
2011,Bristol 046C,E01014520,1122,827,295,205,18,72
2011,Bristol 046D,E01014521,897,667,230,118,25,87
2011,Bristol 047A,E01014607,1033,738,295,201,23,71
2011,Bristol 047B,E01014608,1185,822,363,126,52,185
2011,Bristol 047C,E01014609,1229,884,345,145,46,154
2011,Bristol 047D,E01014610,978,633,345,136,32,177
2011,Bristol 047E,E01014613,1120,814,306,193,29,84
2011,Bristol 047F,E01014614,900,655,245,164,19,62
2011,Bristol 048A,E01014594,985,613,372,80,45,247
2011,Bristol 048B,E01014598,1055,771,284,194,24,66
2011,Bristol 048C,E01014599,921,705,216,126,33,57
2011,Bristol 048D,E01014600,911,659,252,111,25,116
2011,Bristol 049A,E01014702,1079,768,311,229,17,65
2011,Bristol 049B,E01014703,1071,729,342,125,36,181
2011,Bristol 049C,E01014704,1332,974,358,150,56,152
2011,Bristol 049D,E01014705,973,647,326,245,22,59
2011,Bristol 049E,E01014706,842,560,282,127,12,143
2011,Bristol 049F,E01014707,1195,818,377,255,47,75
2011,Bristol 049G,E01014708,1286,951,335,196,34,105
2011,Bristol 050A,E01014515,1022,673,349,144,38,167
2011,Bristol 050B,E01014516,946,578,368,119,30,219
2011,Bristol 050C,E01014517,863,594,269,76,35,158
2011,Bristol 050D,E01014522,1077,740,337,124,33,180
2011,Bristol 051A,E01014593,966,566,400,91,53,256
2011,Bristol 051B,E01014595,997,653,344,134,31,179
2011,Bristol 051C,E01014596,1036,634,402,158,45,199
2011,Bristol 051D,E01014597,924,574,350,125,29,196
2011,Bristol 052A,E01014611,947,653,294,219,18,57
2011,Bristol 052B,E01014612,1044,712,332,194,36,102
2011,Bristol 052C,E01014722,1162,873,289,202,25,62
2011,Bristol 052D,E01014723,1030,755,275,193,25,57
2011,Bristol 052E,E01014725,1123,808,315,217,31,67
2011,Bristol 053B,E01014726,1107,627,480,95,89,296
2011,Bristol 053C,E01014727,1008,610,398,104,49,245
2011,Bristol 053E,E01032514,1297,704,593,127,55,411
2011,Bristol 053F,E01032515,921,622,299,106,39,154
2011,Bristol 054A,E01033352,1101,930,171,27,51,93
2011,Bristol 054B,E01033353,1010,693,317,55,170,92
2011,Bristol 054C,E01033355,1023,815,208,38,102,68
2011,Bristol 054D,E01033358,1519,844,675,70,342,263
2011,Bristol 054E,E01033370,887,601,286,97,38,151
2011,Bristol 055A,E01014564,1323,901,422,96,130,196
2011,Bristol 055B,E01014653,1672,995,677,97,145,435
2011,Bristol 055C,E01014655,1660,1092,568,94,128,346
2011,Bristol 056A,E01014654,1552,962,590,94,133,363
2011,Bristol 056B,E01014658,1314,755,559,96,97,366
2011,Bristol 056C,E01033356,962,621,341,93,41,207
2011,Bristol 056D,E01033369,919,559,360,96,60,204
2011,Bristol 057A,E01014568,1700,1162,538,110,152,276
2011,Bristol 057B,E01014569,1556,1145,411,93,108,210
2011,Bristol 057C,E01014570,1330,1016,314,86,73,155
2011,Bristol 057D,E01014574,1551,1069,482,94,122,266
2011,Cornwall 010A,E01018753,1219,824,395,279,34,82
2011,Cornwall 010B,E01018754,1119,719,400,223,57,120
2011,Cornwall 010C,E01018755,1119,753,366,243,42,81
2011,Cornwall 010D,E01018756,1177,748,429,307,36,86
2011,Cornwall 012A,E01018777,1558,1064,494,327,44,123
2011,Cornwall 012B,E01018782,1076,736,340,218,37,85
2011,Cornwall 012C,E01018783,1167,808,359,226,35,98
2011,Cornwall 012D,E01018784,1080,720,360,235,40,85
2011,Cornwall 013A,E01018750,1621,1120,501,308,61,132
2011,Cornwall 013B,E01018751,1113,759,354,150,35,169
2011,Cornwall 013C,E01018752,1485,1036,449,261,50,138
2011,Cornwall 013D,E01018779,1635,1074,561,346,57,158
2011,Cornwall 016A,E01018758,1798,1220,578,331,58,189
2011,Cornwall 016B,E01018768,1414,1057,357,150,61,146
2011,Cornwall 016C,E01018769,1287,873,414,209,65,140
2011,Cornwall 016D,E01018778,1245,829,416,250,45,121
2011,Cornwall 017A,E01018767,1054,638,416,163,56,197
2011,Cornwall 017B,E01018770,863,546,317,132,43,142
2011,Cornwall 017C,E01018771,1021,719,302,150,36,116
2011,Cornwall 017D,E01018772,1117,733,384,261,43,80
2011,Cornwall 022A,E01018764,1083,757,326,246,26,54
2011,Cornwall 022B,E01018787,1137,905,232,132,38,62
2011,Cornwall 022C,E01018795,956,616,340,256,37,47
2011,Cornwall 022D,E01018796,902,699,203,133,31,39
2011,Cornwall 023A,E01018757,1572,960,612,432,63,117
2011,Cornwall 023B,E01018763,841,646,195,107,30,58
2011,Cornwall 023C,E01018765,1130,682,448,353,18,77
2011,Cornwall 023D,E01018785,1461,1010,451,291,54,106
2011,Cornwall 025A,E01018786,973,665,308,187,41,80
2011,Cornwall 025B,E01018788,963,573,390,251,22,117
2011,Cornwall 025C,E01018790,862,585,277,139,32,106
2011,Cornwall 025D,E01018794,1058,727,331,208,38,85
2011,Cornwall 026A,E01018789,1107,774,333,211,43,79
2011,Cornwall 026B,E01018791,920,568,352,217,35,100
2011,Cornwall 026C,E01018792,2027,1500,527,322,75,130
2011,Cornwall 026D,E01018793,1279,882,397,197,63,137
2011,Cornwall 028A,E01018759,1123,730,393,252,34,107
2011,Cornwall 028B,E01018760,912,615,297,182,36,79
2011,Cornwall 028C,E01018761,1033,604,429,295,31,103
2011,Cornwall 028D,E01018766,1334,839,495,338,31,126
2011,Cornwall 028E,E01018774,1018,624,394,201,34,159
2011,Cornwall 029A,E01018797,815,508,307,153,39,115
2011,Cornwall 029B,E01018798,1107,728,379,250,39,90
2011,Cornwall 029C,E01018799,819,552,267,145,30,92
2011,Cornwall 029D,E01018800,1162,867,295,158,42,95
2011,Cornwall 034A,E01018780,1680,1046,634,391,59,184
2011,Cornwall 034B,E01018781,1397,888,509,391,40,78
2011,Cornwall 034E,E01033294,1767,1293,474,281,65,128
2011,Cornwall 037A,E01018762,911,561,350,242,15,93
2011,Cornwall 037B,E01018773,1067,663,404,257,33,114
2011,Cornwall 037C,E01018775,1010,629,381,250,34,97
2011,Cornwall 037D,E01018776,915,607,308,212,24,72
2011,Cornwall 032A,E01018815,1525,1182,343,170,45,128
2011,Cornwall 032B,E01018831,934,695,239,132,29,78
2011,Cornwall 032C,E01018832,992,672,320,216,42,62
2011,Cornwall 032D,E01018847,1135,861,274,142,44,88
2011,Cornwall 033A,E01018833,1061,770,291,186,38,67
2011,Cornwall 033B,E01018842,1043,712,331,194,36,101
2011,Cornwall 033C,E01018843,974,689,285,194,38,53
2011,Cornwall 033D,E01018844,878,593,285,168,31,86
2011,Cornwall 040A,E01018825,1174,856,318,202,31,85
2011,Cornwall 040B,E01018826,1516,1047,469,311,46,112
2011,Cornwall 040C,E01018851,994,684,310,202,27,81
2011,Cornwall 040D,E01018852,1802,1256,546,369,67,110
2011,Cornwall 042A,E01018823,1055,738,317,212,46,59
2011,Cornwall 042B,E01018824,1777,1239,538,310,61,167
2011,Cornwall 042C,E01018853,1847,1332,515,243,85,187
2011,Cornwall 042D,E01018854,968,658,310,135,51,124
2011,Cornwall 043A,E01018819,1136,851,285,139,37,109
2011,Cornwall 043B,E01018822,903,637,266,169,26,71
2011,Cornwall 043C,E01018855,1779,1277,502,216,153,133
2011,Cornwall 043D,E01018856,1035,708,327,157,58,112
2011,Cornwall 043E,E01018857,845,559,286,139,27,120
2011,Cornwall 043F,E01018858,958,592,366,231,41,94
2011,Cornwall 044A,E01018807,965,660,305,202,44,59
2011,Cornwall 044B,E01018808,1051,783,268,142,44,82
2011,Cornwall 044C,E01018809,1431,1051,380,186,57,137
2011,Cornwall 044D,E01018810,1014,741,273,163,47,63
2011,Cornwall 047A,E01018816,1200,680,520,395,41,84
2011,Cornwall 047B,E01018817,1493,977,516,331,77,108
2011,Cornwall 047C,E01018818,1144,678,466,344,42,80
2011,Cornwall 047D,E01018820,1326,946,380,223,41,116
2011,Cornwall 047E,E01018821,907,669,238,131,39,68
2011,Cornwall 048A,E01018845,1089,802,287,173,34,80
2011,Cornwall 048B,E01018846,1015,701,314,224,34,56
2011,Cornwall 048C,E01018848,1162,831,331,217,32,82
2011,Cornwall 048D,E01018849,1347,821,526,394,27,105
2011,Cornwall 048E,E01018850,998,664,334,235,41,58
2011,Cornwall 056A,E01018827,1114,627,487,291,136,60
2011,Cornwall 056B,E01018828,1071,659,412,271,55,86
2011,Cornwall 056C,E01018829,1045,733,312,182,43,87
2011,Cornwall 056D,E01018830,1050,646,404,293,37,74
2011,Cornwall 060A,E01018834,1326,918,408,229,81,98
2011,Cornwall 060B,E01018835,1332,893,439,190,129,120
2011,Cornwall 060C,E01018836,1208,771,437,122,127,188
2011,Cornwall 060D,E01018837,1530,1049,481,256,112,113
2011,Cornwall 062A,E01018838,1143,687,456,164,150,142
2011,Cornwall 062B,E01018839,943,600,343,160,114,69
2011,Cornwall 062C,E01018840,1373,781,592,133,357,102
2011,Cornwall 062D,E01018841,1003,614,389,129,90,170
2011,Cornwall 062E,E01018860,1347,795,552,271,76,205
2011,Cornwall 063A,E01018803,1319,756,563,191,292,80
2011,Cornwall 063B,E01018804,1597,952,645,100,473,72
2011,Cornwall 063C,E01018805,1062,624,438,279,86,73
2011,Cornwall 063D,E01018806,1208,734,474,131,273,70
2011,Cornwall 064A,E01018811,1087,785,302,192,33,77
2011,Cornwall 064B,E01018812,989,694,295,133,54,108
2011,Cornwall 064C,E01018813,1064,773,291,188,43,60
2011,Cornwall 064D,E01018814,1081,786,295,173,51,71
2011,Cornwall 064E,E01018859,1278,816,462,277,103,82
2011,Cornwall 045A,E01018889,976,726,250,140,34,76
2011,Cornwall 045B,E01018890,1047,654,393,233,27,133
2011,Cornwall 045C,E01018891,977,652,325,211,27,87
2011,Cornwall 045D,E01018892,1004,707,297,197,29,71
2011,Cornwall 045E,E01018893,975,584,391,213,30,148
2011,Cornwall 046A,E01018908,1236,804,432,244,54,134
2011,Cornwall 046B,E01018909,1159,840,319,156,45,118
2011,Cornwall 046C,E01018910,1256,706,550,147,62,341
2011,Cornwall 046D,E01018911,1213,798,415,197,36,182
2011,Cornwall 049A,E01018912,1083,736,347,246,30,71
2011,Cornwall 049B,E01018913,1342,1001,341,151,51,139
2011,Cornwall 049C,E01018914,1401,932,469,268,43,158
2011,Cornwall 049D,E01018915,1445,997,448,251,44,153
2011,Cornwall 050A,E01018916,992,638,354,175,45,134
2011,Cornwall 050B,E01018917,1021,668,353,236,31,86
2011,Cornwall 050C,E01018918,1308,880,428,256,36,136
2011,Cornwall 050D,E01018919,1033,683,350,239,19,92
2011,Cornwall 051A,E01018894,1338,964,374,190,49,135
2011,Cornwall 051B,E01018895,1243,877,366,185,41,140
2011,Cornwall 051C,E01018896,1138,713,425,243,39,143
2011,Cornwall 051D,E01018897,1081,731,350,146,29,175
2011,Cornwall 051E,E01018898,935,535,400,147,59,194
2011,Cornwall 052A,E01018865,1403,959,444,203,52,189
2011,Cornwall 052B,E01018866,1179,763,416,240,29,147
2011,Cornwall 052C,E01018867,1378,919,459,193,48,218
2011,Cornwall 052D,E01018868,1254,820,434,211,47,176
2011,Cornwall 053A,E01018874,953,577,376,233,38,105
2011,Cornwall 053B,E01018875,894,479,415,185,36,194
2011,Cornwall 053C,E01018876,1031,681,350,185,37,128
2011,Cornwall 053D,E01018877,1041,623,418,282,40,96
2011,Cornwall 053E,E01018878,1006,641,365,145,53,167
2011,Cornwall 055A,E01018869,1114,733,381,209,25,147
2011,Cornwall 055B,E01018870,893,557,336,67,51,218
2011,Cornwall 055C,E01018871,1239,828,411,241,44,126
2011,Cornwall 055D,E01018872,926,572,354,204,29,121
2011,Cornwall 055E,E01018873,901,617,284,129,33,122
2011,Cornwall 059A,E01018863,1220,844,376,201,43,132
2011,Cornwall 059B,E01018864,1205,840,365,221,34,110
2011,Cornwall 059C,E01018921,1568,1090,478,277,49,152
2011,Cornwall 059D,E01018922,1785,1257,528,312,81,135
2011,Cornwall 066A,E01018879,1276,785,491,352,57,82
2011,Cornwall 066B,E01018880,1514,983,531,331,55,145
2011,Cornwall 066C,E01018899,2215,989,1226,215,930,81
2011,Cornwall 066D,E01018900,1110,756,354,236,48,70
2011,Cornwall 066E,E01018901,1226,753,473,269,113,91
2011,Cornwall 071A,E01018882,1121,790,331,212,41,78
2011,Cornwall 071B,E01018883,1158,875,283,181,32,70
2011,Cornwall 071C,E01018884,1184,874,310,188,44,78
2011,Cornwall 071D,E01018885,1085,751,334,183,32,119
2011,Cornwall 071E,E01018886,1324,1014,310,144,43,123
2011,Cornwall 071F,E01018887,1118,820,298,114,52,132
2011,Cornwall 071G,E01018888,1305,860,445,215,45,185
2011,Cornwall 072A,E01018861,1081,710,371,235,25,111
2011,Cornwall 072B,E01018862,1045,657,388,285,23,80
2011,Cornwall 072C,E01018905,962,658,304,186,36,82
2011,Cornwall 072D,E01018906,879,571,308,221,21,66
2011,Cornwall 072E,E01018907,888,549,339,201,34,104
2011,Cornwall 073A,E01018881,1359,823,536,336,62,138
2011,Cornwall 073B,E01018902,872,590,282,175,34,73
2011,Cornwall 073C,E01018903,1490,1210,280,169,27,84
2011,Cornwall 073D,E01018904,1470,899,571,365,56,150
2011,Cornwall 073E,E01018920,1482,948,534,370,42,122
2011,Cornwall 001A,E01018936,1126,764,362,210,38,114
2011,Cornwall 001B,E01018937,1336,886,450,192,62,196
2011,Cornwall 001C,E01018938,1135,684,451,273,59,119
2011,Cornwall 001D,E01018959,1025,543,482,353,32,97
2011,Cornwall 001E,E01018960,1365,913,452,261,60,131
2011,Cornwall 001F,E01018961,1051,661,390,248,35,107
2011,Cornwall 002A,E01018943,1565,1075,490,295,49,146
2011,Cornwall 002B,E01018951,1654,1066,588,360,56,172
2011,Cornwall 002C,E01018974,1880,1268,612,369,48,195
2011,Cornwall 003A,E01018940,1153,775,378,259,30,89
2011,Cornwall 003B,E01018941,1136,759,377,199,33,145
2011,Cornwall 003C,E01018942,1140,724,416,274,29,113
2011,Cornwall 003D,E01018969,1679,1102,577,406,48,123
2011,Cornwall 004B,E01018953,899,579,320,199,33,88
2011,Cornwall 004C,E01018968,1840,1255,585,393,45,147
2011,Cornwall 004D,E01033291,1171,788,383,260,48,75
2011,Cornwall 004E,E01033292,935,629,306,114,35,157
2011,Cornwall 005A,E01018946,1060,735,325,188,25,112
2011,Cornwall 005B,E01018947,2102,1570,532,227,72,233
2011,Cornwall 005C,E01018948,1210,868,342,180,28,134
2011,Cornwall 005D,E01018949,961,654,307,95,50,162
2011,Cornwall 005E,E01018950,1253,952,301,157,23,121
2011,Cornwall 006A,E01018925,1608,1052,556,352,42,162
2011,Cornwall 006B,E01018952,863,560,303,196,22,85
2011,Cornwall 006C,E01018965,1861,1191,670,397,93,180
2011,Cornwall 006D,E01018966,855,595,260,154,60,46
2011,Cornwall 006E,E01018967,1035,684,351,206,73,72
2011,Cornwall 007A,E01018924,857,595,262,160,34,68
2011,Cornwall 007B,E01018962,1538,1042,496,333,46,117
2011,Cornwall 007E,E01033289,1484,981,503,355,23,125
2011,Cornwall 008A,E01018954,902,655,247,117,46,84
2011,Cornwall 008B,E01018955,1142,754,388,237,34,117
2011,Cornwall 008C,E01018956,787,500,287,202,26,59
2011,Cornwall 008D,E01018957,948,640,308,191,31,86
2011,Cornwall 008E,E01018958,949,580,369,230,28,111
2011,Cornwall 009A,E01018970,1103,780,323,212,34,77
2011,Cornwall 009B,E01018971,1311,835,476,291,58,127
2011,Cornwall 009C,E01018972,1250,850,400,228,32,140
2011,Cornwall 009D,E01018973,1020,686,334,214,29,91
2011,Cornwall 011A,E01018923,903,595,308,214,21,73
2011,Cornwall 011B,E01018926,1776,1169,607,385,60,162
2011,Cornwall 011C,E01018944,892,584,308,165,36,107
2011,Cornwall 011D,E01018945,956,660,296,204,20,72
2011,Cornwall 014A,E01018932,1218,842,376,178,64,134
2011,Cornwall 014B,E01018933,1074,749,325,159,38,128
2011,Cornwall 014C,E01018934,1468,1034,434,302,44,88
2011,Cornwall 014D,E01018935,1608,1138,470,262,51,157
2011,Cornwall 015A,E01018927,1152,758,394,225,27,142
2011,Cornwall 015B,E01018928,1257,868,389,163,35,191
2011,Cornwall 015C,E01018929,927,590,337,199,32,106
2011,Cornwall 015D,E01018930,1099,706,393,98,51,244
2011,Cornwall 015E,E01018931,851,572,279,199,29,51
2011,Cornwall 054A,E01019008,1032,631,401,186,45,170
2011,Cornwall 054B,E01019009,1107,742,365,150,53,162
2011,Cornwall 054C,E01019010,994,705,289,186,28,75
2011,Cornwall 054D,E01019011,1051,653,398,273,40,85
2011,Cornwall 054E,E01019012,1368,915,453,308,34,111
2011,Cornwall 057A,E01018978,1101,740,361,195,42,124
2011,Cornwall 057B,E01018981,1479,950,529,333,56,140
2011,Cornwall 057C,E01018982,1530,1033,497,260,54,183
2011,Cornwall 057D,E01018983,1150,737,413,275,42,96
2011,Cornwall 057E,E01018984,1460,882,578,259,68,251
2011,Cornwall 058A,E01018985,1702,1075,627,402,91,134
2011,Cornwall 058B,E01018986,1082,636,446,335,20,91
2011,Cornwall 058C,E01018987,1571,1059,512,343,50,119
2011,Cornwall 061A,E01018975,1379,903,476,299,63,114
2011,Cornwall 061B,E01018979,1053,736,317,166,37,114
2011,Cornwall 061C,E01018980,1017,690,327,199,24,104
2011,Cornwall 061D,E01018990,1261,734,527,356,38,133
2011,Cornwall 061E,E01019007,1640,1106,534,309,65,160
2011,Cornwall 065A,E01018988,1161,769,392,260,25,107
2011,Cornwall 065B,E01018989,1312,871,441,240,64,137
2011,Cornwall 065C,E01018991,1130,739,391,220,32,139
2011,Cornwall 065D,E01019006,1196,811,385,256,40,89
2011,Cornwall 067A,E01018976,1499,953,546,364,40,142
2011,Cornwall 067B,E01018977,1017,634,383,142,44,197
2011,Cornwall 067C,E01018994,1137,688,449,281,48,120
2011,Cornwall 067D,E01018996,1126,661,465,223,41,201
2011,Cornwall 067E,E01018997,1001,566,435,98,72,265
2011,Cornwall 068A,E01018995,1544,937,607,262,54,291
2011,Cornwall 068B,E01018998,1066,772,294,135,30,129
2011,Cornwall 068C,E01018999,1100,718,382,195,41,146
2011,Cornwall 068D,E01019001,1234,824,410,243,46,121
2011,Cornwall 069A,E01018992,1242,868,374,239,39,96
2011,Cornwall 069B,E01018993,1222,800,422,233,57,132
2011,Cornwall 069C,E01019005,1540,1032,508,304,38,166
2011,Cornwall 070A,E01019000,971,541,430,300,25,105
2011,Cornwall 070B,E01019002,1020,598,422,313,22,87
2011,Cornwall 070C,E01019003,1256,823,433,294,34,105
2011,Cornwall 070D,E01019004,1165,710,455,215,49,191
2011,Cornwall 018A,E01019048,1351,909,442,273,35,134
2011,Cornwall 018B,E01019049,1316,906,410,192,58,160
2011,Cornwall 018C,E01019050,1076,762,314,201,31,82
2011,Cornwall 018D,E01019051,1143,741,402,191,46,165
2011,Cornwall 019A,E01019060,1204,837,367,223,33,111
2011,Cornwall 019B,E01019061,1253,896,357,189,46,122
2011,Cornwall 019C,E01019062,1382,915,467,214,62,191
2011,Cornwall 019D,E01019063,1478,1075,403,221,52,130
2011,Cornwall 019E,E01019064,1420,1012,408,240,32,136
2011,Cornwall 019F,E01019065,952,678,274,139,33,102
2011,Cornwall 020A,E01019028,1494,1087,407,169,50,188
2011,Cornwall 020B,E01019029,1094,815,279,114,46,119
2011,Cornwall 020C,E01019030,1317,935,382,216,52,114
2011,Cornwall 020D,E01019031,1116,789,327,188,37,102
2011,Cornwall 021A,E01019018,1177,773,404,267,52,85
2011,Cornwall 021B,E01019019,1036,669,367,220,44,103
2011,Cornwall 021C,E01019020,1152,822,330,95,55,180
2011,Cornwall 021D,E01019021,1079,734,345,227,39,79
2011,Cornwall 021E,E01019022,1243,813,430,216,52,162
2011,Cornwall 021F,E01019023,1176,903,273,108,55,110
2011,Cornwall 024A,E01019052,1297,896,401,195,48,158
2011,Cornwall 024B,E01019053,1438,1025,413,242,30,141
2011,Cornwall 024C,E01019054,1366,928,438,250,41,147
2011,Cornwall 024D,E01019055,1020,647,373,133,42,198
2011,Cornwall 027A,E01019035,1065,694,371,239,41,91
2011,Cornwall 027B,E01019036,1292,858,434,285,37,112
2011,Cornwall 027C,E01019037,1066,712,354,206,47,101
2011,Cornwall 027D,E01019074,1320,901,419,182,56,181
2011,Cornwall 027E,E01019075,1295,883,412,230,41,141
2011,Cornwall 027F,E01019076,1337,892,445,204,61,180
2011,Cornwall 030A,E01019069,961,694,267,110,31,126
2011,Cornwall 030B,E01019070,1458,927,531,261,45,225
2011,Cornwall 030C,E01019071,1174,818,356,206,51,99
2011,Cornwall 030D,E01019072,1081,727,354,172,47,135
2011,Cornwall 030E,E01019073,1051,715,336,221,25,90
2011,Cornwall 031A,E01019056,1073,643,430,146,43,241
2011,Cornwall 031B,E01019057,1384,974,410,216,41,153
2011,Cornwall 031C,E01019058,1326,943,383,238,41,104
2011,Cornwall 031D,E01019059,1130,732,398,241,35,122
2011,Cornwall 035A,E01019024,1056,707,349,190,43,116
2011,Cornwall 035B,E01019025,973,607,366,280,30,56
2011,Cornwall 035C,E01019026,1048,682,366,244,31,91
2011,Cornwall 035D,E01019027,1068,676,392,263,32,97
2011,Cornwall 036A,E01019013,1558,994,564,294,63,207
2011,Cornwall 036B,E01019014,1058,721,337,210,33,94
2011,Cornwall 036C,E01019015,1042,778,264,159,28,77
2011,Cornwall 036D,E01019016,1339,1046,293,153,44,96
2011,Cornwall 036E,E01019017,1664,1024,640,511,39,90
2011,Cornwall 038A,E01019032,1081,712,369,218,28,123
2011,Cornwall 038B,E01019034,1099,763,336,150,49,137
2011,Cornwall 038C,E01019045,1552,1152,400,223,57,120
2011,Cornwall 038D,E01019047,780,501,279,158,34,87
2011,Cornwall 039A,E01019033,971,559,412,161,36,215
2011,Cornwall 039B,E01019041,1155,740,415,158,50,207
2011,Cornwall 039C,E01019042,1266,835,431,198,58,175
2011,Cornwall 039D,E01019043,1130,711,419,256,45,118
2011,Cornwall 039E,E01019044,1076,638,438,308,35,95
2011,Cornwall 039F,E01019046,983,657,326,135,48,143
2011,Cornwall 041A,E01019038,803,482,321,228,19,74
2011,Cornwall 041B,E01019039,982,601,381,261,38,82
2011,Cornwall 041C,E01019040,901,572,329,218,29,82
2011,Cornwall 041D,E01019066,891,613,278,181,29,68
2011,Cornwall 041E,E01019067,823,528,295,218,21,56
2011,Cornwall 041F,E01019068,1171,693,478,366,24,88
2011,Isles of Scilly 001A,E01019077,1622,1331,291,209,13,69
2011,North Somerset 001B,E01014790,1033,741,292,207,26,59
2011,North Somerset 001C,E01014795,1016,723,293,152,32,109
2011,North Somerset 001D,E01014797,1286,934,352,234,34,84
2011,North Somerset 001E,E01032675,1056,896,160,96,11,53
2011,North Somerset 001F,E01032676,1062,852,210,136,9,65
2011,North Somerset 001G,E01032681,806,572,234,171,20,43
2011,North Somerset 002A,E01014789,954,646,308,248,19,41
2011,North Somerset 002B,E01014793,1095,790,305,230,27,48
2011,North Somerset 002C,E01014794,1200,761,439,364,26,49
2011,North Somerset 002D,E01014798,1147,813,334,227,42,65
2011,North Somerset 003B,E01014792,1251,870,381,283,23,75
2011,North Somerset 003C,E01014796,1203,825,378,284,28,66
2011,North Somerset 003D,E01032677,932,772,160,40,24,96
2011,North Somerset 003E,E01032678,1071,907,164,69,25,70
2011,North Somerset 003F,E01032682,732,596,136,77,15,44
2011,North Somerset 004A,E01014766,951,652,299,189,55,55
2011,North Somerset 004B,E01014767,957,631,326,245,39,42
2011,North Somerset 004C,E01014786,1157,804,353,203,28,122
2011,North Somerset 004D,E01014787,1423,1033,390,259,36,95
2011,North Somerset 005A,E01014752,1123,843,280,177,40,63
2011,North Somerset 005B,E01014754,830,625,205,161,8,36
2011,North Somerset 005C,E01014758,891,547,344,239,39,66
2011,North Somerset 005D,E01014759,936,627,309,236,23,50
2011,North Somerset 006B,E01014849,1105,743,362,258,32,72
2011,North Somerset 006C,E01014850,1433,1063,370,224,48,98
2011,North Somerset 006D,E01014851,1730,1342,388,226,38,124
2011,North Somerset 006E,E01014852,1151,859,292,164,39,89
2011,North Somerset 006F,E01032674,1740,1394,346,203,28,115
2011,North Somerset 006G,E01032680,1347,918,429,324,34,71
2011,North Somerset 007A,E01014750,1173,851,322,156,28,138
2011,North Somerset 007B,E01014751,1111,784,327,162,35,130
2011,North Somerset 007C,E01014753,1292,904,388,202,44,142
2011,North Somerset 007D,E01014755,899,619,280,207,14,59
2011,North Somerset 007E,E01014760,1055,754,301,195,37,69
2011,North Somerset 008A,E01014780,1075,756,319,211,31,77
2011,North Somerset 008B,E01014781,1080,721,359,248,26,85
2011,North Somerset 008C,E01014782,1007,681,326,247,24,55
2011,North Somerset 008D,E01014783,1167,862,305,179,40,86
2011,North Somerset 008E,E01014784,1098,772,326,236,30,60
2011,North Somerset 008F,E01014785,1071,686,385,305,27,53
2011,North Somerset 009A,E01014775,958,703,255,169,45,41
2011,North Somerset 009B,E01014776,971,722,249,163,36,50
2011,North Somerset 009C,E01014777,1078,809,269,173,33,63
2011,North Somerset 009D,E01014778,970,642,328,261,28,39
2011,North Somerset 009E,E01014779,867,599,268,196,28,44
2011,North Somerset 010A,E01014756,1197,901,296,175,33,88
2011,North Somerset 010B,E01014757,1111,872,239,163,27,49
2011,North Somerset 010C,E01014761,1207,913,294,193,32,69
2011,North Somerset 010D,E01014762,1056,801,255,167,32,56
2011,North Somerset 010E,E01014763,1339,1080,259,99,41,119
2011,North Somerset 011A,E01014737,1021,714,307,211,48,48
2011,North Somerset 011B,E01014738,1012,741,271,153,35,83
2011,North Somerset 011C,E01014739,1064,744,320,209,38,73
2011,North Somerset 011D,E01014740,950,695,255,157,37,61
2011,North Somerset 012A,E01014855,1086,785,301,227,23,51
2011,North Somerset 012B,E01014856,1098,801,297,171,39,87
2011,North Somerset 012C,E01014857,1092,740,352,218,44,90
2011,North Somerset 012D,E01014858,1312,1030,282,158,37,87
2011,North Somerset 012E,E01014859,1114,781,333,207,43,83
2011,North Somerset 012F,E01014860,1080,766,314,183,44,87
2011,North Somerset 013A,E01014847,1265,925,340,230,32,78
2011,North Somerset 013B,E01014848,981,730,251,169,30,52
2011,North Somerset 013C,E01014853,1116,776,340,219,50,71
2011,North Somerset 013D,E01014854,991,712,279,197,33,49
2011,North Somerset 014A,E01014764,1186,728,458,251,93,114
2011,North Somerset 014B,E01014765,1347,877,470,299,80,91
2011,North Somerset 014C,E01014773,1248,988,260,133,47,80
2011,North Somerset 014D,E01014774,1306,861,445,275,33,137
2011,North Somerset 015A,E01014821,886,716,170,68,27,75
2011,North Somerset 015B,E01014822,1063,843,220,122,32,66
2011,North Somerset 015C,E01014823,925,762,163,87,30,46
2011,North Somerset 015D,E01014824,1094,790,304,189,27,88
2011,North Somerset 015E,E01014825,907,660,247,157,25,65
2011,North Somerset 015F,E01014826,1134,886,248,95,45,108
2011,North Somerset 015G,E01014827,996,707,289,107,35,147
2011,North Somerset 016A,E01014817,1080,706,374,267,24,83
2011,North Somerset 016B,E01014820,922,535,387,270,22,95
2011,North Somerset 016C,E01014835,957,611,346,179,33,134
2011,North Somerset 016D,E01014836,1006,654,352,210,31,111
2011,North Somerset 016E,E01014838,983,673,310,197,27,86
2011,North Somerset 016F,E01014840,974,620,354,202,34,118
2011,North Somerset 017A,E01014812,991,653,338,239,21,78
2011,North Somerset 017B,E01014813,1213,863,350,219,32,99
2011,North Somerset 017C,E01014815,968,655,313,153,32,128
2011,North Somerset 017D,E01014816,1023,715,308,225,19,64
2011,North Somerset 017E,E01014818,1243,817,426,307,33,86
2011,North Somerset 017F,E01014819,1114,700,414,317,20,77
2011,North Somerset 018A,E01014841,1346,928,418,229,33,156
2011,North Somerset 018B,E01014842,1131,767,364,184,20,160
2011,North Somerset 018C,E01014843,1047,680,367,196,29,142
2011,North Somerset 018D,E01014844,950,626,324,128,28,168
2011,North Somerset 018E,E01014845,868,571,297,208,24,65
2011,North Somerset 018F,E01014846,1100,732,368,213,37,118
2011,North Somerset 020A,E01014799,1232,830,402,150,50,202
2011,North Somerset 020B,E01014800,1170,786,384,106,44,234
2011,North Somerset 020C,E01014801,1027,615,412,167,29,216
2011,North Somerset 020D,E01014802,1157,722,435,159,43,233
2011,North Somerset 020E,E01014809,1253,878,375,153,40,182
2011,North Somerset 020F,E01014811,1133,783,350,204,30,116
2011,North Somerset 021A,E01014829,1324,846,478,140,79,259
2011,North Somerset 021B,E01014830,1162,825,337,132,41,164
2011,North Somerset 021C,E01014831,899,524,375,95,48,232
2011,North Somerset 021D,E01014832,976,512,464,142,57,265
2011,North Somerset 021E,E01014833,1001,582,419,130,38,251
2011,North Somerset 022A,E01014804,904,565,339,225,26,88
2011,North Somerset 022B,E01014806,1048,637,411,189,23,199
2011,North Somerset 022C,E01014807,1239,889,350,125,50,175
2011,North Somerset 022D,E01014808,1024,752,272,170,31,71
2011,North Somerset 023A,E01014744,1007,673,334,240,19,75
2011,North Somerset 023B,E01014746,1001,678,323,191,28,104
2011,North Somerset 023C,E01014769,1639,1207,432,242,45,145
2011,North Somerset 023D,E01014770,993,589,404,306,14,84
2011,North Somerset 023E,E01014771,1004,657,347,260,27,60
2011,North Somerset 023F,E01014772,966,650,316,236,17,63
2011,North Somerset 024A,E01014741,962,636,326,221,34,71
2011,North Somerset 024B,E01014742,1144,686,458,259,145,54
2011,North Somerset 024C,E01014745,1021,695,326,229,26,71
2011,North Somerset 024D,E01014747,1003,697,306,195,40,71
2011,North Somerset 024E,E01014748,816,533,283,143,86,54
2011,North Somerset 024F,E01014749,1018,718,300,184,53,63
2011,North Somerset 025A,E01014803,1041,692,349,242,31,76
2011,North Somerset 025B,E01014805,1023,582,441,371,11,59
2011,North Somerset 025C,E01014828,973,607,366,148,46,172
2011,North Somerset 025D,E01014834,962,591,371,162,34,175
2011,North Somerset 026A,E01014839,1114,858,256,117,32,107
2011,North Somerset 026B,E01032666,856,632,224,150,29,45
2011,North Somerset 026C,E01032667,757,607,150,70,20,60
2011,North Somerset 026D,E01032668,1062,872,190,62,21,107
2011,North Somerset 026E,E01032672,1005,823,182,94,16,72
2011,North Somerset 026F,E01032673,887,619,268,153,18,97
2011,North Somerset 027A,E01014810,994,715,279,141,32,106
2011,North Somerset 027B,E01032669,1012,872,140,38,24,78
2011,North Somerset 027C,E01032670,1097,933,164,33,34,97
2011,North Somerset 027D,E01032671,915,792,123,42,27,54
2011,North Somerset 027E,E01032679,941,772,169,82,28,59
2011,Plymouth 001A,E01015025,1123,691,432,331,28,73
2011,Plymouth 001B,E01015097,1269,689,580,464,30,86
2011,Plymouth 001C,E01015160,1073,737,336,243,28,65
2011,Plymouth 001D,E01015164,1406,1044,362,154,47,161
2011,Plymouth 002A,E01015027,1206,863,343,199,40,104
2011,Plymouth 002B,E01015159,1113,669,444,256,35,153
2011,Plymouth 002C,E01015161,1106,692,414,251,37,126
2011,Plymouth 002D,E01015162,1041,678,363,167,46,150
2011,Plymouth 002E,E01015166,1340,888,452,177,53,222
2011,Plymouth 003A,E01015023,1175,747,428,168,61,199
2011,Plymouth 003B,E01015026,1165,746,419,154,44,221
2011,Plymouth 003C,E01015028,1013,644,369,123,37,209
2011,Plymouth 003D,E01015163,1043,664,379,244,39,96
2011,Plymouth 003E,E01015165,1173,908,265,127,46,92
2011,Plymouth 004A,E01015024,1153,845,308,181,36,91
2011,Plymouth 004B,E01015082,1178,721,457,179,43,235
2011,Plymouth 004C,E01015083,1093,677,416,164,55,197
2011,Plymouth 004D,E01015084,1060,680,380,189,47,144
2011,Plymouth 005A,E01015090,1084,783,301,198,36,67
2011,Plymouth 005B,E01015091,1214,846,368,228,42,98
2011,Plymouth 005C,E01015092,1289,752,537,117,313,107
2011,Plymouth 005D,E01015093,1066,713,353,188,32,133
2011,Plymouth 005E,E01015094,1003,701,302,155,37,110
2011,Plymouth 006A,E01015085,1136,742,394,210,35,149
2011,Plymouth 006B,E01015087,1087,697,390,120,66,204
2011,Plymouth 006C,E01015088,1048,608,440,109,74,257
2011,Plymouth 006D,E01015147,923,621,302,185,33,84
2011,Plymouth 006E,E01015148,1102,761,341,151,45,145
2011,Plymouth 007A,E01015030,1121,653,468,159,48,261
2011,Plymouth 007B,E01015070,1862,1361,501,195,79,227
2011,Plymouth 007C,E01015081,1083,689,394,168,52,174
2011,Plymouth 007D,E01015086,972,571,401,197,45,159
2011,Plymouth 007E,E01015089,1201,788,413,220,39,154
2011,Plymouth 008A,E01015029,1270,913,357,144,53,160
2011,Plymouth 008B,E01015064,1126,722,404,292,29,83
2011,Plymouth 008C,E01015065,974,653,321,194,37,90
2011,Plymouth 008D,E01015071,1088,740,348,210,45,93
2011,Plymouth 009A,E01015076,1087,788,299,160,26,113
2011,Plymouth 009B,E01015142,1031,743,288,153,37,98
2011,Plymouth 009C,E01015143,1019,674,345,204,24,117
2011,Plymouth 009D,E01015144,1071,687,384,123,60,201
2011,Plymouth 009E,E01015146,1214,806,408,88,51,269
2011,Plymouth 009F,E01015149,1037,588,449,177,54,218
2011,Plymouth 009G,E01015150,1018,679,339,206,28,105
2011,Plymouth 010A,E01015063,1068,741,327,141,39,147
2011,Plymouth 010B,E01015068,1152,820,332,193,47,92
2011,Plymouth 010C,E01015069,1140,782,358,181,43,134
2011,Plymouth 010D,E01015095,1081,676,405,286,24,95
2011,Plymouth 010E,E01015096,1065,679,386,218,37,131
2011,Plymouth 011A,E01015074,1076,654,422,187,41,194
2011,Plymouth 011B,E01015077,1189,811,378,183,52,143
2011,Plymouth 011C,E01015079,1057,740,317,190,38,89
2011,Plymouth 011D,E01015102,1267,995,272,146,39,87
2011,Plymouth 011E,E01015104,1089,841,248,140,37,71
2011,Plymouth 012A,E01015035,1150,834,316,193,56,67
2011,Plymouth 012B,E01015037,950,642,308,179,25,104
2011,Plymouth 012C,E01015058,989,644,345,106,60,179
2011,Plymouth 012D,E01015066,1125,809,316,197,40,79
2011,Plymouth 012E,E01015067,1132,731,401,295,43,63
2011,Plymouth 013A,E01015072,1141,734,407,141,53,213
2011,Plymouth 013B,E01015073,1083,681,402,163,43,196
2011,Plymouth 013C,E01015078,843,485,358,136,42,180
2011,Plymouth 013D,E01015080,897,510,387,81,63,243
2011,Plymouth 013E,E01015106,922,644,278,135,37,106
2011,Plymouth 014A,E01015039,1010,789,221,88,39,94
2011,Plymouth 014B,E01015040,1104,697,407,131,58,218
2011,Plymouth 014C,E01015041,1082,812,270,114,39,117
2011,Plymouth 014D,E01015075,1015,653,362,154,34,174
2011,Plymouth 014E,E01015145,1159,729,430,36,54,340
2011,Plymouth 015A,E01015120,1133,788,345,221,39,85
2011,Plymouth 015B,E01015121,1073,668,405,305,43,57
2011,Plymouth 015C,E01015123,1114,722,392,277,28,87
2011,Plymouth 015D,E01015124,1114,746,368,257,43,68
2011,Plymouth 015E,E01015125,1175,790,385,251,41,93
2011,Plymouth 016A,E01015033,1128,826,302,206,44,52
2011,Plymouth 016B,E01015034,983,693,290,163,56,71
2011,Plymouth 016C,E01015036,1008,715,293,180,45,68
2011,Plymouth 016D,E01015038,1289,941,348,191,60,97
2011,Plymouth 016E,E01015101,1047,726,321,218,32,71
2011,Plymouth 017A,E01015098,1133,798,335,132,130,73
2011,Plymouth 017B,E01015099,1132,872,260,115,86,59
2011,Plymouth 017C,E01015100,1145,829,316,98,122,96
2011,Plymouth 017D,E01015103,1110,859,251,126,43,82
2011,Plymouth 017E,E01015105,1096,856,240,124,50,66
2011,Plymouth 018A,E01015107,1148,904,244,120,43,81
2011,Plymouth 018B,E01015110,1232,950,282,188,27,67
2011,Plymouth 018C,E01015111,1260,1036,224,107,31,86
2011,Plymouth 018D,E01015119,1290,1016,274,158,46,70
2011,Plymouth 019A,E01015112,1047,775,272,172,27,73
2011,Plymouth 019B,E01015113,1076,764,312,221,32,59
2011,Plymouth 019C,E01015114,1089,783,306,202,33,71
2011,Plymouth 019D,E01015118,1148,864,284,206,31,47
2011,Plymouth 019E,E01015122,1086,760,326,220,44,62
2011,Plymouth 020A,E01015042,1101,835,266,104,50,112
2011,Plymouth 020B,E01015044,1219,857,362,128,46,188
2011,Plymouth 020C,E01015167,1204,927,277,105,53,119
2011,Plymouth 020D,E01015168,1445,1073,372,131,71,170
2011,Plymouth 020E,E01015171,1347,970,377,151,77,149
2011,Plymouth 021A,E01015055,1054,650,404,150,52,202
2011,Plymouth 021B,E01015056,1189,830,359,187,36,136
2011,Plymouth 021C,E01015057,1055,694,361,116,66,179
2011,Plymouth 021D,E01015059,1155,866,289,95,59,135
2011,Plymouth 021E,E01015060,1123,766,357,166,50,141
2011,Plymouth 021F,E01015176,1095,728,367,150,45,172
2011,Plymouth 022A,E01015108,1360,998,362,195,51,116
2011,Plymouth 022B,E01015109,1166,904,262,147,41,74
2011,Plymouth 022C,E01015115,919,576,343,194,35,114
2011,Plymouth 022D,E01015116,1113,796,317,210,25,82
2011,Plymouth 022E,E01015117,1134,826,308,198,36,74
2011,Plymouth 023A,E01015031,1280,901,379,99,218,62
2011,Plymouth 023B,E01015032,1786,1004,782,81,593,108
2011,Plymouth 023C,E01015049,1449,793,656,78,513,65
2011,Plymouth 023D,E01015050,1686,858,828,48,703,77
2011,Plymouth 023E,E01015051,1780,766,1014,86,864,64
2011,Plymouth 024A,E01015169,1614,1049,565,121,341,103
2011,Plymouth 024B,E01015170,1205,828,377,159,47,171
2011,Plymouth 024C,E01015173,1337,964,373,149,93,131
2011,Plymouth 024D,E01015174,1230,893,337,177,61,99
2011,Plymouth 025A,E01015061,1137,787,350,86,140,124
2011,Plymouth 025B,E01015062,1876,1003,873,80,709,84
2011,Plymouth 025C,E01015175,1335,935,400,107,184,109
2011,Plymouth 025D,E01015177,1399,1012,387,130,163,94
2011,Plymouth 025E,E01015178,1777,1155,622,90,424,108
2011,Plymouth 026A,E01015043,1109,739,370,77,69,224
2011,Plymouth 026B,E01015045,1110,771,339,96,27,216
2011,Plymouth 026C,E01015046,1435,808,627,173,74,380
2011,Plymouth 026D,E01015047,1058,694,364,100,59,205
2011,Plymouth 026E,E01015048,873,557,316,78,34,204
2011,Plymouth 027A,E01015053,1357,658,699,56,534,109
2011,Plymouth 027B,E01015054,2141,753,1388,44,1253,91
2011,Plymouth 027C,E01015152,1418,736,682,152,203,327
2011,Plymouth 027E,E01015156,1302,852,450,142,181,127
2011,Plymouth 027F,E01032657,1344,780,564,125,383,56
2011,Plymouth 027G,E01032658,1038,613,425,113,164,148
2011,Plymouth 028A,E01015052,1730,953,777,75,547,155
2011,Plymouth 028B,E01015179,1438,927,511,73,368,70
2011,Plymouth 028C,E01015180,1357,898,459,156,78,225
2011,Plymouth 028D,E01015181,1704,1165,539,131,200,208
2011,Plymouth 028E,E01015182,1395,981,414,138,98,178
2011,Plymouth 029A,E01015151,1580,908,672,97,357,218
2011,Plymouth 029B,E01015153,1330,785,545,145,124,276
2011,Plymouth 029C,E01015155,1342,753,589,141,93,355
2011,Plymouth 029D,E01015157,1747,1230,517,172,111,234
2011,Plymouth 029E,E01015158,1766,1262,504,228,123,153
2011,Plymouth 029F,E01015172,1439,1060,379,122,121,136
2011,Plymouth 030A,E01015126,900,551,349,269,27,53
2011,Plymouth 030B,E01015127,1087,751,336,227,41,68
2011,Plymouth 030C,E01015131,1048,670,378,299,24,55
2011,Plymouth 030D,E01015132,1055,673,382,243,43,96
2011,Plymouth 030E,E01015133,1115,727,388,273,42,73
2011,Plymouth 031A,E01015135,1134,785,349,191,56,102
2011,Plymouth 031B,E01015136,1057,742,315,188,43,84
2011,Plymouth 031C,E01015137,1142,846,296,185,36,75
2011,Plymouth 031D,E01015138,1149,754,395,288,26,81
2011,Plymouth 031E,E01015139,1008,686,322,198,29,95
2011,Plymouth 031F,E01015141,1285,860,425,307,38,80
2011,Plymouth 032A,E01015128,1196,807,389,289,32,68
2011,Plymouth 032B,E01015129,1105,837,268,129,33,106
2011,Plymouth 032C,E01015130,1221,923,298,147,48,103
2011,Plymouth 032D,E01015134,1014,720,294,171,42,81
2011,Plymouth 032E,E01015140,989,607,382,269,22,91
2011,Poole 001A,E01015431,1063,588,475,190,241,44
2011,Poole 001B,E01015432,1182,819,363,267,36,60
2011,Poole 001C,E01015433,1102,784,318,252,19,47
2011,Poole 001D,E01015434,1147,741,406,300,48,58
2011,Poole 002A,E01015379,958,655,303,113,38,152
2011,Poole 002B,E01015435,1156,904,252,92,36,124
2011,Poole 002C,E01015436,1000,711,289,180,28,81
2011,Poole 002D,E01015437,993,709,284,190,38,56
2011,Poole 003A,E01015395,879,595,284,209,25,50
2011,Poole 003B,E01015396,1056,728,328,248,28,52
2011,Poole 003C,E01015397,1073,823,250,131,39,80
2011,Poole 003D,E01015398,998,747,251,163,27,61
2011,Poole 003E,E01015399,996,666,330,229,53,48
2011,Poole 003F,E01015400,1030,699,331,242,28,61
2011,Poole 003G,E01015401,1018,669,349,261,37,51
2011,Poole 004A,E01015412,1020,797,223,160,20,43
2011,Poole 004B,E01015413,1092,840,252,137,21,94
2011,Poole 004C,E01015414,1084,805,279,156,33,90
2011,Poole 004D,E01015415,928,685,243,65,28,150
2011,Poole 004E,E01015416,939,715,224,130,23,71
2011,Poole 005A,E01015407,1096,767,329,208,29,92
2011,Poole 005B,E01015408,965,686,279,167,31,81
2011,Poole 005C,E01015409,1069,788,281,76,52,153
2011,Poole 005D,E01015410,1182,960,222,103,32,87
2011,Poole 005E,E01015411,1021,780,241,140,28,73
2011,Poole 006A,E01015417,1065,730,335,186,33,116
2011,Poole 006B,E01015418,1140,874,266,160,23,83
2011,Poole 006C,E01015419,1280,919,361,260,25,76
2011,Poole 006D,E01015420,1051,737,314,160,30,124
2011,Poole 006E,E01015421,951,654,297,197,20,80
2011,Poole 006F,E01015422,1131,939,192,90,23,79
2011,Poole 007A,E01015380,1280,816,464,308,35,121
2011,Poole 007B,E01015381,1148,749,399,191,44,164
2011,Poole 007C,E01015382,1352,1032,320,91,55,174
2011,Poole 007D,E01015383,1087,726,361,251,42,68
2011,Poole 007E,E01015384,1075,731,344,97,56,191
2011,Poole 007F,E01015385,1227,799,428,233,49,146
2011,Poole 008A,E01015438,1147,857,290,154,32,104
2011,Poole 008B,E01015439,1276,924,352,154,47,151
2011,Poole 008C,E01015441,1372,1005,367,159,44,164
2011,Poole 008D,E01015442,1329,886,443,197,46,200
2011,Poole 008E,E01015443,1302,899,403,200,34,169
2011,Poole 008F,E01015444,1283,930,353,167,49,137
2011,Poole 009A,E01015386,1238,886,352,138,68,146
2011,Poole 009B,E01015387,1119,787,332,204,37,91
2011,Poole 009C,E01015388,1284,730,554,143,335,76
2011,Poole 009D,E01015389,1125,875,250,161,29,60
2011,Poole 010A,E01015390,1281,970,311,132,46,133
2011,Poole 010B,E01015391,1117,852,265,157,22,86
2011,Poole 010C,E01015392,1062,784,278,139,40,99
2011,Poole 010D,E01015393,937,725,212,102,19,91
2011,Poole 010E,E01015394,1177,909,268,132,44,92
2011,Poole 011A,E01015440,1425,1054,371,202,50,119
2011,Poole 011B,E01015447,1124,791,333,220,27,86
2011,Poole 011C,E01015449,1243,884,359,163,47,149
2011,Poole 011D,E01015456,1253,882,371,187,38,146
2011,Poole 011E,E01015457,1183,797,386,257,25,104
2011,Poole 012A,E01015445,1401,1056,345,228,45,72
2011,Poole 012B,E01015446,1120,808,312,201,33,78
2011,Poole 012C,E01015448,1093,833,260,150,33,77
2011,Poole 012D,E01015450,1263,943,320,171,46,103
2011,Poole 012E,E01015451,1036,718,318,228,31,59
2011,Poole 013A,E01015458,1004,654,350,272,21,57
2011,Poole 013B,E01015460,1236,1006,230,97,40,93
2011,Poole 013C,E01015461,1145,891,254,109,52,93
2011,Poole 013D,E01015462,1215,943,272,116,40,116
2011,Poole 013E,E01015463,1151,849,302,163,42,97
2011,Poole 013F,E01015464,1144,835,309,219,29,61
2011,Poole 014A,E01015427,1259,958,301,108,30,163
2011,Poole 014B,E01015428,1564,1079,485,339,28,118
2011,Poole 014C,E01015429,1192,823,369,176,46,147
2011,Poole 014D,E01015430,1094,704,390,138,49,203
2011,Poole 015A,E01015465,1331,1020,311,158,29,124
2011,Poole 015B,E01015466,1192,865,327,197,36,94
2011,Poole 015D,E01015468,1277,947,330,170,50,110
2011,Poole 015F,E01032659,936,656,280,106,31,143
2011,Poole 015G,E01032660,1381,948,433,111,212,110
2011,Poole 015H,E01032661,1018,718,300,194,31,75
2011,Poole 015I,E01032662,818,525,293,158,20,115
2011,Poole 016A,E01015423,1523,1100,423,209,41,173
2011,Poole 016B,E01015424,1026,758,268,167,23,78
2011,Poole 016C,E01015425,956,681,275,181,28,66
2011,Poole 016D,E01015426,966,643,323,159,33,131
2011,Poole 017A,E01015452,1137,770,367,245,33,89
2011,Poole 017B,E01015453,1383,1092,291,164,36,91
2011,Poole 017C,E01015454,1319,1000,319,162,38,119
2011,Poole 017D,E01015455,1282,882,400,287,32,81
2011,Poole 017E,E01015459,1149,730,419,291,38,90
2011,Poole 018A,E01015402,1123,706,417,220,66,131
2011,Poole 018B,E01015403,958,554,404,332,16,56
2011,Poole 018C,E01015404,1065,620,445,327,36,82
2011,Poole 018D,E01015405,1251,806,445,322,41,82
2011,Poole 018E,E01015406,1272,805,467,302,41,124
2011,South Gloucestershire 001A,E01014985,1083,767,316,223,39,54
2011,South Gloucestershire 001B,E01014986,1077,727,350,192,37,121
2011,South Gloucestershire 001C,E01014987,892,630,262,188,28,46
2011,South Gloucestershire 001D,E01014988,996,697,299,216,32,51
2011,South Gloucestershire 001E,E01014989,1041,633,408,156,36,216
2011,South Gloucestershire 002A,E01014990,1094,741,353,262,33,58
2011,South Gloucestershire 002B,E01014991,1483,1042,441,225,38,178
2011,South Gloucestershire 002C,E01014992,1141,798,343,222,43,78
2011,South Gloucestershire 002D,E01014993,1074,792,282,180,47,55
2011,South Gloucestershire 003A,E01014884,1609,994,615,145,52,418
2011,South Gloucestershire 003B,E01014885,1407,1051,356,250,47,59
2011,South Gloucestershire 003C,E01014929,1506,1086,420,258,38,124
2011,South Gloucestershire 003D,E01014930,1389,1047,342,174,77,91
2011,South Gloucestershire 004A,E01014863,1022,683,339,240,42,57
2011,South Gloucestershire 004B,E01014864,1107,764,343,265,31,47
2011,South Gloucestershire 004C,E01014962,1297,917,380,246,51,83
2011,South Gloucestershire 004D,E01014963,1378,1021,357,262,48,47
2011,South Gloucestershire 005A,E01014861,1396,1046,350,244,37,69
2011,South Gloucestershire 005B,E01014862,1976,1478,498,313,71,114
2011,South Gloucestershire 005C,E01014953,1517,1171,346,203,49,94
2011,South Gloucestershire 005D,E01014954,1162,862,300,192,22,86
2011,South Gloucestershire 006A,E01015014,1118,893,225,146,19,60
2011,South Gloucestershire 006B,E01015015,1105,940,165,76,30,59
2011,South Gloucestershire 006C,E01015016,935,652,283,210,25,48
2011,South Gloucestershire 006D,E01015017,1059,754,305,181,39,85
2011,South Gloucestershire 006E,E01015018,1090,802,288,172,45,71
2011,South Gloucestershire 007A,E01015019,1324,988,336,137,59,140
2011,South Gloucestershire 007B,E01015020,1099,785,314,144,48,122
2011,South Gloucestershire 007C,E01015021,1211,945,266,184,38,44
2011,South Gloucestershire 007D,E01015022,1220,994,226,131,37,58
2011,South Gloucestershire 008A,E01014886,1234,868,366,227,32,107
2011,South Gloucestershire 008B,E01014887,1063,784,279,219,21,39
2011,South Gloucestershire 008C,E01014888,1023,666,357,279,24,54
2011,South Gloucestershire 008D,E01014889,1166,862,304,219,24,61
2011,South Gloucestershire 009A,E01014872,1262,1091,171,56,46,69
2011,South Gloucestershire 009B,E01014874,1095,935,160,62,29,69
2011,South Gloucestershire 009C,E01014876,1284,1127,157,39,40,78
2011,South Gloucestershire 009D,E01014877,1145,968,177,63,56,58
2011,South Gloucestershire 009E,E01014879,1282,993,289,162,37,90
2011,South Gloucestershire 009F,E01014881,1421,1242,179,42,53,84
2011,South Gloucestershire 010A,E01015009,967,675,292,212,22,58
2011,South Gloucestershire 010B,E01015010,1003,720,283,181,32,70
2011,South Gloucestershire 010C,E01015011,1139,805,334,184,46,104
2011,South Gloucestershire 010D,E01015012,908,590,318,239,22,57
2011,South Gloucestershire 010E,E01015013,988,779,209,109,30,70
2011,South Gloucestershire 011A,E01014946,1172,869,303,167,28,108
2011,South Gloucestershire 011B,E01014947,1029,676,353,278,20,55
2011,South Gloucestershire 011C,E01014948,1211,852,359,163,34,162
2011,South Gloucestershire 011D,E01014949,1091,884,207,99,34,74
2011,South Gloucestershire 011E,E01014950,1067,841,226,112,30,84
2011,South Gloucestershire 011F,E01014951,1007,758,249,108,33,108
2011,South Gloucestershire 011G,E01014952,1270,926,344,208,53,83
2011,South Gloucestershire 012A,E01014873,1144,954,190,90,44,56
2011,South Gloucestershire 012B,E01014875,1379,1188,191,56,33,102
2011,South Gloucestershire 012C,E01014878,1571,1358,213,75,42,96
2011,South Gloucestershire 012D,E01014880,1326,1131,195,48,56,91
2011,South Gloucestershire 012E,E01014882,1533,1247,286,81,63,142
2011,South Gloucestershire 012F,E01014883,930,756,174,103,26,45
2011,South Gloucestershire 013A,E01014911,970,649,321,235,39,47
2011,South Gloucestershire 013B,E01014912,1316,990,326,224,42,60
2011,South Gloucestershire 013C,E01014913,1175,837,338,247,41,50
2011,South Gloucestershire 013D,E01014914,1175,810,365,169,49,147
2011,South Gloucestershire 014A,E01014892,1212,926,286,131,24,131
2011,South Gloucestershire 014B,E01014893,1096,852,244,152,25,67
2011,South Gloucestershire 014C,E01014894,977,773,204,123,28,53
2011,South Gloucestershire 014D,E01014895,1062,852,210,101,42,67
2011,South Gloucestershire 014E,E01014896,964,783,181,81,27,73
2011,South Gloucestershire 015A,E01014979,1162,891,271,155,50,66
2011,South Gloucestershire 015B,E01014980,1246,959,287,170,50,67
2011,South Gloucestershire 015C,E01014982,1148,867,281,165,27,89
2011,South Gloucestershire 015D,E01014983,1106,820,286,143,35,108
2011,South Gloucestershire 015E,E01014984,1054,782,272,164,39,69
2011,South Gloucestershire 016A,E01014998,1048,703,345,259,26,60
2011,South Gloucestershire 016B,E01014999,1108,749,359,257,34,68
2011,South Gloucestershire 016C,E01015000,1074,769,305,174,32,99
2011,South Gloucestershire 016D,E01015001,1111,825,286,201,32,53
2011,South Gloucestershire 017A,E01014978,1130,903,227,100,45,82
2011,South Gloucestershire 017B,E01014981,2097,1655,442,170,113,159
2011,South Gloucestershire 017C,E01014996,1139,734,405,267,50,88
2011,South Gloucestershire 017E,E01033331,2010,1235,775,22,688,65
2011,South Gloucestershire 017F,E01033333,1940,1069,871,122,663,86
2011,South Gloucestershire 018A,E01014904,1100,744,356,166,85,105
2011,South Gloucestershire 018B,E01014905,1272,929,343,161,108,74
2011,South Gloucestershire 018C,E01014906,1166,801,365,160,73,132
2011,South Gloucestershire 018D,E01014907,1153,832,321,138,103,80
2011,South Gloucestershire 018E,E01014908,985,719,266,163,44,59
2011,South Gloucestershire 018F,E01014909,1176,846,330,112,133,85
2011,South Gloucestershire 018G,E01014910,1077,793,284,138,72,74
2011,South Gloucestershire 019A,E01014867,1003,628,375,184,61,130
2011,South Gloucestershire 019B,E01014868,1179,921,258,143,35,80
2011,South Gloucestershire 019D,E01014994,1225,862,363,253,29,81
2011,South Gloucestershire 019E,E01014995,1224,870,354,264,27,63
2011,South Gloucestershire 019F,E01033338,1179,964,215,99,50,66
2011,South Gloucestershire 019G,E01033339,1038,788,250,105,45,100
2011,South Gloucestershire 020A,E01014901,1145,857,288,196,41,51
2011,South Gloucestershire 020B,E01014902,893,661,232,162,26,44
2011,South Gloucestershire 020C,E01014903,1041,725,316,240,36,40
2011,South Gloucestershire 020D,E01014965,1028,747,281,194,32,55
2011,South Gloucestershire 021A,E01014964,1228,984,244,163,24,57
2011,South Gloucestershire 021B,E01014966,1138,984,154,71,26,57
2011,South Gloucestershire 021C,E01014967,1511,1216,295,169,33,93
2011,South Gloucestershire 021D,E01014969,1116,836,280,181,33,66
2011,South Gloucestershire 021F,E01033334,1177,1017,160,41,33,86
2011,South Gloucestershire 021G,E01033336,1192,1006,186,80,41,65
2011,South Gloucestershire 022A,E01014897,1000,742,258,179,39,40
2011,South Gloucestershire 022B,E01014898,1133,874,259,172,30,57
2011,South Gloucestershire 022C,E01014899,1175,876,299,172,47,80
2011,South Gloucestershire 022D,E01014900,1115,802,313,168,45,100
2011,South Gloucestershire 023A,E01014959,998,749,249,138,35,76
2011,South Gloucestershire 023B,E01014960,1157,852,305,150,54,101
2011,South Gloucestershire 023C,E01014961,1126,789,337,154,42,141
2011,South Gloucestershire 023D,E01014968,1137,783,354,190,46,118
2011,South Gloucestershire 024A,E01014865,1360,1004,356,204,39,113
2011,South Gloucestershire 024B,E01014869,1190,884,306,174,51,81
2011,South Gloucestershire 024C,E01014870,1222,906,316,170,50,96
2011,South Gloucestershire 024D,E01014871,857,624,233,167,31,35
2011,South Gloucestershire 024E,E01014890,1508,1139,369,234,41,94
2011,South Gloucestershire 024F,E01014891,1298,968,330,206,40,84
2011,South Gloucestershire 025A,E01014955,951,700,251,164,24,63
2011,South Gloucestershire 025B,E01014956,1155,858,297,211,34,52
2011,South Gloucestershire 025C,E01014957,925,686,239,159,32,48
2011,South Gloucestershire 025D,E01014974,1057,818,239,140,30,69
2011,South Gloucestershire 025E,E01014977,929,634,295,115,25,155
2011,South Gloucestershire 026A,E01014922,1010,765,245,144,36,65
2011,South Gloucestershire 026B,E01014923,1057,761,296,169,26,101
2011,South Gloucestershire 026C,E01014924,1304,1002,302,118,46,138
2011,South Gloucestershire 026D,E01014973,1069,741,328,188,37,103
2011,South Gloucestershire 026E,E01014975,1195,916,279,156,38,85
2011,South Gloucestershire 026F,E01014976,1096,795,301,146,37,118
2011,South Gloucestershire 027A,E01014925,1095,804,291,174,37,80
2011,South Gloucestershire 027B,E01014926,1156,771,385,175,56,154
2011,South Gloucestershire 027C,E01014927,1187,861,326,174,39,113
2011,South Gloucestershire 027D,E01014928,1081,740,341,189,33,119
2011,South Gloucestershire 027E,E01014958,852,602,250,129,32,89
2011,South Gloucestershire 028A,E01014915,1110,822,288,138,41,109
2011,South Gloucestershire 028B,E01015003,1191,906,285,187,21,77
2011,South Gloucestershire 028C,E01015005,1456,1134,322,110,56,156
2011,South Gloucestershire 028D,E01015007,1259,912,347,163,43,141
2011,South Gloucestershire 028E,E01015008,1190,882,308,169,36,103
2011,South Gloucestershire 029A,E01014943,1373,1193,180,64,41,75
2011,South Gloucestershire 029B,E01014944,1361,1130,231,114,47,70
2011,South Gloucestershire 029C,E01014972,1264,952,312,193,45,74
2011,South Gloucestershire 029D,E01015002,1171,919,252,114,31,107
2011,South Gloucestershire 029E,E01015004,1352,1037,315,170,45,100
2011,South Gloucestershire 029F,E01015006,1171,810,361,208,41,112
2011,South Gloucestershire 030A,E01014936,1051,802,249,131,44,74
2011,South Gloucestershire 030B,E01014938,1153,920,233,116,34,83
2011,South Gloucestershire 030C,E01014939,919,702,217,118,26,73
2011,South Gloucestershire 030D,E01014940,1038,842,196,111,33,52
2011,South Gloucestershire 030E,E01014941,1080,771,309,155,31,123
2011,South Gloucestershire 030F,E01014942,1008,704,304,133,33,138
2011,South Gloucestershire 030G,E01014945,1236,910,326,185,37,104
2011,South Gloucestershire 031A,E01014916,1063,811,252,141,30,81
2011,South Gloucestershire 031B,E01014917,1035,750,285,187,34,64
2011,South Gloucestershire 031C,E01014918,995,706,289,204,27,58
2011,South Gloucestershire 031D,E01014919,853,611,242,182,16,44
2011,South Gloucestershire 031E,E01014920,1034,737,297,200,36,61
2011,South Gloucestershire 031F,E01014921,1027,730,297,187,46,64
2011,South Gloucestershire 032A,E01014866,1185,860,325,226,34,65
2011,South Gloucestershire 032B,E01014931,1050,744,306,210,33,63
2011,South Gloucestershire 032C,E01014932,1232,919,313,219,25,69
2011,South Gloucestershire 032D,E01014933,1134,885,249,158,35,56
2011,South Gloucestershire 032E,E01014934,897,662,235,183,26,26
2011,South Gloucestershire 032F,E01014935,1164,911,253,157,35,61
2011,South Gloucestershire 032G,E01014937,937,670,267,195,32,40
2011,Swindon 001A,E01015519,1020,660,360,219,38,103
2011,Swindon 001B,E01015520,832,556,276,181,31,64
2011,Swindon 001C,E01015521,1090,769,321,214,46,61
2011,Swindon 001D,E01015522,1122,857,265,150,36,79
2011,Swindon 001E,E01015523,1121,790,331,224,36,71
2011,Swindon 001F,E01015524,887,660,227,121,34,72
2011,Swindon 003A,E01015543,950,657,293,153,27,113
2011,Swindon 003B,E01015544,1123,722,401,129,45,227
2011,Swindon 003C,E01015545,1080,690,390,105,48,237
2011,Swindon 003D,E01015546,1110,687,423,114,45,264
2011,Swindon 004A,E01015513,1214,1016,198,94,26,78
2011,Swindon 004B,E01015514,943,620,323,258,22,43
2011,Swindon 004C,E01015515,1139,885,254,177,26,51
2011,Swindon 004D,E01015516,949,637,312,190,22,100
2011,Swindon 004E,E01015517,1041,683,358,277,21,60
2011,Swindon 005A,E01015555,1047,714,333,212,32,89
2011,Swindon 005B,E01015556,1184,905,279,170,33,76
2011,Swindon 005C,E01015557,1104,846,258,164,30,64
2011,Swindon 005D,E01015558,1043,644,399,172,63,164
2011,Swindon 005E,E01015559,1091,778,313,206,24,83
2011,Swindon 005F,E01015560,1153,876,277,155,34,88
2011,Swindon 006A,E01015526,1123,904,219,100,33,86
2011,Swindon 006B,E01015528,1224,857,367,126,51,190
2011,Swindon 006C,E01015529,1132,782,350,204,40,106
2011,Swindon 006D,E01015530,1184,774,410,196,47,167
2011,Swindon 007A,E01015506,1104,740,364,143,41,180
2011,Swindon 007B,E01015507,1080,700,380,106,57,217
2011,Swindon 007C,E01015527,1204,832,372,157,53,162
2011,Swindon 007D,E01015580,1161,817,344,133,52,159
2011,Swindon 008A,E01015473,1283,922,361,246,38,77
2011,Swindon 008B,E01015474,1233,861,372,217,48,107
2011,Swindon 008C,E01015547,1263,966,297,168,39,90
2011,Swindon 008D,E01015548,1151,864,287,171,32,84
2011,Swindon 009A,E01015549,1261,986,275,178,25,72
2011,Swindon 009B,E01015550,1363,999,364,253,35,76
2011,Swindon 009C,E01015551,1061,773,288,194,35,59
2011,Swindon 009D,E01015552,1510,1215,295,141,53,101
2011,Swindon 009E,E01015553,1225,994,231,118,34,79
2011,Swindon 009F,E01015554,1009,673,336,241,15,80
2011,Swindon 010A,E01015508,1005,681,324,128,36,160
2011,Swindon 010B,E01015509,1230,968,262,129,39,94
2011,Swindon 010C,E01015510,1412,1051,361,137,64,160
2011,Swindon 010D,E01015511,1183,932,251,122,36,93
2011,Swindon 011A,E01015562,1143,956,187,51,41,95
2011,Swindon 011B,E01015563,1191,996,195,92,37,66
2011,Swindon 011C,E01015565,1199,942,257,96,49,112
2011,Swindon 011D,E01015566,1246,1041,205,85,40,80
2011,Swindon 012B,E01015578,1204,931,273,132,22,119
2011,Swindon 012C,E01015579,1173,936,237,126,22,89
2011,Swindon 012D,E01015581,1108,840,268,152,28,88
2011,Swindon 012E,E01015582,1408,1124,284,153,35,96
2011,Swindon 012F,E01032708,1360,1200,160,33,26,101
2011,Swindon 012G,E01032716,1111,913,198,84,25,89
2011,Swindon 013A,E01015481,1294,1020,274,167,34,73
2011,Swindon 013B,E01015482,997,762,235,166,20,49
2011,Swindon 013C,E01015483,1014,692,322,247,20,55
2011,Swindon 013D,E01015484,1042,735,307,234,18,55
2011,Swindon 013E,E01015485,1139,961,178,102,30,46
2011,Swindon 013F,E01015486,1101,801,300,208,18,74
2011,Swindon 014A,E01015561,1157,955,202,89,39,74
2011,Swindon 014B,E01015564,1203,982,221,106,35,80
2011,Swindon 014C,E01015567,1177,970,207,96,31,80
2011,Swindon 014D,E01015568,1118,893,225,107,38,80
2011,Swindon 015A,E01015475,1646,1325,321,95,56,170
2011,Swindon 015B,E01015476,1877,1414,463,140,50,273
2011,Swindon 015C,E01015477,1217,938,279,108,40,131
2011,Swindon 015D,E01015480,1807,1440,367,92,77,198
2011,Swindon 016A,E01015538,1261,809,452,159,50,243
2011,Swindon 016B,E01015572,903,626,277,87,40,150
2011,Swindon 016C,E01015573,1469,976,493,152,76,265
2011,Swindon 016D,E01015575,804,501,303,96,41,166
2011,Swindon 017A,E01015479,1232,968,264,101,42,121
2011,Swindon 017B,E01015493,1291,1035,256,75,58,123
2011,Swindon 017C,E01015574,1148,859,289,144,41,104
2011,Swindon 017D,E01015576,1054,728,326,173,43,110
2011,Swindon 018A,E01015499,1027,857,170,76,33,61
2011,Swindon 018B,E01015500,1171,959,212,80,39,93
2011,Swindon 018C,E01015504,1046,879,167,71,38,58
2011,Swindon 018D,E01015505,1137,940,197,64,30,103
2011,Swindon 019A,E01015494,1460,1235,225,78,40,107
2011,Swindon 019C,E01015496,1321,1113,208,73,34,101
2011,Swindon 019D,E01015497,1212,981,231,89,35,107
2011,Swindon 019E,E01032714,1100,913,187,55,32,100
2011,Swindon 019F,E01032715,780,652,128,43,13,72
2011,Swindon 020A,E01015537,1227,819,408,147,73,188
2011,Swindon 020B,E01015539,1139,767,372,132,54,186
2011,Swindon 020C,E01015540,1282,861,421,121,58,242
2011,Swindon 020D,E01015541,1274,821,453,146,72,235
2011,Swindon 020E,E01015542,1028,664,364,124,56,184
2011,Swindon 021A,E01015478,1127,906,221,105,33,83
2011,Swindon 021B,E01015498,1373,1102,271,127,50,94
2011,Swindon 021D,E01015532,1143,937,206,80,45,81
2011,Swindon 021E,E01032706,1208,1061,147,40,28,79
2011,Swindon 021F,E01032707,1361,1048,313,180,42,91
2011,Swindon 022A,E01015501,1068,837,231,105,41,85
2011,Swindon 022B,E01015502,1129,817,312,108,48,156
2011,Swindon 022C,E01015503,934,683,251,106,26,119
2011,Swindon 022D,E01015569,1149,795,354,129,62,163
2011,Swindon 022E,E01015570,1146,788,358,154,32,172
2011,Swindon 022F,E01015571,1167,845,322,166,46,110
2011,Swindon 023A,E01015487,1225,911,314,192,39,83
2011,Swindon 023B,E01015488,1065,755,310,152,26,132
2011,Swindon 023C,E01015489,1089,790,299,195,26,78
2011,Swindon 023D,E01015490,993,793,200,119,23,58
2011,Swindon 023E,E01015491,1092,754,338,168,25,145
2011,Swindon 023F,E01015492,1016,769,247,103,36,108
2011,Swindon 024A,E01015533,1018,693,325,222,31,72
2011,Swindon 024B,E01015534,1367,1063,304,194,32,78
2011,Swindon 024C,E01015535,1062,763,299,200,33,66
2011,Swindon 024D,E01015536,1694,1245,449,216,60,173
2011,Swindon 025A,E01015583,1636,1294,342,178,49,115
2011,Swindon 025B,E01015584,1002,653,349,268,27,54
2011,Swindon 025C,E01015585,1192,898,294,159,42,93
2011,Swindon 025D,E01015586,1037,666,371,277,36,58
2011,Swindon 025E,E01015587,1289,883,406,219,47,140
2011,Swindon 025F,E01015588,1331,933,398,260,39,99
2011,Swindon 026A,E01015525,1233,994,239,124,26,89
2011,Swindon 026B,E01032700,1127,999,128,41,29,58
2011,Swindon 026C,E01032703,1057,929,128,37,17,74
2011,Swindon 026D,E01032705,1042,907,135,26,20,89
2011,Swindon 026E,E01032709,985,855,130,39,23,68
2011,Swindon 026F,E01032713,1218,1078,140,37,26,77
2011,Swindon 027A,E01032701,926,819,107,35,15,57
2011,Swindon 027B,E01032702,1008,862,146,64,19,63
2011,Swindon 027C,E01032704,1041,903,138,22,26,90
2011,Swindon 027D,E01032711,1041,944,97,23,21,53
2011,Swindon 027E,E01032712,1038,906,132,27,25,80
2011,Swindon 028A,E01015471,1213,1005,208,109,34,65
2011,Swindon 028B,E01015472,2000,1666,334,123,45,166
2011,Swindon 028C,E01015512,1219,1060,159,69,30,60
2011,Swindon 028D,E01015518,1089,917,172,68,35,69
2011,Swindon 028E,E01032710,988,840,148,62,29,57
2011,Torbay 001A,E01015262,991,630,361,156,48,157
2011,Torbay 001B,E01015263,1049,661,388,132,39,217
2011,Torbay 001C,E01015264,937,590,347,262,20,65
2011,Torbay 001D,E01015265,1065,647,418,252,34,132
2011,Torbay 001E,E01015266,1018,600,418,141,64,213
2011,Torbay 002A,E01015236,1114,716,398,232,42,124
2011,Torbay 002B,E01015237,959,700,259,131,38,90
2011,Torbay 002C,E01015238,1001,682,319,187,21,111
2011,Torbay 002D,E01015239,996,618,378,221,28,129
2011,Torbay 003A,E01015249,1008,679,329,152,38,139
2011,Torbay 003B,E01015250,1026,787,239,148,23,68
2011,Torbay 003C,E01015251,886,647,239,130,53,56
2011,Torbay 003D,E01015252,1715,1298,417,217,43,157
2011,Torbay 003E,E01015253,1202,951,251,107,31,113
2011,Torbay 003F,E01015254,1002,648,354,236,27,91
2011,Torbay 004A,E01015257,973,630,343,109,54,180
2011,Torbay 004B,E01015258,1494,1049,445,239,48,158
2011,Torbay 004C,E01015259,1006,755,251,99,34,118
2011,Torbay 004D,E01015260,1177,767,410,159,37,214
2011,Torbay 005A,E01015240,971,587,384,258,17,109
2011,Torbay 005B,E01015241,1009,720,289,162,33,94
2011,Torbay 005C,E01015242,898,638,260,112,35,113
2011,Torbay 005D,E01015243,931,611,320,219,30,71
2011,Torbay 006A,E01015214,1056,789,267,92,27,148
2011,Torbay 006B,E01015215,1069,776,293,161,43,89
2011,Torbay 006C,E01015216,1063,758,305,128,39,138
2011,Torbay 006D,E01015218,1002,687,315,130,36,149
2011,Torbay 008A,E01015217,1132,754,378,122,26,230
2011,Torbay 008B,E01015255,1313,954,359,106,31,222
2011,Torbay 008C,E01015256,1452,1016,436,178,30,228
2011,Torbay 008D,E01015261,1491,1030,461,194,37,230
2011,Torbay 010A,E01015267,1167,737,430,238,16,176
2011,Torbay 010B,E01015268,1173,743,430,301,30,99
2011,Torbay 010C,E01015269,1162,752,410,265,25,120
2011,Torbay 010D,E01015270,1192,714,478,293,29,156
2011,Torbay 010E,E01015271,1000,554,446,353,26,67
2011,Torbay 011A,E01015224,1057,724,333,200,38,95
2011,Torbay 011B,E01015225,1018,686,332,173,34,125
2011,Torbay 011C,E01015226,1038,639,399,288,22,89
2011,Torbay 011D,E01015227,1097,764,333,232,31,70
2011,Torbay 011E,E01015228,1029,673,356,190,31,135
2011,Torbay 011F,E01015230,991,617,374,299,20,55
2011,Torbay 012A,E01015202,1064,766,298,170,32,96
2011,Torbay 012B,E01015203,885,574,311,229,28,54
2011,Torbay 012C,E01015204,996,697,299,166,28,105
2011,Torbay 012D,E01015205,1096,742,354,218,34,102
2011,Torbay 012E,E01015206,1038,725,313,172,29,112
2011,Torbay 013A,E01015190,1216,743,473,276,43,154
2011,Torbay 013B,E01015191,1161,840,321,159,51,111
2011,Torbay 013C,E01015192,1009,676,333,144,45,144
2011,Torbay 013D,E01015193,933,596,337,201,29,107
2011,Torbay 013E,E01015194,1041,645,396,195,40,161
2011,Torbay 013F,E01015195,1066,686,380,190,51,139
2011,Torbay 013G,E01015196,1019,623,396,120,54,222
2011,Torbay 014A,E01015229,872,560,312,185,30,97
2011,Torbay 014B,E01015231,1171,699,472,163,45,264
2011,Torbay 014C,E01015232,1221,839,382,191,38,153
2011,Torbay 014D,E01015233,1033,670,363,168,29,166
2011,Torbay 014E,E01015234,922,621,301,142,32,127
2011,Torbay 014F,E01015235,1161,672,489,326,19,144
2011,Torbay 015A,E01015219,953,569,384,237,38,109
2011,Torbay 015B,E01015220,1004,644,360,243,38,79
2011,Torbay 015C,E01015221,1044,709,335,204,47,84
2011,Torbay 015D,E01015222,1019,656,363,264,29,70
2011,Torbay 015E,E01015223,988,729,259,157,43,59
2011,Torbay 016A,E01015197,1008,593,415,318,38,59
2011,Torbay 016B,E01015198,1102,626,476,381,24,71
2011,Torbay 016C,E01015199,892,474,418,345,20,53
2011,Torbay 016D,E01015200,690,446,244,161,24,59
2011,Torbay 016E,E01015201,952,606,346,246,23,77
2011,Torbay 017A,E01015183,970,596,374,246,20,108
2011,Torbay 017B,E01015184,899,458,441,348,18,75
2011,Torbay 017C,E01015185,945,566,379,249,25,105
2011,Torbay 017D,E01015186,1027,664,363,190,35,138
2011,Torbay 017E,E01015187,978,561,417,323,27,67
2011,Torbay 017F,E01015188,1040,622,418,294,37,87
2011,Torbay 017G,E01015189,891,556,335,198,25,112
2011,Torbay 018A,E01015244,1045,638,407,278,29,100
2011,Torbay 018B,E01015245,949,510,439,252,35,152
2011,Torbay 018C,E01015246,955,557,398,266,32,100
2011,Torbay 018D,E01015247,1224,777,447,235,52,160
2011,Torbay 018E,E01015248,1068,713,355,200,39,116
2011,Torbay 019E,E01015207,1151,839,312,160,42,110
2011,Torbay 019F,E01015208,1280,772,508,397,34,77
2011,Torbay 019A,E01015209,969,653,316,166,34,116
2011,Torbay 019B,E01015210,1059,720,339,147,52,140
2011,Torbay 019G,E01015211,1018,708,310,210,32,68
2011,Torbay 019C,E01015212,1027,750,277,134,33,110
2011,Torbay 019D,E01015213,1019,731,288,148,42,98
2011,Wiltshire 012A,E01031841,1269,948,321,206,35,80
2011,Wiltshire 012B,E01031868,1330,1039,291,159,41,91
2011,Wiltshire 012C,E01031873,1365,1024,341,204,37,100
2011,Wiltshire 012D,E01031874,1102,790,312,187,44,81
2011,Wiltshire 012E,E01031884,1190,845,345,210,44,91
2011,Wiltshire 019A,E01031861,1695,1281,414,249,48,117
2011,Wiltshire 019B,E01031862,1134,832,302,143,32,127
2011,Wiltshire 019C,E01031863,869,638,231,154,26,51
2011,Wiltshire 019D,E01031864,966,702,264,169,42,53
2011,Wiltshire 019E,E01031865,1255,584,671,155,435,81
2011,Wiltshire 024A,E01031866,1188,878,310,168,42,100
2011,Wiltshire 024B,E01031869,1303,908,395,208,40,147
2011,Wiltshire 024C,E01031870,1298,943,355,205,34,116
2011,Wiltshire 024D,E01031871,1195,879,316,177,30,109
2011,Wiltshire 025A,E01031850,1361,1010,351,239,30,82
2011,Wiltshire 025B,E01031851,1092,811,281,140,21,120
2011,Wiltshire 025C,E01031852,1441,1072,369,240,34,95
2011,Wiltshire 025E,E01032688,911,732,179,84,31,64
2011,Wiltshire 025F,E01032689,967,691,276,164,34,78
2011,Wiltshire 025G,E01032692,877,728,149,72,14,63
2011,Wiltshire 025H,E01032693,967,753,214,100,26,88
2011,Wiltshire 026A,E01031853,1104,800,304,204,29,71
2011,Wiltshire 026B,E01031854,1288,901,387,210,37,140
2011,Wiltshire 026C,E01031855,1042,703,339,229,28,82
2011,Wiltshire 026D,E01031856,1086,707,379,220,29,130
2011,Wiltshire 028A,E01031845,1200,859,341,201,33,107
2011,Wiltshire 028B,E01031846,1224,904,320,196,40,84
2011,Wiltshire 028C,E01031848,1689,1078,611,246,51,314
2011,Wiltshire 028D,E01031872,1170,786,384,232,39,113
2011,Wiltshire 028E,E01031876,1078,739,339,211,39,89
2011,Wiltshire 029A,E01031843,1253,903,350,188,37,125
2011,Wiltshire 029B,E01031847,1283,949,334,199,45,90
2011,Wiltshire 029C,E01031849,1267,980,287,156,34,97
2011,Wiltshire 029D,E01031877,1326,953,373,208,33,132
2011,Wiltshire 034A,E01031844,1435,1081,354,206,40,108
2011,Wiltshire 034B,E01031857,1117,866,251,130,44,77
2011,Wiltshire 034C,E01031858,1475,995,480,185,218,77
2011,Wiltshire 034D,E01031883,1295,851,444,318,33,93
2011,Wiltshire 038A,E01031842,1384,1019,365,211,40,114
2011,Wiltshire 038B,E01031867,1405,1093,312,173,35,104
2011,Wiltshire 038C,E01031882,1489,1081,408,227,34,147
2011,Wiltshire 041A,E01031859,1189,865,324,142,35,147
2011,Wiltshire 041B,E01031860,1125,842,283,161,25,97
2011,Wiltshire 041C,E01031878,1951,1683,268,97,33,138
2011,Wiltshire 041D,E01031879,1559,1331,228,14,22,192
2011,Wiltshire 041E,E01031880,3190,2909,281,35,44,202
2011,Wiltshire 041G,E01032697,1024,825,199,25,37,137
2011,Wiltshire 041H,E01032698,1178,899,279,116,27,136
2011,Wiltshire 001A,E01031887,1264,903,361,233,40,88
2011,Wiltshire 001B,E01031934,1295,941,354,222,40,92
2011,Wiltshire 001C,E01031935,1289,939,350,226,35,89
2011,Wiltshire 001D,E01031936,1045,736,309,161,36,112
2011,Wiltshire 002A,E01031885,1158,819,339,193,52,94
2011,Wiltshire 002B,E01031947,1171,816,355,186,45,124
2011,Wiltshire 002C,E01031948,1508,1198,310,160,46,104
2011,Wiltshire 002D,E01031949,1336,1027,309,202,29,78
2011,Wiltshire 003A,E01031954,997,722,275,179,28,68
2011,Wiltshire 003B,E01031955,1114,805,309,207,25,77
2011,Wiltshire 003C,E01031956,863,592,271,135,27,109
2011,Wiltshire 003D,E01031962,955,681,274,203,22,49
2011,Wiltshire 004A,E01031886,1079,787,292,195,33,64
2011,Wiltshire 004B,E01031892,1011,708,303,186,27,90
2011,Wiltshire 004C,E01031893,1155,888,267,178,29,60
2011,Wiltshire 004D,E01031894,1109,805,304,190,30,84
2011,Wiltshire 005A,E01031957,1040,763,277,150,36,91
2011,Wiltshire 005B,E01031958,993,736,257,159,34,64
2011,Wiltshire 005C,E01031959,1126,779,347,234,28,85
2011,Wiltshire 005D,E01031960,985,754,231,112,34,85
2011,Wiltshire 006A,E01031963,1249,833,416,185,58,173
2011,Wiltshire 006B,E01031964,1310,954,356,238,35,83
2011,Wiltshire 006C,E01031967,1354,1013,341,178,47,116
2011,Wiltshire 006D,E01031969,1158,899,259,143,53,63
2011,Wiltshire 007B,E01031944,842,658,184,114,28,42
2011,Wiltshire 007D,E01031946,1540,1382,158,11,32,115
2011,Wiltshire 007E,E01031961,1005,737,268,172,25,71
2011,Wiltshire 007F,E01031965,1064,736,328,211,35,82
2011,Wiltshire 007G,E01031966,1126,789,337,240,28,69
2011,Wiltshire 007H,E01031968,1218,915,303,204,39,60
2011,Wiltshire 007I,E01032699,1694,1233,461,287,41,133
2011,Wiltshire 008A,E01031939,1604,1130,474,264,65,145
2011,Wiltshire 008B,E01031940,1601,1169,432,248,58,126
2011,Wiltshire 008C,E01031950,1029,791,238,134,39,65
2011,Wiltshire 008D,E01031951,1078,857,221,113,24,84
2011,Wiltshire 009A,E01031907,1814,1490,324,160,83,81
2011,Wiltshire 009B,E01031910,1085,832,253,105,36,112
2011,Wiltshire 009C,E01031914,870,615,255,88,42,125
2011,Wiltshire 009D,E01031915,968,732,236,139,33,64
2011,Wiltshire 009E,E01031919,1095,772,323,194,48,81
2011,Wiltshire 009F,E01031920,922,769,153,77,30,46
2011,Wiltshire 010A,E01031905,1088,884,204,87,46,71
2011,Wiltshire 010B,E01031906,1120,957,163,82,28,53
2011,Wiltshire 010C,E01031908,1184,897,287,120,45,122
2011,Wiltshire 010D,E01031909,950,688,262,185,27,50
2011,Wiltshire 010E,E01031925,781,564,217,108,21,88
2011,Wiltshire 010F,E01031926,1077,804,273,156,33,84
2011,Wiltshire 010G,E01031927,992,723,269,196,32,41
2011,Wiltshire 011A,E01031911,941,675,266,102,39,125
2011,Wiltshire 011B,E01031912,1021,778,243,100,30,113
2011,Wiltshire 011C,E01031913,998,756,242,132,27,83
2011,Wiltshire 011D,E01031917,1073,790,283,118,42,123
2011,Wiltshire 011E,E01031918,1680,1152,528,356,43,129
2011,Wiltshire 011F,E01031928,956,646,310,140,24,146
2011,Wiltshire 013A,E01031891,1679,1221,458,273,65,120
2011,Wiltshire 013B,E01031904,1522,1083,439,242,61,136
2011,Wiltshire 013C,E01031937,808,589,219,127,28,64
2011,Wiltshire 013D,E01031938,1019,783,236,135,22,79
2011,Wiltshire 014A,E01031916,931,665,266,124,38,104
2011,Wiltshire 014B,E01031921,1059,890,169,59,43,67
2011,Wiltshire 014C,E01031922,1009,851,158,63,27,68
2011,Wiltshire 014D,E01031923,1037,834,203,105,43,55
2011,Wiltshire 014E,E01031924,1238,1056,182,68,47,67
2011,Wiltshire 015A,E01031895,1082,778,304,149,40,115
2011,Wiltshire 015B,E01031896,826,543,283,122,27,134
2011,Wiltshire 015C,E01031897,1549,1203,346,193,39,114
2011,Wiltshire 015D,E01031898,1247,859,388,132,148,108
2011,Wiltshire 015F,E01032690,1222,1015,207,60,36,111
2011,Wiltshire 015G,E01032691,1087,826,261,126,33,102
2011,Wiltshire 016A,E01031900,1600,1156,444,291,42,111
2011,Wiltshire 016B,E01031901,1055,771,284,130,31,123
2011,Wiltshire 016C,E01031902,880,666,214,103,44,67
2011,Wiltshire 016D,E01031903,1743,1267,476,307,59,110
2011,Wiltshire 017A,E01031888,959,673,286,184,30,72
2011,Wiltshire 017B,E01031889,1352,1042,310,132,39,139
2011,Wiltshire 017C,E01031890,1049,742,307,217,27,63
2011,Wiltshire 017D,E01031929,927,654,273,179,32,62
2011,Wiltshire 017E,E01031930,1240,1096,144,35,21,88
2011,Wiltshire 018A,E01031931,1131,755,376,259,36,81
2011,Wiltshire 018B,E01031932,1035,700,335,233,33,69
2011,Wiltshire 018C,E01031933,1100,810,290,148,38,104
2011,Wiltshire 018D,E01031941,1147,852,295,172,38,85
2011,Wiltshire 018E,E01031942,1072,785,287,150,67,70
2011,Wiltshire 018F,E01031952,1747,1267,480,224,67,189
2011,Wiltshire 018G,E01031953,2118,1634,484,254,68,162
2011,Wiltshire 045B,E01031988,1129,965,164,10,19,135
2011,Wiltshire 045C,E01031998,2162,1917,245,17,25,203
2011,Wiltshire 045D,E01032026,1188,860,328,231,31,66
2011,Wiltshire 045F,E01032696,2362,2003,359,200,45,114
2011,Wiltshire 046A,E01031989,1077,809,268,142,31,95
2011,Wiltshire 046B,E01031996,997,753,244,119,32,93
2011,Wiltshire 046C,E01031997,1102,870,232,139,27,66
2011,Wiltshire 046D,E01031999,1145,859,286,184,31,71
2011,Wiltshire 048A,E01031974,902,627,275,187,15,73
2011,Wiltshire 048B,E01031975,893,605,288,159,39,90
2011,Wiltshire 048C,E01031976,949,768,181,42,37,102
2011,Wiltshire 048D,E01031977,2145,1772,373,158,63,152
2011,Wiltshire 048E,E01031978,1283,1063,220,87,31,102
2011,Wiltshire 048F,E01031979,1520,1165,355,233,29,93
2011,Wiltshire 049A,E01032013,1527,1029,498,260,39,199
2011,Wiltshire 049B,E01032032,1160,843,317,226,28,63
2011,Wiltshire 049C,E01032033,1073,800,273,176,30,67
2011,Wiltshire 049D,E01032034,988,747,241,169,19,53
2011,Wiltshire 050A,E01032010,1488,1039,449,295,37,117
2011,Wiltshire 050B,E01032035,1058,682,376,284,18,74
2011,Wiltshire 050C,E01032036,1069,721,348,216,38,94
2011,Wiltshire 050D,E01032037,1027,693,334,204,15,115
2011,Wiltshire 051A,E01031984,1148,911,237,133,46,58
2011,Wiltshire 051B,E01031985,872,671,201,107,27,67
2011,Wiltshire 051C,E01031986,863,613,250,136,13,101
2011,Wiltshire 051D,E01032017,1025,758,267,187,35,45
2011,Wiltshire 052A,E01031980,1130,880,250,104,32,114
2011,Wiltshire 052B,E01031981,1148,793,355,114,58,183
2011,Wiltshire 052C,E01031982,1065,820,245,134,38,73
2011,Wiltshire 052D,E01031983,1220,882,338,118,28,192
2011,Wiltshire 053A,E01032018,1157,822,335,234,37,64
2011,Wiltshire 053B,E01032019,973,690,283,124,43,116
2011,Wiltshire 053C,E01032020,1069,792,277,173,35,69
2011,Wiltshire 053D,E01032025,1118,857,261,165,21,75
2011,Wiltshire 054A,E01031990,1379,985,394,224,41,129
2011,Wiltshire 054B,E01032004,1639,1135,504,323,41,140
2011,Wiltshire 054C,E01032027,1002,701,301,208,21,72
2011,Wiltshire 054D,E01032038,931,652,279,190,26,63
2011,Wiltshire 054E,E01032039,971,748,223,131,9,83
2011,Wiltshire 054F,E01032040,1033,787,246,138,19,89
2011,Wiltshire 055A,E01032001,1123,868,255,139,30,86
2011,Wiltshire 055B,E01032002,1020,792,228,115,25,88
2011,Wiltshire 055C,E01032003,1105,895,210,120,19,71
2011,Wiltshire 055D,E01032024,1850,1522,328,165,41,122
2011,Wiltshire 056A,E01032014,1243,900,343,131,37,175
2011,Wiltshire 056B,E01032015,1051,807,244,104,36,104
2011,Wiltshire 056C,E01032016,1070,845,225,109,37,79
2011,Wiltshire 056D,E01032021,1182,912,270,132,78,60
2011,Wiltshire 057A,E01032000,1656,1191,465,259,69,137
2011,Wiltshire 057B,E01032011,1789,1377,412,229,45,138
2011,Wiltshire 057C,E01032012,1176,780,396,288,33,75
2011,Wiltshire 058A,E01032008,1040,701,339,185,28,126
2011,Wiltshire 058B,E01032009,1264,855,409,293,40,76
2011,Wiltshire 058C,E01032022,1133,871,262,156,17,89
2011,Wiltshire 059A,E01032005,897,677,220,122,26,72
2011,Wiltshire 059B,E01032006,891,697,194,125,24,45
2011,Wiltshire 059C,E01032007,976,796,180,84,32,64
2011,Wiltshire 059D,E01032023,1235,818,417,156,83,178
2011,Wiltshire 060A,E01031970,1136,854,282,183,35,64
2011,Wiltshire 060B,E01031971,880,644,236,153,25,58
2011,Wiltshire 060C,E01031972,1074,763,311,203,32,76
2011,Wiltshire 060D,E01032041,1376,957,419,286,36,97
2011,Wiltshire 060E,E01032042,1241,905,336,206,50,80
2011,Wiltshire 061A,E01031991,1433,977,456,251,87,118
2011,Wiltshire 061B,E01032029,988,701,287,191,33,63
2011,Wiltshire 061C,E01032030,1072,753,319,174,36,109
2011,Wiltshire 061D,E01032031,754,510,244,161,18,65
2011,Wiltshire 062A,E01031973,1315,903,412,277,39,96
2011,Wiltshire 062B,E01031992,1063,745,318,233,23,62
2011,Wiltshire 062C,E01031993,1013,705,308,230,18,60
2011,Wiltshire 062D,E01031994,946,657,289,181,39,69
2011,Wiltshire 062E,E01031995,1118,831,287,204,19,64
2011,Wiltshire 020A,E01032063,1365,1000,365,216,43,106
2011,Wiltshire 020B,E01032064,934,660,274,107,39,128
2011,Wiltshire 020C,E01032065,1106,802,304,163,40,101
2011,Wiltshire 020D,E01032073,1035,869,166,99,19,48
2011,Wiltshire 020E,E01032074,858,531,327,266,17,44
2011,Wiltshire 021A,E01032043,918,624,294,161,71,62
2011,Wiltshire 021B,E01032044,951,645,306,214,25,67
2011,Wiltshire 021C,E01032057,864,645,219,155,16,48
2011,Wiltshire 021D,E01032070,1140,798,342,216,25,101
2011,Wiltshire 021E,E01032071,1721,1291,430,257,58,115
2011,Wiltshire 021F,E01032072,1483,1197,286,148,53,85
2011,Wiltshire 022A,E01032062,1091,764,327,151,21,155
2011,Wiltshire 022B,E01032066,1075,784,291,154,18,119
2011,Wiltshire 022C,E01032067,1110,776,334,218,26,90
2011,Wiltshire 022D,E01032068,931,644,287,155,30,102
2011,Wiltshire 022E,E01032069,912,711,201,130,30,41
2011,Wiltshire 023A,E01032058,988,723,265,156,37,72
2011,Wiltshire 023B,E01032059,1273,891,382,254,36,92
2011,Wiltshire 023C,E01032060,1035,697,338,230,39,69
2011,Wiltshire 023D,E01032061,838,554,284,204,24,56
2011,Wiltshire 027A,E01032045,1038,727,311,204,48,59
2011,Wiltshire 027B,E01032046,1078,752,326,190,38,98
2011,Wiltshire 027C,E01032047,970,657,313,204,47,62
2011,Wiltshire 027D,E01032048,1207,811,396,245,28,123
2011,Wiltshire 027E,E01032049,1097,751,346,225,34,87
2011,Wiltshire 027F,E01032050,1283,896,387,256,51,80
2011,Wiltshire 030A,E01032077,1254,925,329,212,36,81
2011,Wiltshire 030B,E01032078,2083,1631,452,203,59,190
2011,Wiltshire 030C,E01032079,1044,739,305,194,30,81
2011,Wiltshire 030D,E01032080,1192,922,270,152,42,76
2011,Wiltshire 031A,E01032085,1259,1001,258,127,41,90
2011,Wiltshire 031B,E01032086,1827,1362,465,135,69,261
2011,Wiltshire 031C,E01032087,1539,1062,477,281,42,154
2011,Wiltshire 032A,E01032099,1990,1509,481,256,61,164
2011,Wiltshire 032B,E01032100,1080,773,307,207,35,65
2011,Wiltshire 032C,E01032101,1225,950,275,137,38,100
2011,Wiltshire 032D,E01032102,1089,745,344,245,29,70
2011,Wiltshire 033A,E01032096,1249,786,463,147,78,238
2011,Wiltshire 033B,E01032097,1374,1003,371,244,53,74
2011,Wiltshire 033C,E01032098,1255,891,364,220,47,97
2011,Wiltshire 035A,E01032092,1118,878,240,155,24,61
2011,Wiltshire 035B,E01032093,1293,905,388,148,62,178
2011,Wiltshire 035C,E01032094,1670,1264,406,157,64,185
2011,Wiltshire 035D,E01032095,1229,935,294,173,29,92
2011,Wiltshire 036A,E01032088,1086,771,315,219,36,60
2011,Wiltshire 036B,E01032089,1146,923,223,81,56,86
2011,Wiltshire 036C,E01032090,1052,746,306,179,26,101
2011,Wiltshire 036D,E01032091,899,656,243,133,29,81
2011,Wiltshire 037A,E01032053,1039,712,327,231,32,64
2011,Wiltshire 037B,E01032083,1657,1222,435,284,32,119
2011,Wiltshire 037C,E01032084,1862,1258,604,431,40,133
2011,Wiltshire 039A,E01032052,991,713,278,211,19,48
2011,Wiltshire 039B,E01032054,912,623,289,146,39,104
2011,Wiltshire 039C,E01032055,920,635,285,207,30,48
2011,Wiltshire 039D,E01032056,944,679,265,152,29,84
2011,Wiltshire 039E,E01032121,1138,805,333,240,26,67
2011,Wiltshire 040A,E01032115,1213,868,345,161,38,146
2011,Wiltshire 040B,E01032116,1842,1375,467,263,51,153
2011,Wiltshire 040C,E01032117,1871,1456,415,192,71,152
2011,Wiltshire 040D,E01032118,1043,683,360,128,55,177
2011,Wiltshire 040E,E01032119,1402,1071,331,175,50,106
2011,Wiltshire 040G,E01032694,1148,947,201,57,42,102
2011,Wiltshire 040H,E01032695,1057,739,318,221,24,73
2011,Wiltshire 042A,E01032104,958,679,279,106,43,130
2011,Wiltshire 042B,E01032105,1040,720,320,232,27,61
2011,Wiltshire 042C,E01032107,1004,806,198,16,30,152
2011,Wiltshire 042D,E01032108,882,611,271,178,26,67
2011,Wiltshire 043A,E01032110,1161,820,341,239,26,76
2011,Wiltshire 043B,E01032111,924,643,281,157,25,99
2011,Wiltshire 043C,E01032112,1091,913,178,98,34,46
2011,Wiltshire 043D,E01032113,1030,776,254,145,24,85
2011,Wiltshire 044A,E01032103,1238,910,328,204,29,95
2011,Wiltshire 044B,E01032106,1008,670,338,262,21,55
2011,Wiltshire 044C,E01032109,1088,817,271,156,25,90
2011,Wiltshire 044D,E01032114,1055,712,343,140,119,84
2011,Wiltshire 047A,E01032051,988,676,312,214,35,63
2011,Wiltshire 047B,E01032075,982,691,291,187,31,73
2011,Wiltshire 047C,E01032076,886,616,270,167,26,77
2011,Wiltshire 047D,E01032081,909,634,275,168,34,73
2011,Wiltshire 047E,E01032082,910,664,246,149,26,71
2011,East Devon 001A,E01019902,1352,914,438,324,28,86
2011,East Devon 001B,E01019938,1644,1175,469,317,38,114
2011,East Devon 001C,E01019967,951,640,311,223,26,62
2011,East Devon 002A,E01019927,849,619,230,119,23,88
2011,East Devon 002B,E01019932,1196,827,369,216,32,121
2011,East Devon 002C,E01019933,874,601,273,169,20,84
2011,East Devon 002D,E01019934,1271,815,456,339,34,83
2011,East Devon 003A,E01019928,1033,786,247,139,37,71
2011,East Devon 003B,E01019929,1044,799,245,156,24,65
2011,East Devon 003C,E01019930,929,626,303,207,22,74
2011,East Devon 003D,E01019931,916,621,295,210,30,55
2011,East Devon 004A,E01019925,953,729,224,154,29,41
2011,East Devon 004D,E01019959,811,573,238,152,21,65
2011,East Devon 004E,E01019960,1006,742,264,173,36,55
2011,East Devon 004F,E01019962,1772,1262,510,321,66,123
2011,East Devon 004G,E01032628,1472,1058,414,283,41,90
2011,East Devon 005A,E01019886,1875,1244,631,420,51,160
2011,East Devon 005B,E01019887,964,692,272,161,31,80
2011,East Devon 005C,E01019888,1108,784,324,224,26,74
2011,East Devon 005D,E01019889,1013,693,320,245,23,52
2011,East Devon 005E,E01019966,762,473,289,204,21,64
2011,East Devon 006A,E01019891,1072,817,255,151,44,60
2011,East Devon 006B,E01019892,1100,861,239,147,29,63
2011,East Devon 006C,E01019893,1300,926,374,234,39,101
2011,East Devon 006D,E01019903,1486,1024,462,313,46,103
2011,East Devon 007A,E01019899,915,611,304,200,30,74
2011,East Devon 007B,E01019900,1229,754,475,357,32,86
2011,East Devon 007C,E01019935,885,568,317,240,22,55
2011,East Devon 007D,E01019936,816,470,346,230,34,82
2011,East Devon 007E,E01019961,1829,1146,683,501,68,114
2011,East Devon 008A,E01019939,1024,636,388,284,34,70
2011,East Devon 008B,E01019940,1078,651,427,308,48,71
2011,East Devon 008C,E01019942,1225,857,368,213,45,110
2011,East Devon 008D,E01019943,1106,770,336,229,41,66
2011,East Devon 008E,E01019944,1069,803,266,166,32,68
2011,East Devon 009A,E01019890,1368,914,454,324,36,94
2011,East Devon 009B,E01019901,985,629,356,270,26,60
2011,East Devon 009C,E01019951,1505,846,659,515,47,97
2011,East Devon 010A,E01019946,925,486,439,366,20,53
2011,East Devon 010B,E01019947,1176,770,406,295,25,86
2011,East Devon 010C,E01019948,811,470,341,266,17,58
2011,East Devon 010D,E01019949,895,554,341,268,18,55
2011,East Devon 010E,E01019950,838,494,344,246,23,75
2011,East Devon 011A,E01019952,1143,725,418,321,27,70
2011,East Devon 011B,E01019953,1018,574,444,346,26,72
2011,East Devon 011C,E01019954,1019,716,303,185,26,92
2011,East Devon 011D,E01019955,1088,671,417,302,29,86
2011,East Devon 012A,E01019956,1050,719,331,241,28,62
2011,East Devon 012B,E01019957,976,465,511,439,21,51
2011,East Devon 012C,E01019958,1134,721,413,331,27,55
2011,East Devon 013A,E01019937,1471,986,485,350,41,94
2011,East Devon 013B,E01019945,1604,1045,559,305,108,146
2011,East Devon 013C,E01019963,1107,809,298,203,34,61
2011,East Devon 014A,E01019898,1717,1160,557,430,52,75
2011,East Devon 014B,E01019964,1578,1326,252,158,23,71
2011,East Devon 014C,E01019965,1213,809,404,258,32,114
2011,East Devon 015A,E01019904,942,669,273,168,26,79
2011,East Devon 015B,E01019905,1511,1053,458,282,57,119
2011,East Devon 015C,E01019906,1050,745,305,201,36,68
2011,East Devon 015D,E01019907,1043,677,366,288,26,52
2011,East Devon 016A,E01019908,1283,1020,263,122,51,90
2011,East Devon 016B,E01019909,1217,807,410,300,34,76
2011,East Devon 016C,E01019910,1190,820,370,237,38,95
2011,East Devon 016D,E01019911,1040,585,455,363,24,68
2011,East Devon 017A,E01019894,853,401,452,380,20,52
2011,East Devon 017B,E01019895,916,523,393,311,20,62
2011,East Devon 017C,E01019896,1027,571,456,365,15,76
2011,East Devon 017D,E01019897,1058,736,322,191,26,105
2011,East Devon 018A,E01019920,1079,791,288,172,30,86
2011,East Devon 018B,E01019921,1105,770,335,226,38,71
2011,East Devon 018C,E01019922,1011,644,367,200,39,128
2011,East Devon 018D,E01019923,878,569,309,179,30,100
2011,East Devon 018E,E01019924,1128,854,274,139,35,100
2011,East Devon 019A,E01019916,1423,1112,311,129,38,144
2011,East Devon 019B,E01019917,1120,825,295,146,36,113
2011,East Devon 019C,E01019918,1438,1058,380,216,32,132
2011,East Devon 019D,E01019919,1279,977,302,149,46,107
2011,East Devon 020A,E01019912,1132,725,407,282,23,102
2011,East Devon 020B,E01019913,898,488,410,335,23,52
2011,East Devon 020C,E01019914,1523,948,575,290,49,236
2011,East Devon 020D,E01019915,1088,631,457,331,38,88
2011,Exeter 001C,E01019998,1045,797,248,124,53,71
2011,Exeter 001D,E01019999,983,625,358,126,185,47
2011,Exeter 001E,E01020001,1046,740,306,200,44,62
2011,Exeter 001F,E01033233,4443,1627,2816,384,2334,98
2011,Exeter 002A,E01019990,968,714,254,104,26,124
2011,Exeter 002B,E01019991,1037,752,285,92,51,142
2011,Exeter 002C,E01019993,917,746,171,102,35,34
2011,Exeter 002D,E01020000,935,619,316,137,57,122
2011,Exeter 002E,E01020007,1333,709,624,39,534,51
2011,Exeter 003A,E01019992,1069,789,280,139,42,99
2011,Exeter 003B,E01020002,1035,707,328,179,26,123
2011,Exeter 003C,E01020003,1099,744,355,235,32,88
2011,Exeter 003D,E01020004,1069,819,250,143,35,72
2011,Exeter 003E,E01020005,1232,821,411,174,58,179
2011,Exeter 004A,E01019997,1367,813,554,69,433,52
2011,Exeter 004B,E01020019,1565,655,910,66,801,43
2011,Exeter 004C,E01020020,1579,789,790,56,668,66
2011,Exeter 004D,E01020021,1443,706,737,101,441,195
2011,Exeter 004E,E01020022,1511,754,757,59,608,90
2011,Exeter 005A,E01019980,1254,995,259,84,47,128
2011,Exeter 005B,E01019982,1266,1018,248,72,64,112
2011,Exeter 005C,E01019983,1121,760,361,248,33,80
2011,Exeter 005D,E01019984,1058,837,221,129,35,57
2011,Exeter 005E,E01019985,986,723,263,90,34,139
2011,Exeter 006A,E01019987,1389,840,549,104,361,84
2011,Exeter 006B,E01019989,848,687,161,71,45,45
2011,Exeter 006C,E01020006,1583,1101,482,119,225,138
2011,Exeter 006D,E01020008,1551,892,659,53,553,53
2011,Exeter 006E,E01020009,1130,883,247,95,101,51
2011,Exeter 007A,E01019986,1061,828,233,146,30,57
2011,Exeter 007B,E01020036,1013,746,267,138,31,98
2011,Exeter 007C,E01020037,947,632,315,136,34,145
2011,Exeter 007D,E01020039,1275,871,404,175,53,176
2011,Exeter 007E,E01020040,973,704,269,155,29,85
2011,Exeter 008A,E01019994,1296,836,460,101,263,96
2011,Exeter 008B,E01019995,1087,666,421,115,131,175
2011,Exeter 008C,E01020016,1861,1123,738,152,361,225
2011,Exeter 008D,E01020017,2163,1194,969,83,767,119
2011,Exeter 008E,E01020018,1666,1101,565,138,277,150
2011,Exeter 009A,E01019996,1087,740,347,86,207,54
2011,Exeter 009B,E01020023,1592,1191,401,225,66,110
2011,Exeter 009C,E01020024,1037,736,301,155,60,86
2011,Exeter 009D,E01020025,1215,949,266,94,103,69
2011,Exeter 010A,E01019975,930,684,246,89,33,124
2011,Exeter 010B,E01020029,1195,959,236,123,32,81
2011,Exeter 010C,E01020030,1383,1111,272,105,44,123
2011,Exeter 010D,E01020031,1169,936,233,110,39,84
2011,Exeter 010E,E01020032,1149,867,282,116,53,113
2011,Exeter 011A,E01020026,1306,961,345,246,31,68
2011,Exeter 011B,E01020027,1217,923,294,169,34,91
2011,Exeter 011D,E01020035,1189,857,332,179,88,65
2011,Exeter 011E,E01020038,1087,826,261,157,38,66
2011,Exeter 011F,E01033232,1095,937,158,57,32,69
2011,Exeter 011G,E01033234,1087,894,193,103,27,63
2011,Exeter 012A,E01019973,1026,753,273,159,25,89
2011,Exeter 012B,E01019974,1052,738,314,193,25,96
2011,Exeter 012C,E01019976,906,625,281,200,29,52
2011,Exeter 012D,E01019977,1054,770,284,170,25,89
2011,Exeter 012E,E01019981,1042,782,260,111,35,114
2011,Exeter 013A,E01019988,953,720,233,136,34,63
2011,Exeter 013B,E01020010,1242,888,354,124,56,174
2011,Exeter 013C,E01020013,987,714,273,118,43,112
2011,Exeter 013D,E01020014,1126,797,329,122,39,168
2011,Exeter 013E,E01020015,1278,867,411,99,62,250
2011,Exeter 014A,E01019968,1090,748,342,242,31,69
2011,Exeter 014B,E01019969,968,736,232,156,16,60
2011,Exeter 014C,E01019970,956,732,224,136,26,62
2011,Exeter 014D,E01019971,1286,1039,247,93,55,99
2011,Exeter 014E,E01019972,1058,869,189,71,25,93
2011,Exeter 015A,E01020011,900,612,288,179,30,79
2011,Exeter 015B,E01020012,1057,794,263,113,26,124
2011,Exeter 015C,E01020033,1074,685,389,256,32,101
2011,Exeter 015E,E01033235,830,592,238,162,30,46
2011,Exeter 015F,E01033236,717,475,242,189,16,37
2011,Mid Devon 001A,E01020046,1176,874,302,182,47,73
2011,Mid Devon 001B,E01020049,988,698,290,190,36,64
2011,Mid Devon 001C,E01020050,1530,1020,510,340,36,134
2011,Mid Devon 001D,E01020077,1177,888,289,170,44,75
2011,Mid Devon 002A,E01020047,1488,1042,446,313,37,96
2011,Mid Devon 002B,E01020051,1318,866,452,348,36,68
2011,Mid Devon 002C,E01020066,1993,1540,453,255,72,126
2011,Mid Devon 002D,E01020080,919,609,310,230,21,59
2011,Mid Devon 003A,E01020063,1722,1190,532,304,49,179
2011,Mid Devon 003B,E01020074,1557,1179,378,256,35,87
2011,Mid Devon 003C,E01020075,1348,979,369,237,43,89
2011,Mid Devon 004A,E01020052,1273,890,383,183,34,166
2011,Mid Devon 004B,E01020053,1015,686,329,191,30,108
2011,Mid Devon 004C,E01020065,1371,914,457,164,155,138
2011,Mid Devon 004D,E01020067,1307,922,385,133,43,209
2011,Mid Devon 005A,E01020048,1539,1145,394,183,49,162
2011,Mid Devon 005B,E01020078,940,670,270,111,19,140
2011,Mid Devon 005C,E01020079,927,623,304,171,18,115
2011,Mid Devon 005D,E01020081,900,611,289,167,29,93
2011,Mid Devon 006A,E01020045,1180,857,323,203,48,72
2011,Mid Devon 006B,E01020059,1511,1124,387,238,45,104
2011,Mid Devon 006C,E01020062,1120,832,288,182,33,73
2011,Mid Devon 006D,E01020064,1258,954,304,182,30,92
2011,Mid Devon 007A,E01020054,1518,1194,324,181,34,109
2011,Mid Devon 007B,E01020055,1349,982,367,187,45,135
2011,Mid Devon 007C,E01020057,1263,920,343,184,31,128
2011,Mid Devon 007D,E01020058,1405,1046,359,229,35,95
2011,Mid Devon 008A,E01020043,1382,963,419,242,45,132
2011,Mid Devon 008B,E01020044,1150,852,298,185,46,67
2011,Mid Devon 008C,E01020056,1517,1144,373,210,46,117
2011,Mid Devon 008D,E01020071,1333,943,390,273,40,77
2011,Mid Devon 009A,E01020072,1234,887,347,208,43,96
2011,Mid Devon 009B,E01020073,1204,798,406,269,30,107
2011,Mid Devon 009C,E01020076,1279,903,376,206,53,117
2011,Mid Devon 009D,E01020082,880,633,247,146,29,72
2011,Mid Devon 010A,E01020068,1113,783,330,221,31,78
2011,Mid Devon 010B,E01020069,1126,807,319,188,40,91
2011,Mid Devon 010C,E01020070,1367,979,388,253,36,99
2011,Mid Devon 010D,E01020083,1706,1274,432,244,53,135
2011,Mid Devon 011A,E01020041,1621,1217,404,182,37,185
2011,Mid Devon 011B,E01020042,1183,890,293,214,21,58
2011,Mid Devon 011C,E01020060,1174,839,335,210,24,101
2011,Mid Devon 011D,E01020061,1486,1051,435,229,67,139
2011,North Devon 001A,E01020111,1002,649,353,150,40,163
2011,North Devon 001B,E01020112,1233,780,453,210,30,213
2011,North Devon 001C,E01020114,910,654,256,132,27,97
2011,North Devon 001D,E01020115,885,618,267,195,15,57
2011,North Devon 002A,E01020099,1022,642,380,255,36,89
2011,North Devon 002B,E01020100,805,551,254,183,21,50
2011,North Devon 002C,E01020101,1072,685,387,250,31,106
2011,North Devon 002D,E01020126,1237,866,371,254,21,96
2011,North Devon 003A,E01020113,1023,680,343,180,26,137
2011,North Devon 003B,E01020116,1211,832,379,200,53,126
2011,North Devon 003C,E01020117,1117,739,378,253,40,85
2011,North Devon 003D,E01020118,967,644,323,148,41,134
2011,North Devon 004A,E01020090,1226,786,440,289,54,97
2011,North Devon 004B,E01020108,1713,1202,511,350,61,100
2011,North Devon 004C,E01020109,1029,718,311,193,43,75
2011,North Devon 005A,E01020089,1634,1215,419,275,51,93
2011,North Devon 005B,E01020091,938,661,277,205,26,46
2011,North Devon 005C,E01020092,977,615,362,268,24,70
2011,North Devon 005D,E01020093,958,696,262,166,32,64
2011,North Devon 005E,E01020110,1930,1497,433,207,39,187
2011,North Devon 006A,E01020088,1516,1072,444,282,51,111
2011,North Devon 006B,E01020120,1335,953,382,253,40,89
2011,North Devon 006C,E01020127,1400,1042,358,238,45,75
2011,North Devon 007A,E01020132,1293,929,364,246,35,83
2011,North Devon 007B,E01020133,1074,787,287,203,23,61
2011,North Devon 007C,E01020134,824,605,219,99,23,97
2011,North Devon 007D,E01020139,1027,725,302,140,41,121
2011,North Devon 008A,E01020094,1256,815,441,206,34,201
2011,North Devon 008B,E01020095,1087,815,272,113,37,122
2011,North Devon 008C,E01020140,863,576,287,192,19,76
2011,North Devon 008D,E01020141,1245,897,348,119,36,193
2011,North Devon 009A,E01020096,1210,892,318,163,19,136
2011,North Devon 009B,E01020123,1042,677,365,210,42,113
2011,North Devon 009C,E01020124,997,677,320,219,25,76
2011,North Devon 009D,E01020125,918,614,304,238,17,49
2011,North Devon 010A,E01020102,1233,990,243,128,35,80
2011,North Devon 010B,E01020103,1025,693,332,117,45,170
2011,North Devon 010C,E01020104,1017,775,242,68,33,141
2011,North Devon 010D,E01020128,921,637,284,185,24,75
2011,North Devon 010E,E01020129,843,576,267,147,34,86
2011,North Devon 010F,E01020130,1138,908,230,86,40,104
2011,North Devon 011A,E01020105,1052,736,316,204,21,91
2011,North Devon 011B,E01020106,829,490,339,272,16,51
2011,North Devon 011C,E01020107,1112,710,402,298,26,78
2011,North Devon 011D,E01020119,1115,722,393,273,26,94
2011,North Devon 012A,E01020084,1032,704,328,200,27,101
2011,North Devon 012B,E01020085,1107,842,265,142,31,92
2011,North Devon 012C,E01020086,1104,732,372,270,30,72
2011,North Devon 012D,E01020121,1427,1024,403,252,48,103
2011,North Devon 012E,E01020122,1272,877,395,271,29,95
2011,North Devon 013A,E01020097,1670,1166,504,328,52,124
2011,North Devon 013B,E01020131,1645,1142,503,257,89,157
2011,North Devon 013C,E01020135,1102,753,349,194,33,122
2011,North Devon 013D,E01020136,1208,858,350,220,31,99
2011,North Devon 013E,E01020137,1111,845,266,140,33,93
2011,North Devon 014A,E01020087,1402,949,453,318,35,100
2011,North Devon 014B,E01020098,1529,1041,488,309,45,134
2011,North Devon 014C,E01020138,1637,1143,494,294,42,158
2011,South Hams 001A,E01020144,1174,965,209,102,31,76
2011,South Hams 001B,E01020145,1587,1164,423,258,48,117
2011,South Hams 001C,E01020146,907,728,179,105,18,56
2011,South Hams 001D,E01020149,887,664,223,139,23,61
2011,South Hams 002A,E01020148,841,565,276,162,27,87
2011,South Hams 002B,E01020157,1753,1178,575,339,73,163
2011,South Hams 002C,E01020160,1379,1020,359,210,52,97
2011,South Hams 002D,E01020176,818,572,246,149,42,55
2011,South Hams 002E,E01020177,942,643,299,164,45,90
2011,South Hams 003A,E01020180,1333,910,423,206,60,157
2011,South Hams 003B,E01020181,1182,758,424,250,48,126
2011,South Hams 003C,E01020182,1095,795,300,121,55,124
2011,South Hams 003D,E01020183,1025,736,289,154,42,93
2011,South Hams 003E,E01020184,1213,787,426,239,51,136
2011,South Hams 004A,E01020153,947,557,390,293,23,74
2011,South Hams 004B,E01020156,1342,869,473,338,39,96
2011,South Hams 004C,E01020170,1566,1019,547,395,54,98
2011,South Hams 004D,E01020188,1464,1029,435,286,46,103
2011,South Hams 005A,E01020161,1686,1144,542,324,60,158
2011,South Hams 005B,E01020162,1257,983,274,161,50,63
2011,South Hams 005C,E01020163,1310,1005,305,182,56,67
2011,South Hams 005D,E01020164,1130,821,309,159,61,89
2011,South Hams 005E,E01020165,1141,925,216,118,33,65
2011,South Hams 005F,E01020166,1081,795,286,178,44,64
2011,South Hams 005G,E01020167,989,756,233,127,42,64
2011,South Hams 006A,E01020142,1613,1173,440,265,48,127
2011,South Hams 006B,E01020143,1696,1202,494,289,73,132
2011,South Hams 006C,E01020150,1220,818,402,252,40,110
2011,South Hams 007A,E01020151,1169,713,456,360,32,64
2011,South Hams 007B,E01020152,1061,717,344,257,22,65
2011,South Hams 007C,E01020154,1211,958,253,97,46,110
2011,South Hams 007D,E01020155,751,519,232,117,14,101
2011,South Hams 008A,E01020147,1477,1002,475,305,42,128
2011,South Hams 008B,E01020158,1202,854,348,212,42,94
2011,South Hams 008C,E01020159,1044,754,290,186,39,65
2011,South Hams 008D,E01020190,1465,917,548,407,37,104
2011,South Hams 009A,E01020171,1343,809,534,417,37,80
2011,South Hams 009B,E01020185,966,585,381,293,30,58
2011,South Hams 009C,E01020186,1077,591,486,390,39,57
2011,South Hams 009D,E01020187,1223,847,376,230,37,109
2011,South Hams 010A,E01020168,1363,858,505,333,31,141
2011,South Hams 010B,E01020169,1669,1265,404,223,43,138
2011,South Hams 010C,E01020189,1438,963,475,261,44,170
2011,South Hams 011A,E01020174,1118,671,447,337,28,82
2011,South Hams 011B,E01020175,1381,816,565,450,26,89
2011,South Hams 011C,E01020178,1331,811,520,405,28,87
2011,South Hams 012A,E01020172,1306,852,454,316,28,110
2011,South Hams 012B,E01020173,1113,711,402,300,24,78
2011,South Hams 012C,E01020179,1331,845,486,386,21,79
2011,Teignbridge 001A,E01020243,892,661,231,161,26,44
2011,Teignbridge 001B,E01020262,948,639,309,213,27,69
2011,Teignbridge 001C,E01020263,1041,652,389,296,21,72
2011,Teignbridge 001D,E01020274,981,716,265,176,36,53
2011,Teignbridge 002A,E01020240,1095,789,306,210,22,74
2011,Teignbridge 002B,E01020241,1290,978,312,207,27,78
2011,Teignbridge 002C,E01020242,1038,780,258,175,39,44
2011,Teignbridge 002D,E01020244,996,701,295,178,31,86
2011,Teignbridge 002E,E01020245,1223,875,348,240,31,77
2011,Teignbridge 003A,E01020205,1044,677,367,261,37,69
2011,Teignbridge 003B,E01020258,1230,896,334,205,51,78
2011,Teignbridge 003C,E01020259,835,623,212,134,29,49
2011,Teignbridge 003D,E01020273,991,641,350,250,23,77
2011,Teignbridge 004A,E01020203,1078,684,394,315,19,60
2011,Teignbridge 004B,E01020206,1065,791,274,173,16,85
2011,Teignbridge 004C,E01020220,1003,692,311,150,37,124
2011,Teignbridge 004D,E01020221,1307,938,369,212,45,112
2011,Teignbridge 004E,E01020222,901,699,202,131,23,48
2011,Teignbridge 004F,E01020223,1318,932,386,244,25,117
2011,Teignbridge 005A,E01020229,1237,744,493,292,34,167
2011,Teignbridge 005B,E01020230,1291,854,437,287,34,116
2011,Teignbridge 005C,E01020231,1010,682,328,203,29,96
2011,Teignbridge 005D,E01020232,1169,797,372,184,61,127
2011,Teignbridge 006A,E01020228,1236,735,501,323,18,160
2011,Teignbridge 006B,E01020233,1219,725,494,387,33,74
2011,Teignbridge 006C,E01020234,1024,700,324,161,45,118
2011,Teignbridge 006D,E01020235,1222,754,468,306,46,116
2011,Teignbridge 007A,E01020202,994,565,429,331,25,73
2011,Teignbridge 007B,E01020204,1142,886,256,106,41,109
2011,Teignbridge 007C,E01020236,905,638,267,187,21,59
2011,Teignbridge 007D,E01020237,1136,841,295,192,35,68
2011,Teignbridge 008A,E01020265,1231,828,403,295,23,85
2011,Teignbridge 008B,E01020266,1286,814,472,262,101,109
2011,Teignbridge 008C,E01020267,1059,691,368,256,36,76
2011,Teignbridge 008D,E01020268,988,555,433,323,26,84
2011,Teignbridge 008E,E01020270,1184,809,375,253,36,86
2011,Teignbridge 009A,E01020250,1161,845,316,227,22,67
2011,Teignbridge 009B,E01020252,962,680,282,154,20,108
2011,Teignbridge 009C,E01020253,1086,884,202,109,28,65
2011,Teignbridge 009D,E01020254,960,694,266,136,35,95
2011,Teignbridge 009E,E01020255,936,647,289,182,22,85
2011,Teignbridge 009F,E01020257,886,654,232,172,26,34
2011,Teignbridge 010A,E01020264,1044,662,382,212,32,138
2011,Teignbridge 010B,E01020269,1302,830,472,305,25,142
2011,Teignbridge 010C,E01020271,1079,788,291,134,39,118
2011,Teignbridge 010D,E01020272,1320,927,393,168,46,179
2011,Teignbridge 011A,E01020200,809,541,268,205,24,39
2011,Teignbridge 011B,E01020201,1013,601,412,337,10,65
2011,Teignbridge 011C,E01020251,1082,825,257,170,21,66
2011,Teignbridge 011D,E01020260,855,517,338,266,20,52
2011,Teignbridge 011E,E01020261,878,557,321,230,25,66
2011,Teignbridge 012A,E01020208,868,618,250,131,24,95
2011,Teignbridge 012B,E01020209,1060,797,263,166,18,79
2011,Teignbridge 012C,E01020210,897,642,255,191,21,43
2011,Teignbridge 012D,E01020219,1517,1139,378,194,50,134
2011,Teignbridge 013A,E01020191,1438,653,785,170,29,586
2011,Teignbridge 013B,E01020194,1068,812,256,168,35,53
2011,Teignbridge 013C,E01020207,785,597,188,122,25,41
2011,Teignbridge 013D,E01020256,979,704,275,158,53,64
2011,Teignbridge 014A,E01020211,1094,742,352,138,32,182
2011,Teignbridge 014B,E01020217,1200,898,302,157,36,109
2011,Teignbridge 014C,E01020218,1102,865,237,93,30,114
2011,Teignbridge 014D,E01020224,928,741,187,82,34,71
2011,Teignbridge 015A,E01020216,1147,812,335,136,43,156
2011,Teignbridge 015B,E01020225,929,698,231,88,29,114
2011,Teignbridge 015C,E01020226,865,602,263,172,34,57
2011,Teignbridge 015D,E01020227,985,700,285,169,30,86
2011,Teignbridge 016A,E01020212,871,621,250,110,21,119
2011,Teignbridge 016B,E01020213,1060,676,384,235,28,121
2011,Teignbridge 016C,E01020214,1091,770,321,223,25,73
2011,Teignbridge 016D,E01020215,1007,702,305,236,23,46
2011,Teignbridge 017A,E01020195,1264,901,363,221,47,95
2011,Teignbridge 017B,E01020196,1219,850,369,198,42,129
2011,Teignbridge 017C,E01020197,923,615,308,207,26,75
2011,Teignbridge 017D,E01020198,1002,711,291,130,36,125
2011,Teignbridge 017E,E01020199,1137,817,320,170,32,118
2011,Teignbridge 018A,E01020246,849,637,212,133,34,45
2011,Teignbridge 018B,E01020247,1134,774,360,187,37,136
2011,Teignbridge 018C,E01020248,1192,836,356,258,32,66
2011,Teignbridge 018D,E01020249,979,623,356,262,37,57
2011,Teignbridge 019A,E01020192,1108,744,364,268,40,56
2011,Teignbridge 019B,E01020193,1067,747,320,179,45,96
2011,Teignbridge 019C,E01020238,847,552,295,187,32,76
2011,Teignbridge 019D,E01020239,877,615,262,184,30,48
2011,Torridge 001A,E01020275,990,664,326,195,25,106
2011,Torridge 001B,E01020276,1076,632,444,315,22,107
2011,Torridge 001C,E01020297,1079,691,388,222,17,149
2011,Torridge 001D,E01020299,1332,813,519,382,26,111
2011,Torridge 002A,E01020298,1404,837,567,428,24,115
2011,Torridge 002B,E01020300,1230,795,435,312,34,89
2011,Torridge 002C,E01020310,1562,902,660,484,35,141
2011,Torridge 003A,E01020280,1682,1174,508,204,53,251
2011,Torridge 003B,E01020281,1403,959,444,278,72,94
2011,Torridge 003C,E01020282,1122,722,400,224,38,138
2011,Torridge 004A,E01020277,1373,852,521,226,51,244
2011,Torridge 004B,E01020278,1279,889,390,223,55,112
2011,Torridge 004C,E01020279,1722,1232,490,238,51,201
2011,Torridge 004D,E01020283,1003,719,284,189,29,66
2011,Torridge 004E,E01020284,1431,1031,400,193,49,158
2011,Torridge 004F,E01020285,1416,962,454,178,55,221
2011,Torridge 005A,E01020288,1232,835,397,262,45,90
2011,Torridge 005B,E01020292,1054,719,335,206,35,94
2011,Torridge 005C,E01020295,1168,776,392,242,51,99
2011,Torridge 005D,E01020296,1118,738,380,269,36,75
2011,Torridge 006A,E01020304,1220,826,394,233,48,113
2011,Torridge 006B,E01020305,792,559,233,124,21,88
2011,Torridge 006C,E01020306,891,632,259,166,25,68
2011,Torridge 006D,E01020307,1133,793,340,172,51,117
2011,Torridge 007A,E01020287,1143,785,358,236,40,82
2011,Torridge 007B,E01020303,1199,775,424,316,36,72
2011,Torridge 007C,E01020308,1298,917,381,281,28,72
2011,Torridge 007D,E01020311,1535,1006,529,376,25,128
2011,Torridge 008A,E01020291,1196,849,347,207,44,96
2011,Torridge 008B,E01020293,1639,1135,504,314,44,146
2011,Torridge 008C,E01020294,1120,755,365,213,29,123
2011,Torridge 008D,E01020302,1283,881,402,248,39,115
2011,Torridge 008E,E01020309,1280,900,380,227,30,123
2011,Torridge 009A,E01020286,1202,837,365,224,24,117
2011,Torridge 009B,E01020289,1189,757,432,299,42,91
2011,Torridge 009C,E01020290,1237,820,417,295,28,94
2011,Torridge 009D,E01020301,1477,989,488,326,71,91
2011,West Devon 001A,E01020320,1272,812,460,293,34,133
2011,West Devon 001B,E01020321,1639,1135,504,257,56,191
2011,West Devon 001C,E01020322,1497,1028,469,288,57,124
2011,West Devon 001D,E01020326,1483,1099,384,234,30,120
2011,West Devon 002A,E01020327,1299,925,374,242,35,97
2011,West Devon 002B,E01020328,1617,1236,381,177,45,159
2011,West Devon 002C,E01020329,1159,819,340,231,31,78
2011,West Devon 002D,E01020330,1255,883,372,217,23,132
2011,West Devon 003A,E01020318,1035,703,332,235,28,69
2011,West Devon 003B,E01020319,1226,894,332,217,34,81
2011,West Devon 003C,E01020323,1650,976,674,215,51,408
2011,West Devon 003D,E01020339,1261,880,381,225,42,114
2011,West Devon 004A,E01020314,1167,799,368,249,34,85
2011,West Devon 004B,E01020325,1211,893,318,203,39,76
2011,West Devon 004C,E01020331,1146,787,359,240,35,84
2011,West Devon 004D,E01020340,1252,900,352,230,42,80
2011,West Devon 005A,E01020332,1356,959,397,221,43,133
2011,West Devon 005B,E01020333,1396,957,439,287,59,93
2011,West Devon 005C,E01020334,1393,964,429,223,47,159
2011,West Devon 005D,E01020335,1035,595,440,302,39,99
2011,West Devon 005E,E01020336,969,573,396,321,39,36
2011,West Devon 005F,E01020337,935,576,359,179,76,104
2011,West Devon 005G,E01020338,1648,1215,433,265,54,114
2011,West Devon 006A,E01020317,1059,675,384,285,28,71
2011,West Devon 006B,E01020324,1118,767,351,238,35,78
2011,West Devon 006C,E01020341,1184,739,445,328,34,83
2011,West Devon 006D,E01020342,1113,751,362,204,37,121
2011,West Devon 007A,E01020312,1188,739,449,334,34,81
2011,West Devon 007B,E01020313,1014,679,335,182,33,120
2011,West Devon 007C,E01020315,1036,713,323,194,44,85
2011,West Devon 007D,E01020316,1328,872,456,314,54,88
2011,Christchurch 001A,E01020343,1123,764,359,256,34,69
2011,Christchurch 001B,E01020344,1084,843,241,115,42,84
2011,Christchurch 001C,E01020345,882,608,274,177,27,70
2011,Christchurch 001D,E01020365,1112,708,404,300,30,74
2011,Christchurch 002A,E01020351,928,647,281,192,22,67
2011,Christchurch 002B,E01020352,911,663,248,165,27,56
2011,Christchurch 002C,E01020353,1118,736,382,214,48,120
2011,Christchurch 002D,E01020359,897,674,223,108,43,72
2011,Christchurch 002E,E01020366,1436,938,498,379,49,70
2011,Christchurch 003A,E01020349,927,470,457,362,34,61
2011,Christchurch 003B,E01020350,958,461,497,426,17,54
2011,Christchurch 003C,E01020357,1523,1001,522,318,60,144
2011,Christchurch 003D,E01020358,982,575,407,314,28,65
2011,Christchurch 004A,E01020369,856,511,345,271,21,53
2011,Christchurch 004B,E01020370,1080,795,285,197,29,59
2011,Christchurch 004C,E01020371,1026,537,489,404,25,60
2011,Christchurch 004D,E01020372,826,498,328,263,17,48
2011,Christchurch 005A,E01020346,1144,764,380,208,48,124
2011,Christchurch 005B,E01020347,1178,761,417,145,49,223
2011,Christchurch 005C,E01020348,1163,792,371,144,47,180
2011,Christchurch 005D,E01020363,888,644,244,108,27,109
2011,Christchurch 006A,E01020360,1052,786,266,144,49,73
2011,Christchurch 006B,E01020361,1117,839,278,136,35,107
2011,Christchurch 006C,E01020364,1148,779,369,222,33,114
2011,Christchurch 006D,E01020367,1317,912,405,278,55,72
2011,Christchurch 006E,E01020368,1653,1146,507,314,64,129
2011,Christchurch 007A,E01020354,1053,689,364,227,34,103
2011,Christchurch 007B,E01020355,1229,642,587,486,24,77
2011,Christchurch 007C,E01020356,1030,619,411,321,23,67
2011,Christchurch 007D,E01020362,1004,618,386,296,26,64
2011,East Dorset 001A,E01020373,917,709,208,107,30,71
2011,East Dorset 001B,E01020374,1086,761,325,238,23,64
2011,East Dorset 001C,E01020389,1637,1210,427,227,73,127
2011,East Dorset 001D,E01020397,1056,762,294,170,34,90
2011,East Dorset 002A,E01020416,1087,878,209,116,25,68
2011,East Dorset 002B,E01020417,775,577,198,146,14,38
2011,East Dorset 002C,E01020418,942,572,370,299,17,54
2011,East Dorset 002D,E01020419,1266,914,352,256,25,71
2011,East Dorset 002E,E01020420,912,635,277,194,29,54
2011,East Dorset 003A,E01020411,753,535,218,128,15,75
2011,East Dorset 003B,E01020412,1024,753,271,115,33,123
2011,East Dorset 003C,E01020413,1011,721,290,205,17,68
2011,East Dorset 003D,E01020414,1318,938,380,251,37,92
2011,East Dorset 003E,E01020415,1106,744,362,261,34,67
2011,East Dorset 004A,E01020403,1150,661,489,311,66,112
2011,East Dorset 004B,E01020404,1116,680,436,350,33,53
2011,East Dorset 004C,E01020405,1112,686,426,338,19,69
2011,East Dorset 004D,E01020406,1596,873,723,612,22,89
2011,East Dorset 005A,E01020396,788,560,228,148,21,59
2011,East Dorset 005B,E01020398,1719,1236,483,363,42,78
2011,East Dorset 005C,E01020409,933,701,232,143,28,61
2011,East Dorset 005D,E01020410,946,711,235,103,37,95
2011,East Dorset 006A,E01020421,942,626,316,207,22,87
2011,East Dorset 006B,E01020422,990,552,438,316,16,106
2011,East Dorset 006C,E01020423,1037,649,388,295,26,67
2011,East Dorset 006D,E01020424,997,647,350,262,13,75
2011,East Dorset 006E,E01020425,1123,647,476,383,21,72
2011,East Dorset 007A,E01020377,1189,882,307,220,32,55
2011,East Dorset 007B,E01020379,1049,697,352,251,31,70
2011,East Dorset 007C,E01020380,790,536,254,184,30,40
2011,East Dorset 007D,E01020381,895,598,297,208,32,57
2011,East Dorset 008A,E01020390,871,457,414,329,17,68
2011,East Dorset 008B,E01020391,976,593,383,292,18,73
2011,East Dorset 008C,E01020392,938,556,382,287,17,78
2011,East Dorset 008D,E01020393,1116,829,287,60,43,184
2011,East Dorset 008E,E01020394,1143,662,481,328,22,131
2011,East Dorset 009A,E01020375,981,679,302,200,22,80
2011,East Dorset 009B,E01020376,773,536,237,172,22,43
2011,East Dorset 009C,E01020378,1124,834,290,207,27,56
2011,East Dorset 009D,E01020407,834,551,283,215,20,48
2011,East Dorset 009E,E01020408,820,573,247,165,22,60
2011,East Dorset 010A,E01020426,1183,808,375,276,37,62
2011,East Dorset 010B,E01020427,1098,733,365,198,28,139
2011,East Dorset 010C,E01020428,1265,895,370,259,19,92
2011,East Dorset 010D,E01020429,1205,910,295,173,27,95
2011,East Dorset 011A,E01020395,1143,642,501,394,35,72
2011,East Dorset 011B,E01020399,1757,1249,508,344,50,114
2011,East Dorset 011C,E01020400,1139,746,393,278,45,70
2011,East Dorset 011D,E01020401,993,555,438,351,28,59
2011,East Dorset 011E,E01020402,1095,766,329,248,17,64
2011,East Dorset 012A,E01020382,1144,872,272,173,42,57
2011,East Dorset 012B,E01020383,1272,880,392,315,22,55
2011,East Dorset 012C,E01020384,1263,993,270,146,41,83
2011,East Dorset 012D,E01020385,916,682,234,147,27,60
2011,East Dorset 012E,E01020386,870,638,232,147,26,59
2011,East Dorset 012F,E01020387,777,517,260,193,14,53
2011,East Dorset 012G,E01020388,1089,769,320,191,32,97
2011,North Dorset 001A,E01020443,1824,1437,387,157,60,170
2011,North Dorset 001B,E01020447,1205,782,423,299,28,96
2011,North Dorset 001C,E01020463,1151,832,319,218,43,58
2011,North Dorset 001D,E01020464,1017,723,294,203,26,65
2011,North Dorset 002A,E01020440,1432,991,441,322,29,90
2011,North Dorset 002B,E01020450,1656,1241,415,227,60,128
2011,North Dorset 002D,E01020462,1310,907,403,277,36,90
2011,North Dorset 002E,E01033156,1201,971,230,113,27,90
2011,North Dorset 002F,E01033158,937,650,287,189,38,60
2011,North Dorset 003A,E01020454,1442,1039,403,228,48,127
2011,North Dorset 003B,E01020455,1317,1050,267,150,37,80
2011,North Dorset 003C,E01020456,1307,1003,304,149,47,108
2011,North Dorset 003D,E01020457,1050,683,367,238,64,65
2011,North Dorset 004A,E01020433,1324,934,390,267,36,87
2011,North Dorset 004B,E01020434,1248,825,423,291,22,110
2011,North Dorset 004C,E01020449,1428,877,551,367,43,141
2011,North Dorset 004D,E01020458,1530,1104,426,278,55,93
2011,North Dorset 004E,E01020459,1807,1256,551,301,65,185
2011,North Dorset 005A,E01020444,1293,877,416,239,44,133
2011,North Dorset 005B,E01020445,932,566,366,179,120,67
2011,North Dorset 005C,E01020446,1023,656,367,248,35,84
2011,North Dorset 005D,E01020460,1763,1036,727,334,51,342
2011,North Dorset 006A,E01020442,1488,1065,423,289,39,95
2011,North Dorset 006B,E01020452,1719,1030,689,234,321,134
2011,North Dorset 006C,E01020453,1263,888,375,247,34,94
2011,North Dorset 006E,E01033154,1670,1503,167,28,17,122
2011,North Dorset 006F,E01033159,784,575,209,125,21,63
2011,North Dorset 007A,E01020435,1407,1114,293,183,26,84
2011,North Dorset 007B,E01020436,1526,1206,320,176,43,101
2011,North Dorset 007C,E01020437,1357,983,374,221,28,125
2011,North Dorset 007D,E01020438,1397,1013,384,198,49,137
2011,North Dorset 007E,E01020439,1621,1206,415,231,40,144
2011,North Dorset 008A,E01020430,1072,700,372,271,21,80
2011,North Dorset 008B,E01020431,869,515,354,144,143,67
2011,North Dorset 008C,E01020432,930,639,291,198,24,69
2011,North Dorset 008D,E01020441,1382,992,390,253,37,100
2011,North Dorset 008E,E01020448,1458,1009,449,302,39,108
2011,Purbeck 001A,E01020465,1451,1084,367,234,38,95
2011,Purbeck 001B,E01020469,1347,986,361,216,37,108
2011,Purbeck 001C,E01020470,1353,883,470,343,58,69
2011,Purbeck 002A,E01020471,993,737,256,101,42,113
2011,Purbeck 002B,E01020472,998,697,301,170,33,98
2011,Purbeck 002C,E01020473,1084,766,318,206,27,85
2011,Purbeck 002D,E01020474,1234,852,382,284,28,70
2011,Purbeck 002E,E01020475,1477,1066,411,275,41,95
2011,Purbeck 003A,E01020476,910,614,296,198,19,79
2011,Purbeck 003B,E01020477,1098,802,296,173,38,85
2011,Purbeck 003C,E01020485,1004,638,366,238,27,101
2011,Purbeck 003D,E01020486,916,602,314,216,18,80
2011,Purbeck 003E,E01020487,965,707,258,167,42,49
2011,Purbeck 003F,E01020488,1059,731,328,212,30,86
2011,Purbeck 004A,E01020489,1111,781,330,180,26,124
2011,Purbeck 004B,E01020490,1209,855,354,247,20,87
2011,Purbeck 004C,E01020491,1147,812,335,216,24,95
2011,Purbeck 004D,E01020492,812,537,275,182,28,65
2011,Purbeck 004E,E01020493,1830,1464,366,120,60,186
2011,Purbeck 005A,E01020466,1293,840,453,318,29,106
2011,Purbeck 005B,E01020467,1279,856,423,316,22,85
2011,Purbeck 005C,E01020468,1051,678,373,291,19,63
2011,Purbeck 006A,E01020478,753,534,219,146,15,58
2011,Purbeck 006B,E01020479,741,450,291,208,21,62
2011,Purbeck 006C,E01020480,1038,566,472,381,20,71
2011,Purbeck 006D,E01020481,1107,742,365,261,25,79
2011,Purbeck 006E,E01020482,1178,809,369,224,39,106
2011,Purbeck 006F,E01020483,933,649,284,140,50,94
2011,Purbeck 006G,E01020484,1008,662,346,230,33,83
2011,West Dorset 001A,E01020542,922,576,346,252,24,70
2011,West Dorset 001B,E01020543,964,659,305,150,27,128
2011,West Dorset 001C,E01020544,997,626,371,224,92,55
2011,West Dorset 001E,E01020546,1120,516,604,148,405,51
2011,West Dorset 001F,E01020547,826,603,223,140,19,64
2011,West Dorset 001H,E01032642,1451,940,511,380,38,93
2011,West Dorset 002A,E01020497,1347,906,441,296,34,111
2011,West Dorset 002B,E01020508,1452,936,516,326,91,99
2011,West Dorset 002C,E01020541,1444,1017,427,289,32,106
2011,West Dorset 002D,E01020550,1128,730,398,282,45,71
2011,West Dorset 003A,E01020494,799,582,217,135,30,52
2011,West Dorset 003B,E01020495,945,593,352,247,19,86
2011,West Dorset 003C,E01020496,1070,614,456,311,22,123
2011,West Dorset 003D,E01020506,1273,835,438,299,28,111
2011,West Dorset 003E,E01020530,1374,942,432,293,39,100
2011,West Dorset 003F,E01020534,1534,1097,437,265,36,136
2011,West Dorset 004A,E01020509,1958,1357,601,415,75,111
2011,West Dorset 004B,E01020510,1383,946,437,293,38,106
2011,West Dorset 004C,E01020529,1646,1186,460,316,44,100
2011,West Dorset 004D,E01020539,1483,1043,440,290,42,108
2011,West Dorset 004E,E01020540,1763,1271,492,326,52,114
2011,West Dorset 005A,E01020511,1135,648,487,369,33,85
2011,West Dorset 005B,E01020532,1140,631,509,412,26,71
2011,West Dorset 005C,E01020533,1390,908,482,310,47,125
2011,West Dorset 005D,E01020535,1265,824,441,335,24,82
2011,West Dorset 006A,E01020498,1406,942,464,301,35,128
2011,West Dorset 006B,E01020499,985,681,304,141,27,136
2011,West Dorset 006C,E01020500,1152,805,347,213,29,105
2011,West Dorset 006D,E01020501,975,637,338,240,17,81
2011,West Dorset 007A,E01020507,1362,826,536,422,24,90
2011,West Dorset 007B,E01020517,1298,831,467,368,29,70
2011,West Dorset 007C,E01020531,1238,824,414,291,43,80
2011,West Dorset 007D,E01020536,1499,1039,460,298,41,121
2011,West Dorset 008A,E01020502,1188,801,387,197,35,155
2011,West Dorset 008B,E01020503,1219,858,361,228,27,106
2011,West Dorset 008C,E01020504,1595,976,619,490,34,95
2011,West Dorset 009C,E01020526,942,657,285,183,30,72
2011,West Dorset 009D,E01020527,1078,842,236,119,44,73
2011,West Dorset 009E,E01020528,1384,977,407,225,28,154
2011,West Dorset 009F,E01032641,1148,803,345,183,54,108
2011,West Dorset 009G,E01032643,1310,922,388,155,45,188
2011,West Dorset 009H,E01032644,673,494,179,118,13,48
2011,West Dorset 009I,E01032645,703,468,235,119,25,91
2011,West Dorset 010A,E01020518,1095,764,331,177,26,128
2011,West Dorset 010B,E01020519,1223,892,331,190,38,103
2011,West Dorset 010C,E01020520,1034,717,317,225,19,73
2011,West Dorset 010D,E01020523,949,748,201,120,39,42
2011,West Dorset 010E,E01020524,1047,703,344,241,24,79
2011,West Dorset 010F,E01020525,902,632,270,186,27,57
2011,West Dorset 011A,E01020505,1364,960,404,290,37,77
2011,West Dorset 011B,E01020537,1457,1016,441,313,26,102
2011,West Dorset 011C,E01020538,1356,920,436,287,36,113
2011,West Dorset 011D,E01020549,1516,1063,453,314,36,103
2011,West Dorset 012A,E01020512,1535,1034,501,365,33,103
2011,West Dorset 012B,E01020513,1051,750,301,212,18,71
2011,West Dorset 012C,E01020514,930,683,247,161,22,64
2011,West Dorset 012D,E01020515,841,597,244,176,21,47
2011,West Dorset 012E,E01020516,1095,718,377,266,19,92
2011,Weymouth and Portland 001A,E01020551,1401,1004,397,188,46,163
2011,Weymouth and Portland 001B,E01020552,1281,823,458,163,46,249
2011,Weymouth and Portland 001C,E01020570,1182,806,376,239,35,102
2011,Weymouth and Portland 001D,E01020571,1514,1096,418,204,52,162
2011,Weymouth and Portland 002A,E01020557,1044,611,433,378,19,36
2011,Weymouth and Portland 002B,E01020558,1243,760,483,367,38,78
2011,Weymouth and Portland 002C,E01020559,1129,619,510,427,26,57
2011,Weymouth and Portland 002D,E01020560,1449,960,489,347,51,91
2011,Weymouth and Portland 002E,E01020561,1228,913,315,175,46,94
2011,Weymouth and Portland 003A,E01020574,1377,924,453,250,40,163
2011,Weymouth and Portland 003B,E01020575,1182,723,459,212,47,200
2011,Weymouth and Portland 003C,E01020576,1236,779,457,366,27,64
2011,Weymouth and Portland 003D,E01020579,1389,919,470,303,49,118
2011,Weymouth and Portland 003E,E01020580,1044,717,327,227,42,58
2011,Weymouth and Portland 004A,E01020553,1010,717,293,97,41,155
2011,Weymouth and Portland 004B,E01020554,1429,1030,399,157,33,209
2011,Weymouth and Portland 004C,E01020555,1086,795,291,126,26,139
2011,Weymouth and Portland 004D,E01020556,1094,702,392,201,33,158
2011,Weymouth and Portland 004E,E01020581,1531,966,565,375,51,139
2011,Weymouth and Portland 004F,E01020582,1136,724,412,190,35,187
2011,Weymouth and Portland 005A,E01020572,1493,1139,354,161,54,139
2011,Weymouth and Portland 005B,E01020573,1350,909,441,205,48,188
2011,Weymouth and Portland 005C,E01020577,1153,837,316,152,44,120
2011,Weymouth and Portland 005D,E01020578,1447,937,510,307,45,158
2011,Weymouth and Portland 006A,E01020583,1417,945,472,299,37,136
2011,Weymouth and Portland 006B,E01020584,1275,907,368,191,50,127
2011,Weymouth and Portland 006C,E01020585,1082,736,346,159,53,134
2011,Weymouth and Portland 007A,E01020586,942,646,296,178,39,79
2011,Weymouth and Portland 007B,E01020587,1015,699,316,181,28,107
2011,Weymouth and Portland 007C,E01020588,969,684,285,205,21,59
2011,Weymouth and Portland 007D,E01020589,1083,738,345,201,33,111
2011,Weymouth and Portland 008A,E01020563,1310,688,622,172,30,420
2011,Weymouth and Portland 008D,E01020569,1012,640,372,140,35,197
2011,Weymouth and Portland 008E,E01033200,2068,1291,777,227,68,482
2011,Weymouth and Portland 009A,E01020562,1456,1063,393,243,30,120
2011,Weymouth and Portland 009B,E01020564,1154,803,351,141,34,176
2011,Weymouth and Portland 009C,E01020565,1082,769,313,201,20,92
2011,Weymouth and Portland 009D,E01020566,1578,1084,494,339,32,123
2011,Cheltenham 001A,E01022163,1186,929,257,128,39,90
2011,Cheltenham 001B,E01022164,1053,739,314,90,70,154
2011,Cheltenham 001C,E01022165,1154,864,290,180,26,84
2011,Cheltenham 001D,E01022166,1023,764,259,153,33,73
2011,Cheltenham 002A,E01022143,1069,712,357,268,33,56
2011,Cheltenham 002B,E01022144,785,513,272,190,24,58
2011,Cheltenham 002C,E01022145,864,635,229,154,24,51
2011,Cheltenham 002D,E01022146,939,604,335,256,37,42
2011,Cheltenham 003A,E01022122,905,597,308,101,43,164
2011,Cheltenham 003B,E01022160,1481,1097,384,115,65,204
2011,Cheltenham 003C,E01022161,1082,854,228,100,32,96
2011,Cheltenham 003D,E01022162,1156,803,353,221,30,102
2011,Cheltenham 004A,E01022139,982,629,353,205,108,40
2011,Cheltenham 004B,E01022151,1509,971,538,83,340,115
2011,Cheltenham 004C,E01022152,888,549,339,70,123,146
2011,Cheltenham 004D,E01022153,1422,995,427,35,239,153
2011,Cheltenham 004E,E01022154,1681,1131,550,61,387,102
2011,Cheltenham 005A,E01022120,1090,775,315,92,42,181
2011,Cheltenham 005B,E01022121,1214,895,319,64,59,196
2011,Cheltenham 005C,E01022147,1193,808,385,100,47,238
2011,Cheltenham 005D,E01022157,1107,797,310,103,40,167
2011,Cheltenham 005E,E01022159,1047,751,296,118,33,145
2011,Cheltenham 006A,E01022131,889,562,327,135,32,160
2011,Cheltenham 006B,E01022132,1009,702,307,152,23,132
2011,Cheltenham 006C,E01022133,1043,727,316,83,58,175
2011,Cheltenham 006D,E01022134,1172,812,360,164,49,147
2011,Cheltenham 007A,E01022148,1121,835,286,161,33,92
2011,Cheltenham 007B,E01022149,1039,784,255,102,48,105
2011,Cheltenham 007C,E01022150,1146,873,273,113,56,104
2011,Cheltenham 007D,E01022155,1132,810,322,149,83,90
2011,Cheltenham 007E,E01022156,1204,921,283,71,75,137
2011,Cheltenham 007F,E01022158,1916,1504,412,90,191,131
2011,Cheltenham 008A,E01022100,1370,1056,314,139,82,93
2011,Cheltenham 008B,E01022101,1421,1123,298,129,83,86
2011,Cheltenham 008C,E01022102,1592,1340,252,53,83,116
2011,Cheltenham 008D,E01022140,846,623,223,141,34,48
2011,Cheltenham 008E,E01022141,1168,927,241,125,33,83
2011,Cheltenham 008F,E01022142,1242,979,263,105,80,78
2011,Cheltenham 009A,E01022116,1091,685,406,93,259,54
2011,Cheltenham 009B,E01022117,1437,1145,292,125,75,92
2011,Cheltenham 009C,E01022119,997,813,184,79,51,54
2011,Cheltenham 009D,E01022124,970,750,220,96,28,96
2011,Cheltenham 009E,E01022125,917,684,233,113,50,70
2011,Cheltenham 009F,E01022126,1256,1042,214,103,42,69
2011,Cheltenham 009G,E01022127,1483,891,592,82,431,79
2011,Cheltenham 010A,E01022106,1284,943,341,232,41,68
2011,Cheltenham 010B,E01022107,1120,806,314,202,44,68
2011,Cheltenham 010C,E01022108,1346,980,366,252,49,65
2011,Cheltenham 010D,E01022123,1724,1390,334,170,55,109
2011,Cheltenham 011A,E01022135,1145,709,436,183,181,72
2011,Cheltenham 011B,E01022136,1092,798,294,148,70,76
2011,Cheltenham 011C,E01022137,1338,1045,293,142,87,64
2011,Cheltenham 011D,E01022138,1361,954,407,196,143,68
2011,Cheltenham 011E,E01022174,959,678,281,196,41,44
2011,Cheltenham 012A,E01022103,1764,1354,410,218,69,123
2011,Cheltenham 012B,E01022104,1179,869,310,160,50,100
2011,Cheltenham 012C,E01022105,985,706,279,184,37,58
2011,Cheltenham 012D,E01022109,1005,744,261,185,40,36
2011,Cheltenham 012E,E01022110,923,706,217,121,37,59
2011,Cheltenham 012F,E01022111,942,717,225,127,37,61
2011,Cheltenham 012G,E01022112,887,667,220,129,39,52
2011,Cheltenham 013A,E01022167,868,607,261,206,18,37
2011,Cheltenham 013B,E01022168,782,539,243,174,21,48
2011,Cheltenham 013C,E01022169,1077,828,249,143,38,68
2011,Cheltenham 013D,E01022170,1070,837,233,129,39,65
2011,Cheltenham 013E,E01022171,1030,846,184,74,52,58
2011,Cheltenham 013F,E01022172,972,654,318,248,28,42
2011,Cheltenham 013G,E01022173,962,677,285,152,32,101
2011,Cheltenham 014A,E01022113,1094,697,397,281,43,73
2011,Cheltenham 014B,E01022114,1034,689,345,244,40,61
2011,Cheltenham 014C,E01022115,1230,907,323,207,34,82
2011,Cheltenham 014D,E01022118,983,754,229,112,57,60
2011,Cheltenham 015A,E01022128,1108,778,330,232,40,58
2011,Cheltenham 015B,E01022129,1412,990,422,245,53,124
2011,Cheltenham 015C,E01022130,1123,894,229,134,34,61
2011,Cotswold 001A,E01022179,1464,972,492,308,47,137
2011,Cotswold 001B,E01022182,1065,724,341,234,31,76
2011,Cotswold 001C,E01022183,1022,677,345,241,32,72
2011,Cotswold 001D,E01022184,1057,737,320,210,31,79
2011,Cotswold 001E,E01022185,977,698,279,190,28,61
2011,Cotswold 002A,E01022177,1414,1017,397,256,48,93
2011,Cotswold 002B,E01022178,964,674,290,177,27,86
2011,Cotswold 002C,E01022205,1314,967,347,215,35,97
2011,Cotswold 002D,E01022211,1244,884,360,213,36,111
2011,Cotswold 002E,E01022212,1191,866,325,214,28,83
2011,Cotswold 003A,E01022180,1479,1089,390,234,45,111
2011,Cotswold 003B,E01022181,1095,716,379,277,30,72
2011,Cotswold 003C,E01022214,1538,1194,344,178,52,114
2011,Cotswold 003D,E01022222,1459,1069,390,253,39,98
2011,Cotswold 004A,E01022186,1244,910,334,186,41,107
2011,Cotswold 004B,E01022187,1441,953,488,190,189,109
2011,Cotswold 004C,E01022201,1341,997,344,187,58,99
2011,Cotswold 004D,E01022216,1382,1029,353,209,54,90
2011,Cotswold 005A,E01022175,1423,996,427,240,52,135
2011,Cotswold 005B,E01022207,1319,930,389,236,38,115
2011,Cotswold 005C,E01022213,1305,951,354,239,33,82
2011,Cotswold 005D,E01022215,1337,1006,331,199,32,100
2011,Cotswold 006A,E01022188,981,714,267,118,55,94
2011,Cotswold 006B,E01022189,989,793,196,117,43,36
2011,Cotswold 006C,E01022190,1049,829,220,86,57,77
2011,Cotswold 006D,E01022196,1214,904,310,189,46,75
2011,Cotswold 006E,E01022197,1380,1021,359,223,56,80
2011,Cotswold 007A,E01022194,1104,784,320,170,72,78
2011,Cotswold 007B,E01022195,1198,687,511,167,291,53
2011,Cotswold 007C,E01022199,1326,964,362,173,100,89
2011,Cotswold 007D,E01022200,866,620,246,118,24,104
2011,Cotswold 008A,E01022191,1052,819,233,101,65,67
2011,Cotswold 008B,E01022192,978,658,320,113,99,108
2011,Cotswold 008C,E01022193,777,531,246,159,55,32
2011,Cotswold 008D,E01022198,993,756,237,109,56,72
2011,Cotswold 008E,E01022225,1274,891,383,208,53,122
2011,Cotswold 009A,E01022202,793,567,226,151,26,49
2011,Cotswold 009B,E01022203,943,659,284,194,26,64
2011,Cotswold 009C,E01022204,1059,777,282,155,41,86
2011,Cotswold 009D,E01022208,1109,779,330,233,43,54
2011,Cotswold 009E,E01022209,857,626,231,125,38,68
2011,Cotswold 009F,E01022210,918,568,350,242,33,75
2011,Cotswold 010A,E01022221,1389,1023,366,201,57,108
2011,Cotswold 010B,E01022223,1756,1365,391,234,53,104
2011,Cotswold 010C,E01022224,1181,830,351,222,47,82
2011,Cotswold 011A,E01022176,1471,1071,400,191,62,147
2011,Cotswold 011B,E01022206,1440,1075,365,209,49,107
2011,Cotswold 011C,E01022217,955,721,234,151,20,63
2011,Cotswold 011D,E01022218,925,664,261,127,41,93
2011,Cotswold 011E,E01022219,894,658,236,164,24,48
2011,Cotswold 011F,E01022220,1129,796,333,226,28,79
2011,Forest of Dean 001A,E01022233,1421,1026,395,262,52,81
2011,Forest of Dean 001B,E01022235,1287,870,417,284,43,90
2011,Forest of Dean 001C,E01022247,2089,1209,880,217,595,68
2011,Forest of Dean 001D,E01022270,1368,948,420,259,57,104
2011,Forest of Dean 001E,E01022271,1258,843,415,293,46,76
2011,Forest of Dean 002A,E01022261,1349,968,381,215,48,118
2011,Forest of Dean 002B,E01022262,1370,1013,357,218,39,100
2011,Forest of Dean 002C,E01022267,1194,815,379,245,42,92
2011,Forest of Dean 003A,E01022251,1028,710,318,154,41,123
2011,Forest of Dean 003B,E01022252,1293,913,380,248,44,88
2011,Forest of Dean 003C,E01022258,769,534,235,118,26,91
2011,Forest of Dean 003D,E01022259,1238,893,345,223,51,71
2011,Forest of Dean 003E,E01022260,1331,876,455,239,56,160
2011,Forest of Dean 004A,E01022236,1544,1117,427,223,69,135
2011,Forest of Dean 004B,E01022237,1073,721,352,145,46,161
2011,Forest of Dean 004C,E01022238,873,563,310,142,26,142
2011,Forest of Dean 004D,E01022239,1209,864,345,190,46,109
2011,Forest of Dean 004E,E01022240,1548,1103,445,215,44,186
2011,Forest of Dean 004F,E01022249,1490,1004,486,308,36,142
2011,Forest of Dean 004G,E01022250,1325,878,447,249,32,166
2011,Forest of Dean 005A,E01022228,1283,886,397,217,47,133
2011,Forest of Dean 005B,E01022230,1246,867,379,237,47,95
2011,Forest of Dean 005C,E01022265,1248,809,439,245,38,156
2011,Forest of Dean 005D,E01022266,1013,696,317,193,36,88
2011,Forest of Dean 006A,E01022234,1146,765,381,258,39,84
2011,Forest of Dean 006B,E01022253,1252,834,418,261,46,111
2011,Forest of Dean 006C,E01022263,1398,941,457,278,56,123
2011,Forest of Dean 007A,E01022229,1176,836,340,200,34,106
2011,Forest of Dean 007B,E01022241,1134,756,378,224,36,118
2011,Forest of Dean 007C,E01022242,1043,687,356,201,39,116
2011,Forest of Dean 007D,E01022243,888,583,305,143,41,121
2011,Forest of Dean 007E,E01022244,1073,726,347,165,45,137
2011,Forest of Dean 007F,E01022245,997,714,283,123,34,126
2011,Forest of Dean 007G,E01022246,948,661,287,192,25,70
2011,Forest of Dean 008A,E01022231,1187,819,368,193,37,138
2011,Forest of Dean 008B,E01022232,1111,790,321,203,31,87
2011,Forest of Dean 008C,E01022264,1133,764,369,230,44,95
2011,Forest of Dean 008D,E01022268,1179,779,400,247,32,121
2011,Forest of Dean 008E,E01022269,1454,961,493,308,60,125
2011,Forest of Dean 009A,E01022226,1087,774,313,188,34,91
2011,Forest of Dean 009B,E01022227,1149,783,366,242,42,82
2011,Forest of Dean 009C,E01022254,1344,919,425,180,55,190
2011,Forest of Dean 009D,E01022255,1158,885,273,153,45,75
2011,Forest of Dean 009E,E01022256,1097,735,362,196,36,130
2011,Forest of Dean 009F,E01022257,1377,988,389,255,48,86
2011,Forest of Dean 010A,E01022248,1279,883,396,259,48,89
2011,Forest of Dean 010B,E01022272,925,647,278,175,22,81
2011,Forest of Dean 010C,E01022273,953,715,238,118,30,90
2011,Forest of Dean 010D,E01022274,905,650,255,157,35,63
2011,Forest of Dean 010E,E01022275,1101,769,332,213,39,80
2011,Gloucester 001A,E01022313,1259,969,290,192,35,63
2011,Gloucester 001B,E01022315,1092,803,289,182,45,62
2011,Gloucester 001C,E01022316,1186,958,228,134,40,54
2011,Gloucester 001D,E01022317,1132,859,273,166,52,55
2011,Gloucester 001E,E01022318,1308,909,399,213,129,57
2011,Gloucester 002A,E01022309,1151,818,333,137,80,116
2011,Gloucester 002B,E01022310,1311,880,431,178,104,149
2011,Gloucester 002C,E01022311,1366,966,400,130,62,208
2011,Gloucester 002D,E01022312,1766,1203,563,156,203,204
2011,Gloucester 002E,E01022314,1034,721,313,232,32,49
2011,Gloucester 003A,E01022295,989,713,276,177,29,70
2011,Gloucester 003B,E01022296,1028,779,249,122,35,92
2011,Gloucester 003C,E01022297,930,695,235,159,44,32
2011,Gloucester 003D,E01022298,1172,900,272,121,61,90
2011,Gloucester 004A,E01022332,1263,916,347,97,75,175
2011,Gloucester 004B,E01022347,1471,1057,414,82,88,244
2011,Gloucester 004C,E01022348,1954,1487,467,217,100,150
2011,Gloucester 004E,E01032932,898,490,408,166,41,201
2011,Gloucester 004F,E01032937,963,661,302,59,112,131
2011,Gloucester 005A,E01022288,1206,886,320,91,53,176
2011,Gloucester 005B,E01022289,1112,737,375,117,58,200
2011,Gloucester 005C,E01022290,935,635,300,97,45,158
2011,Gloucester 005D,E01022291,1221,800,421,78,75,268
2011,Gloucester 005E,E01022292,1025,696,329,84,63,182
2011,Gloucester 006A,E01022283,1098,755,343,242,35,66
2011,Gloucester 006B,E01022303,999,694,305,191,29,85
2011,Gloucester 006C,E01022304,1103,733,370,275,25,70
2011,Gloucester 006D,E01022305,1007,691,316,235,33,48
2011,Gloucester 006E,E01022308,1016,691,325,237,20,68
2011,Gloucester 007A,E01022278,1196,942,254,155,21,78
2011,Gloucester 007B,E01022279,1088,836,252,143,34,75
2011,Gloucester 007C,E01022282,2033,1688,345,155,74,116
2011,Gloucester 007D,E01022284,947,714,233,112,34,87
2011,Gloucester 007E,E01022285,954,648,306,116,55,135
2011,Gloucester 007F,E01022286,1160,867,293,120,45,128
2011,Gloucester 007G,E01022287,1203,906,297,159,36,102
2011,Gloucester 008A,E01022293,1163,845,318,87,59,172
2011,Gloucester 008B,E01022294,1135,858,277,106,44,127
2011,Gloucester 008C,E01022323,1221,856,365,85,62,218
2011,Gloucester 008D,E01022328,955,684,271,93,37,141
2011,Gloucester 008E,E01022329,1096,734,362,94,53,215
2011,Gloucester 009A,E01022326,963,771,192,65,38,89
2011,Gloucester 009B,E01022327,1179,870,309,108,62,139
2011,Gloucester 009C,E01022330,1056,847,209,93,50,66
2011,Gloucester 009D,E01022331,975,741,234,86,39,109
2011,Gloucester 009E,E01022333,1007,616,391,138,43,210
2011,Gloucester 009F,E01022334,1152,800,352,194,36,122
2011,Gloucester 010A,E01022276,1211,914,297,216,30,51
2011,Gloucester 010B,E01022277,1115,800,315,207,41,67
2011,Gloucester 010C,E01022280,1224,1035,189,67,40,82
2011,Gloucester 010D,E01022281,1342,1055,287,166,58,63
2011,Gloucester 010E,E01022306,1058,850,208,124,26,58
2011,Gloucester 010F,E01022307,1208,1041,167,73,36,58
2011,Gloucester 011A,E01022319,977,657,320,84,28,208
2011,Gloucester 011B,E01022320,1123,827,296,121,34,141
2011,Gloucester 011C,E01022321,1105,835,270,132,37,101
2011,Gloucester 011D,E01022322,917,581,336,157,37,142
2011,Gloucester 011E,E01022324,1065,750,315,126,40,149
2011,Gloucester 011F,E01022325,1005,693,312,178,38,96
2011,Gloucester 012A,E01022343,928,642,286,185,19,82
2011,Gloucester 012B,E01022344,1101,768,333,192,39,102
2011,Gloucester 012C,E01022345,1071,748,323,212,26,85
2011,Gloucester 012D,E01022346,1059,684,375,120,50,205
2011,Gloucester 013A,E01022299,1050,755,295,215,30,50
2011,Gloucester 013B,E01022300,999,664,335,249,22,64
2011,Gloucester 013C,E01022301,1091,812,279,160,36,83
2011,Gloucester 013D,E01022302,1133,780,353,220,42,91
2011,Gloucester 014A,E01022339,1236,1017,219,101,43,75
2011,Gloucester 014B,E01022340,1139,989,150,53,33,64
2011,Gloucester 014C,E01022341,1593,1313,280,126,39,115
2011,Gloucester 014D,E01022342,1271,1124,147,56,33,58
2011,Gloucester 015A,E01022335,1107,887,220,134,27,59
2011,Gloucester 015B,E01022336,852,642,210,138,17,55
2011,Gloucester 015D,E01022338,1007,862,145,55,21,69
2011,Gloucester 015E,E01032933,1060,893,167,24,33,110
2011,Gloucester 015F,E01032934,1087,873,214,114,29,71
2011,Gloucester 015G,E01032935,1121,967,154,27,33,94
2011,Gloucester 015H,E01032936,1209,957,252,18,63,171
2011,Stroud 001A,E01022378,1387,1167,220,118,37,65
2011,Stroud 001B,E01022379,1086,871,215,90,33,92
2011,Stroud 001C,E01022380,1111,850,261,174,25,62
2011,Stroud 001D,E01022412,2070,1513,557,350,74,133
2011,Stroud 002A,E01022354,1572,1088,484,338,49,97
2011,Stroud 002B,E01022390,788,488,300,217,21,62
2011,Stroud 002C,E01022391,1028,652,376,280,38,58
2011,Stroud 002D,E01022392,1121,773,348,215,46,87
2011,Stroud 003A,E01022376,1311,975,336,210,45,81
2011,Stroud 003B,E01022396,1241,942,299,183,38,78
2011,Stroud 003C,E01022397,1367,1055,312,190,43,79
2011,Stroud 003D,E01022398,848,580,268,166,29,73
2011,Stroud 004A,E01022355,1204,896,308,165,50,93
2011,Stroud 004B,E01022356,1670,1350,320,140,56,124
2011,Stroud 004C,E01022357,1276,989,287,193,33,61
2011,Stroud 004D,E01022358,1095,744,351,178,44,129
2011,Stroud 004E,E01022377,1577,1134,443,258,56,129
2011,Stroud 004F,E01022389,1287,949,338,217,59,62
2011,Stroud 005A,E01022400,1325,1004,321,190,35,96
2011,Stroud 005B,E01022401,1037,782,255,131,32,92
2011,Stroud 005C,E01022402,1201,974,227,109,39,79
2011,Stroud 005D,E01022403,972,640,332,184,37,111
2011,Stroud 005E,E01022404,1065,754,311,140,106,65
2011,Stroud 006A,E01022365,1624,1236,388,175,58,155
2011,Stroud 006B,E01022399,1602,1170,432,159,77,196
2011,Stroud 006C,E01022410,1579,1163,416,189,77,150
2011,Stroud 006D,E01022411,1627,1247,380,186,60,134
2011,Stroud 006E,E01022414,1877,1460,417,160,73,184
2011,Stroud 007A,E01022393,1055,717,338,237,28,73
2011,Stroud 007B,E01022394,1171,945,226,87,48,91
2011,Stroud 007C,E01022395,1135,854,281,189,38,54
2011,Stroud 007D,E01022408,805,599,206,129,18,59
2011,Stroud 007E,E01022409,933,714,219,110,44,65
2011,Stroud 008A,E01022366,1226,936,290,197,43,50
2011,Stroud 008B,E01022367,1174,822,352,210,57,85
2011,Stroud 008C,E01022368,1035,742,293,191,46,56
2011,Stroud 008D,E01022369,1209,990,219,95,47,77
2011,Stroud 009A,E01022370,890,650,240,147,33,60
2011,Stroud 009B,E01022371,789,550,239,154,37,48
2011,Stroud 009C,E01022405,1011,694,317,195,27,95
2011,Stroud 009D,E01022406,913,663,250,173,26,51
2011,Stroud 009E,E01022407,1005,723,282,188,28,66
2011,Stroud 010A,E01022350,1506,1024,482,325,48,109
2011,Stroud 010B,E01022382,1055,682,373,237,43,93
2011,Stroud 010C,E01022383,878,567,311,182,34,95
2011,Stroud 010D,E01022384,1028,670,358,216,36,106
2011,Stroud 011A,E01022359,1043,784,259,151,41,67
2011,Stroud 011B,E01022360,1042,724,318,201,31,86
2011,Stroud 011C,E01022361,891,602,289,186,17,86
2011,Stroud 011D,E01022362,843,582,261,172,32,57
2011,Stroud 011E,E01022363,1305,966,339,231,37,71
2011,Stroud 011F,E01022364,795,524,271,137,30,104
2011,Stroud 012A,E01022351,1059,779,280,151,36,93
2011,Stroud 012B,E01022352,981,722,259,184,13,62
2011,Stroud 012C,E01022353,1051,791,260,152,27,81
2011,Stroud 012D,E01022413,1388,1026,362,239,40,83
2011,Stroud 013A,E01022385,1190,841,349,202,55,92
2011,Stroud 013B,E01022386,1188,851,337,197,53,87
2011,Stroud 013C,E01022387,1207,896,311,154,43,114
2011,Stroud 013D,E01022388,1237,895,342,176,50,116
2011,Stroud 014A,E01022372,1285,930,355,213,38,104
2011,Stroud 014B,E01022373,1253,911,342,195,38,109
2011,Stroud 014C,E01022374,1395,1018,377,212,40,125
2011,Stroud 014D,E01022375,897,648,249,64,46,139
2011,Stroud 015A,E01022381,1488,1107,381,213,69,99
2011,Stroud 015B,E01022415,1138,804,334,233,39,62
2011,Stroud 015C,E01022416,1052,752,300,171,31,98
2011,Stroud 015D,E01022417,1268,950,318,218,34,66
2011,Stroud 015E,E01022418,1193,889,304,187,38,79
2011,Tewkesbury 001B,E01022450,1517,1175,342,145,42,155
2011,Tewkesbury 001C,E01022451,1145,881,264,157,24,83
2011,Tewkesbury 001D,E01022452,1092,885,207,110,38,59
2011,Tewkesbury 001E,E01022455,1523,1124,399,282,52,65
2011,Tewkesbury 001F,E01032938,1158,931,227,102,35,90
2011,Tewkesbury 001G,E01032939,1137,931,206,87,50,69
2011,Tewkesbury 001H,E01032940,1014,878,136,46,28,62
2011,Tewkesbury 002A,E01022456,977,753,224,142,26,56
2011,Tewkesbury 002B,E01022457,1025,711,314,146,34,134
2011,Tewkesbury 002C,E01022458,970,667,303,113,29,161
2011,Tewkesbury 002D,E01022459,1145,897,248,157,24,67
2011,Tewkesbury 002E,E01022460,1262,948,314,187,31,96
2011,Tewkesbury 002F,E01022461,994,658,336,266,18,52
2011,Tewkesbury 002G,E01022462,1259,842,417,293,33,91
2011,Tewkesbury 003A,E01022449,1458,1006,452,309,43,100
2011,Tewkesbury 003B,E01022463,1064,754,310,219,24,67
2011,Tewkesbury 003C,E01022464,1072,686,386,266,26,94
2011,Tewkesbury 003D,E01022465,1118,772,346,238,40,68
2011,Tewkesbury 003E,E01022466,1222,819,403,257,37,109
2011,Tewkesbury 004A,E01022434,1492,1038,454,332,38,84
2011,Tewkesbury 004B,E01022441,1176,869,307,187,26,94
2011,Tewkesbury 004C,E01022445,1040,752,288,202,29,57
2011,Tewkesbury 004D,E01022453,1150,761,389,286,46,57
2011,Tewkesbury 005A,E01022432,1418,994,424,300,40,84
2011,Tewkesbury 005B,E01022433,1467,1015,452,330,41,81
2011,Tewkesbury 005C,E01022435,1598,1102,496,299,42,155
2011,Tewkesbury 005D,E01022436,1308,902,406,290,24,92
2011,Tewkesbury 005E,E01022437,970,730,240,136,32,72
2011,Tewkesbury 005F,E01022438,1031,820,211,133,28,50
2011,Tewkesbury 005G,E01022439,1131,941,190,95,27,68
2011,Tewkesbury 006A,E01022440,1202,876,326,197,30,99
2011,Tewkesbury 006B,E01022442,1178,842,336,224,43,69
2011,Tewkesbury 006C,E01022443,1023,694,329,221,37,71
2011,Tewkesbury 006D,E01022444,1084,762,322,204,32,86
2011,Tewkesbury 007A,E01022425,880,651,229,146,42,41
2011,Tewkesbury 007B,E01022426,982,613,369,273,39,57
2011,Tewkesbury 007C,E01022427,1024,733,291,193,38,60
2011,Tewkesbury 007D,E01022428,1294,949,345,148,61,136
2011,Tewkesbury 007E,E01022429,1165,879,286,176,40,70
2011,Tewkesbury 007F,E01022430,1065,764,301,221,41,39
2011,Tewkesbury 007G,E01022431,1563,1282,281,150,55,76
2011,Tewkesbury 007H,E01022447,1129,909,220,35,34,151
2011,Tewkesbury 008A,E01022420,1572,1063,509,334,46,129
2011,Tewkesbury 008B,E01022448,972,617,355,241,27,87
2011,Tewkesbury 008C,E01022454,1326,868,458,294,37,127
2011,Tewkesbury 009A,E01022421,1242,924,318,172,35,111
2011,Tewkesbury 009B,E01022422,1225,986,239,140,29,70
2011,Tewkesbury 009C,E01022423,1417,1052,365,238,25,102
2011,Tewkesbury 009D,E01022424,1138,767,371,165,46,160
2011,Tewkesbury 009E,E01022446,1271,981,290,173,28,89
2011,Mendip 001A,E01029022,991,704,287,189,33,65
2011,Mendip 001B,E01029023,878,591,287,177,29,81
2011,Mendip 001C,E01029044,981,756,225,101,28,96
2011,Mendip 001D,E01029053,1673,1205,468,283,50,135
2011,Mendip 001E,E01029057,1471,1058,413,243,53,117
2011,Mendip 002A,E01029024,1505,1107,398,232,59,107
2011,Mendip 002B,E01029025,956,668,288,146,35,107
2011,Mendip 002C,E01029026,757,538,219,139,35,45
2011,Mendip 002D,E01029068,1013,638,375,113,183,79
2011,Mendip 002E,E01029069,804,548,256,159,35,62
2011,Mendip 003A,E01029030,1450,1188,262,177,28,57
2011,Mendip 003B,E01029031,1153,857,296,207,26,63
2011,Mendip 003C,E01029032,700,432,268,217,12,39
2011,Mendip 003D,E01029033,1052,827,225,135,26,64
2011,Mendip 003E,E01029034,1010,789,221,134,30,57
2011,Mendip 004A,E01029036,1201,905,296,110,45,141
2011,Mendip 004B,E01029041,1381,1034,347,153,38,156
2011,Mendip 004C,E01029042,1090,738,352,128,51,173
2011,Mendip 004D,E01029043,1123,863,260,135,36,89
2011,Mendip 004E,E01029045,1175,857,318,167,46,105
2011,Mendip 005A,E01029052,1526,1004,522,306,62,154
2011,Mendip 005B,E01029060,1355,955,400,250,44,106
2011,Mendip 005C,E01029061,1601,1149,452,281,46,125
2011,Mendip 005D,E01029083,909,525,384,181,154,49
2011,Mendip 006A,E01029018,1702,1239,463,283,66,114
2011,Mendip 006B,E01029056,1707,1266,441,260,62,119
2011,Mendip 006C,E01029064,1226,879,347,151,48,148
2011,Mendip 006D,E01029084,1082,718,364,212,50,102
2011,Mendip 007A,E01029029,1197,778,419,174,75,170
2011,Mendip 007B,E01029035,1107,868,239,128,31,80
2011,Mendip 007C,E01029037,1019,766,253,113,29,111
2011,Mendip 007D,E01029038,1006,744,262,104,36,122
2011,Mendip 007E,E01029039,1081,753,328,211,29,88
2011,Mendip 007F,E01029040,1182,875,307,168,37,102
2011,Mendip 008A,E01029078,1156,787,369,241,28,100
2011,Mendip 008B,E01029079,1137,781,356,166,41,149
2011,Mendip 008C,E01029080,1069,756,313,173,47,93
2011,Mendip 008D,E01029081,1108,787,321,185,37,99
2011,Mendip 008E,E01029082,904,585,319,236,29,54
2011,Mendip 009A,E01029062,1070,814,256,61,36,159
2011,Mendip 009B,E01029063,1849,1485,364,185,49,130
2011,Mendip 009C,E01029065,1248,993,255,135,49,71
2011,Mendip 009D,E01029066,1296,997,299,163,27,109
2011,Mendip 009E,E01029067,1027,731,296,148,39,109
2011,Mendip 010A,E01029020,1047,776,271,164,31,76
2011,Mendip 010B,E01029021,924,693,231,146,26,59
2011,Mendip 010C,E01029027,845,587,258,160,36,62
2011,Mendip 010D,E01029028,824,593,231,143,22,66
2011,Mendip 010E,E01029058,1669,1177,492,270,54,168
2011,Mendip 011A,E01029046,1005,687,318,115,30,173
2011,Mendip 011D,E01029050,1647,1174,473,232,63,178
2011,Mendip 011E,E01029051,1192,856,336,228,35,73
2011,Mendip 011F,E01032627,1560,1047,513,278,53,182
2011,Mendip 012A,E01029047,1081,818,263,128,39,96
2011,Mendip 012B,E01029054,1099,808,291,165,35,91
2011,Mendip 012C,E01029055,864,632,232,152,23,57
2011,Mendip 012D,E01029074,1433,729,704,166,477,61
2011,Mendip 012E,E01029076,1496,1117,379,260,31,88
2011,Mendip 013A,E01029019,1667,1183,484,306,54,124
2011,Mendip 013B,E01029059,1537,1089,448,267,63,118
2011,Mendip 013C,E01029077,1556,1102,454,292,60,102
2011,Mendip 014A,E01029070,1312,1045,267,110,38,119
2011,Mendip 014B,E01029071,1078,799,279,133,31,115
2011,Mendip 014C,E01029072,1128,804,324,142,41,141
2011,Mendip 014D,E01029073,827,579,248,130,29,89
2011,Mendip 014E,E01029075,934,629,305,202,33,70
2011,Sedgemoor 001A,E01029085,1523,1112,411,207,62,142
2011,Sedgemoor 001B,E01029126,1142,812,330,204,39,87
2011,Sedgemoor 001C,E01029127,987,674,313,215,32,66
2011,Sedgemoor 001D,E01029128,1396,971,425,271,49,105
2011,Sedgemoor 001E,E01029129,1369,1003,366,208,71,87
2011,Sedgemoor 002C,E01029089,1638,1222,416,257,51,108
2011,Sedgemoor 002D,E01029113,1093,658,435,331,35,69
2011,Sedgemoor 002E,E01029115,1148,788,360,268,25,67
2011,Sedgemoor 002F,E01029140,2160,1537,623,347,71,205
2011,Sedgemoor 002G,E01032633,1679,1075,604,407,40,157
2011,Sedgemoor 003A,E01029086,1651,1131,520,340,67,113
2011,Sedgemoor 003B,E01029147,1248,838,410,258,55,97
2011,Sedgemoor 003C,E01029148,1141,789,352,235,57,60
2011,Sedgemoor 003D,E01029149,1024,749,275,155,64,56
2011,Sedgemoor 004A,E01029114,1017,585,432,331,27,74
2011,Sedgemoor 004B,E01029116,1127,717,410,233,16,161
2011,Sedgemoor 004C,E01029117,1123,744,379,224,28,127
2011,Sedgemoor 004D,E01029119,1029,691,338,202,22,114
2011,Sedgemoor 004E,E01029120,1093,777,316,189,46,81
2011,Sedgemoor 005A,E01029118,1266,882,384,241,36,107
2011,Sedgemoor 005B,E01029131,1491,1033,458,151,49,258
2011,Sedgemoor 005C,E01029132,1037,617,420,141,46,233
2011,Sedgemoor 005D,E01029133,945,611,334,219,17,98
2011,Sedgemoor 005E,E01029134,1403,886,517,320,32,165
2011,Sedgemoor 006A,E01029135,1220,805,415,286,29,100
2011,Sedgemoor 006B,E01029136,1490,1037,453,276,50,127
2011,Sedgemoor 006C,E01029145,1428,995,433,297,42,94
2011,Sedgemoor 006D,E01029152,1517,973,544,354,45,145
2011,Sedgemoor 007A,E01029121,982,709,273,190,22,61
2011,Sedgemoor 007B,E01029122,1045,754,291,179,45,67
2011,Sedgemoor 007C,E01029123,776,509,267,140,42,85
2011,Sedgemoor 007D,E01029124,1230,792,438,316,25,97
2011,Sedgemoor 007E,E01029125,1012,716,296,184,34,78
2011,Sedgemoor 008A,E01029093,1164,828,336,125,44,167
2011,Sedgemoor 008B,E01029096,1064,778,286,123,38,125
2011,Sedgemoor 008C,E01029106,1111,696,415,133,58,224
2011,Sedgemoor 008D,E01029107,1071,666,405,167,40,198
2011,Sedgemoor 008E,E01029109,962,646,316,99,54,163
2011,Sedgemoor 009A,E01029094,1218,955,263,115,29,119
2011,Sedgemoor 009B,E01029095,1210,896,314,106,40,168
2011,Sedgemoor 009C,E01029110,1636,1218,418,159,57,202
2011,Sedgemoor 009D,E01029111,1773,1310,463,159,69,235
2011,Sedgemoor 009E,E01029112,1445,1045,400,162,37,201
2011,Sedgemoor 010A,E01029090,1110,847,263,172,26,65
2011,Sedgemoor 010B,E01029091,1277,1006,271,134,24,113
2011,Sedgemoor 010C,E01029092,1165,971,194,87,41,66
2011,Sedgemoor 010D,E01029108,1546,1058,488,302,39,147
2011,Sedgemoor 011A,E01029102,1127,795,332,164,43,125
2011,Sedgemoor 011B,E01029103,1036,711,325,244,28,53
2011,Sedgemoor 011C,E01029104,1063,787,276,172,42,62
2011,Sedgemoor 011E,E01032631,979,787,192,79,33,80
2011,Sedgemoor 011F,E01032632,921,698,223,134,39,50
2011,Sedgemoor 011G,E01032634,907,640,267,186,27,54
2011,Sedgemoor 012A,E01029130,1556,1101,455,301,59,95
2011,Sedgemoor 012B,E01029137,1193,848,345,221,44,80
2011,Sedgemoor 012C,E01029138,1026,707,319,203,27,89
2011,Sedgemoor 012D,E01029139,1097,755,342,241,33,68
2011,Sedgemoor 012E,E01029150,953,663,290,197,29,64
2011,Sedgemoor 012F,E01029151,899,596,303,206,32,65
2011,Sedgemoor 013A,E01029097,1004,716,288,103,36,149
2011,Sedgemoor 013B,E01029098,1059,774,285,116,42,127
2011,Sedgemoor 013C,E01029099,904,578,326,133,41,152
2011,Sedgemoor 013D,E01029100,938,640,298,75,50,173
2011,Sedgemoor 013E,E01029105,971,626,345,175,39,131
2011,Sedgemoor 014A,E01029101,822,559,263,138,24,101
2011,Sedgemoor 014C,E01029142,1053,728,325,209,32,84
2011,Sedgemoor 014D,E01029143,974,650,324,193,29,102
2011,Sedgemoor 014E,E01029144,945,700,245,151,35,59
2011,Sedgemoor 014F,E01032629,1137,832,305,190,29,86
2011,Sedgemoor 014G,E01032630,1157,963,194,72,33,89
2011,South Somerset 001A,E01029157,917,574,343,126,129,88
2011,South Somerset 001B,E01029158,982,689,293,134,82,77
2011,South Somerset 001C,E01029221,1785,1246,539,324,94,121
2011,South Somerset 002A,E01029166,1668,1171,497,317,67,113
2011,South Somerset 002B,E01029167,1089,758,331,180,38,113
2011,South Somerset 002C,E01029168,1105,795,310,248,14,48
2011,South Somerset 002D,E01029210,1160,853,307,192,42,73
2011,South Somerset 002E,E01029211,1022,706,316,224,25,67
2011,South Somerset 003A,E01029224,1209,807,402,281,34,87
2011,South Somerset 003B,E01029225,1523,1049,474,333,44,97
2011,South Somerset 003C,E01029226,1129,750,379,245,37,97
2011,South Somerset 004A,E01029200,1012,726,286,150,32,104
2011,South Somerset 004B,E01029201,1019,718,301,198,33,70
2011,South Somerset 004C,E01029222,1143,810,333,210,40,83
2011,South Somerset 004D,E01029223,877,578,299,212,24,63
2011,South Somerset 005A,E01029155,1314,879,435,321,33,81
2011,South Somerset 005B,E01029227,1123,826,297,174,38,85
2011,South Somerset 005C,E01029228,1163,840,323,196,23,104
2011,South Somerset 005D,E01029229,1425,1073,352,188,38,126
2011,South Somerset 006A,E01029164,999,710,289,202,34,53
2011,South Somerset 006B,E01029165,876,529,347,249,27,71
2011,South Somerset 006C,E01029198,884,713,171,46,27,98
2011,South Somerset 006D,E01029199,2442,2019,423,266,48,109
2011,South Somerset 007A,E01029187,719,486,233,135,15,83
2011,South Somerset 007B,E01029188,1076,731,345,260,31,54
2011,South Somerset 007C,E01029196,1065,750,315,194,36,85
2011,South Somerset 007D,E01029197,928,647,281,185,31,65
2011,South Somerset 008A,E01029154,1382,935,447,265,32,150
2011,South Somerset 008B,E01029156,1369,959,410,229,42,139
2011,South Somerset 008C,E01029206,1059,771,288,183,30,75
2011,South Somerset 008D,E01029207,989,654,335,215,38,82
2011,South Somerset 009A,E01029202,838,605,233,133,16,84
2011,South Somerset 009B,E01029203,1173,836,337,239,33,65
2011,South Somerset 009C,E01029204,852,593,259,183,22,54
2011,South Somerset 009D,E01029205,1306,959,347,206,36,105
2011,South Somerset 010A,E01029163,1653,1189,464,292,50,122
2011,South Somerset 010B,E01029216,1042,687,355,276,18,61
2011,South Somerset 010C,E01029217,1097,782,315,236,21,58
2011,South Somerset 010D,E01029218,1254,816,438,279,30,129
2011,South Somerset 011A,E01029238,1118,804,314,162,45,107
2011,South Somerset 011B,E01029252,1079,795,284,189,27,68
2011,South Somerset 011C,E01029253,1139,856,283,167,23,93
2011,South Somerset 011D,E01029254,976,675,301,239,23,39
2011,South Somerset 012A,E01029160,1920,1547,373,153,113,107
2011,South Somerset 012B,E01029248,1119,779,340,137,42,161
2011,South Somerset 012C,E01029250,962,647,315,201,34,80
2011,South Somerset 012D,E01029251,949,632,317,234,26,57
2011,South Somerset 013A,E01029161,1225,1015,210,90,37,83
2011,South Somerset 013B,E01029162,1120,894,226,141,24,61
2011,South Somerset 013C,E01029247,1095,737,358,119,45,194
2011,South Somerset 013D,E01029255,1001,720,281,178,25,78
2011,South Somerset 014A,E01029231,1129,837,292,167,29,96
2011,South Somerset 014B,E01029233,964,717,247,106,28,113
2011,South Somerset 014C,E01029235,980,693,287,156,37,94
2011,South Somerset 014D,E01029236,994,703,291,103,34,154
2011,South Somerset 014E,E01029237,1045,732,313,145,31,137
2011,South Somerset 015A,E01029232,1134,923,211,75,23,113
2011,South Somerset 015B,E01029234,1411,1023,388,159,42,187
2011,South Somerset 015C,E01029239,1042,763,279,106,40,133
2011,South Somerset 015D,E01029240,1123,929,194,101,22,71
2011,South Somerset 016A,E01029241,1372,1085,287,114,45,128
2011,South Somerset 016B,E01029245,1645,1269,376,225,43,108
2011,South Somerset 016C,E01029246,1068,766,302,196,27,79
2011,South Somerset 016D,E01029249,967,651,316,190,36,90
2011,South Somerset 017A,E01029189,806,559,247,156,22,69
2011,South Somerset 017B,E01029190,913,605,308,240,17,51
2011,South Somerset 017C,E01029191,871,597,274,182,31,61
2011,South Somerset 017D,E01029192,1069,790,279,169,36,74
2011,South Somerset 017E,E01029212,765,510,255,191,17,47
2011,South Somerset 017F,E01029213,912,625,287,203,26,58
2011,South Somerset 017G,E01029214,855,593,262,166,16,80
2011,South Somerset 017H,E01029215,788,537,251,145,25,81
2011,South Somerset 018A,E01029159,1162,966,196,115,31,50
2011,South Somerset 018B,E01029242,1141,877,264,156,25,83
2011,South Somerset 018C,E01029243,1159,718,441,344,26,71
2011,South Somerset 018D,E01029244,1147,838,309,245,13,51
2011,South Somerset 019A,E01029193,1356,967,389,223,39,127
2011,South Somerset 019B,E01029194,1761,1259,502,366,36,100
2011,South Somerset 019C,E01029195,1060,743,317,204,28,85
2011,South Somerset 019D,E01029208,769,520,249,179,15,55
2011,South Somerset 019E,E01029209,952,641,311,234,19,58
2011,South Somerset 020A,E01029178,1069,714,355,267,24,64
2011,South Somerset 020B,E01029179,812,562,250,153,19,78
2011,South Somerset 020C,E01029180,1056,748,308,196,31,81
2011,South Somerset 020D,E01029181,961,658,303,217,17,69
2011,South Somerset 021A,E01029182,1082,721,361,258,34,69
2011,South Somerset 021B,E01029183,1028,726,302,174,27,101
2011,South Somerset 021C,E01029184,1260,854,406,314,21,71
2011,South Somerset 021D,E01029185,1238,892,346,217,22,107
2011,South Somerset 021E,E01029186,1015,696,319,198,24,97
2011,South Somerset 022A,E01029169,1099,803,296,185,28,83
2011,South Somerset 022B,E01029172,1060,741,319,233,29,57
2011,South Somerset 022C,E01029173,891,671,220,108,23,89
2011,South Somerset 022D,E01029176,908,677,231,162,20,49
2011,South Somerset 022E,E01029177,798,522,276,134,19,123
2011,South Somerset 023A,E01029170,775,569,206,105,28,73
2011,South Somerset 023B,E01029171,1479,1004,475,285,44,146
2011,South Somerset 023C,E01029174,768,487,281,181,21,79
2011,South Somerset 023D,E01029175,1405,972,433,194,44,195
2011,South Somerset 024A,E01029153,1730,1163,567,426,32,109
2011,South Somerset 024B,E01029219,1054,715,339,250,33,56
2011,South Somerset 024C,E01029220,865,573,292,206,24,62
2011,South Somerset 024D,E01029230,1706,1166,540,385,47,108
2011,Taunton Deane 001A,E01029258,1075,778,297,196,31,70
2011,Taunton Deane 001B,E01029259,1005,678,327,183,32,112
2011,Taunton Deane 001C,E01029260,1558,1270,288,151,56,81
2011,Taunton Deane 001D,E01029268,1161,822,339,226,39,74
2011,Taunton Deane 002A,E01029276,1136,666,470,188,213,69
2011,Taunton Deane 002B,E01029278,938,632,306,198,37,71
2011,Taunton Deane 002C,E01029290,1048,779,269,156,33,80
2011,Taunton Deane 002D,E01029306,1096,727,369,237,41,91
2011,Taunton Deane 002E,E01029319,1115,931,184,72,28,84
2011,Taunton Deane 003A,E01029267,1185,817,368,235,50,83
2011,Taunton Deane 003B,E01029320,1124,796,328,184,37,107
2011,Taunton Deane 003C,E01029321,1685,1169,516,321,54,141
2011,Taunton Deane 004A,E01029297,910,595,315,144,30,141
2011,Taunton Deane 004B,E01029298,1017,756,261,118,26,117
2011,Taunton Deane 004C,E01029304,1054,704,350,134,42,174
2011,Taunton Deane 004D,E01029305,1021,739,282,164,29,89
2011,Taunton Deane 004E,E01029307,975,636,339,153,36,150
2011,Taunton Deane 005A,E01029271,1273,905,368,259,32,77
2011,Taunton Deane 005B,E01029273,832,604,228,158,7,63
2011,Taunton Deane 005C,E01029274,1067,735,332,248,32,52
2011,Taunton Deane 005D,E01029275,894,577,317,227,30,60
2011,Taunton Deane 005E,E01029279,1038,752,286,184,25,77
2011,Taunton Deane 006A,E01029282,1079,908,171,88,25,58
2011,Taunton Deane 006B,E01029291,1172,838,334,159,22,153
2011,Taunton Deane 006C,E01029294,1334,1090,244,143,32,69
2011,Taunton Deane 006D,E01029317,911,661,250,141,48,61
2011,Taunton Deane 006E,E01029318,1090,771,319,245,31,43
2011,Taunton Deane 007A,E01029285,1873,1524,349,119,116,114
2011,Taunton Deane 007B,E01029287,1202,1008,194,62,37,95
2011,Taunton Deane 007C,E01029288,1132,858,274,137,34,103
2011,Taunton Deane 007D,E01029289,1391,1068,323,131,49,143
2011,Taunton Deane 007E,E01029299,1098,777,321,147,34,140
2011,Taunton Deane 007F,E01029300,1174,942,232,117,35,80
2011,Taunton Deane 008A,E01029256,975,650,325,227,30,68
2011,Taunton Deane 008B,E01029257,1532,1051,481,245,67,169
2011,Taunton Deane 008D,E01029277,768,619,149,85,16,48
2011,Taunton Deane 008E,E01032651,1608,1298,310,125,29,156
2011,Taunton Deane 008F,E01032652,847,610,237,134,18,85
2011,Taunton Deane 009A,E01029280,1139,828,311,139,48,124
2011,Taunton Deane 009B,E01029281,1262,879,383,184,47,152
2011,Taunton Deane 009C,E01029283,1357,1008,349,153,57,139
2011,Taunton Deane 009D,E01029292,1008,666,342,113,34,195
2011,Taunton Deane 009E,E01029293,1022,656,366,62,36,268
2011,Taunton Deane 010A,E01029266,928,579,349,174,103,72
2011,Taunton Deane 010B,E01029284,1289,843,446,145,188,113
2011,Taunton Deane 010C,E01029286,1263,990,273,91,57,125
2011,Taunton Deane 010D,E01029301,1282,864,418,246,51,121
2011,Taunton Deane 010E,E01029303,1185,798,387,264,50,73
2011,Taunton Deane 011A,E01029263,1032,809,223,135,32,56
2011,Taunton Deane 011B,E01029264,881,612,269,214,21,34
2011,Taunton Deane 011C,E01029265,1025,684,341,247,41,53
2011,Taunton Deane 011D,E01029302,1138,782,356,265,42,49
2011,Taunton Deane 011E,E01029308,1389,907,482,296,102,84
2011,Taunton Deane 012A,E01029309,1420,1034,386,174,41,171
2011,Taunton Deane 012B,E01029311,1021,686,335,142,49,144
2011,Taunton Deane 012C,E01029312,1001,793,208,113,28,67
2011,Taunton Deane 012D,E01029313,977,738,239,100,40,99
2011,Taunton Deane 012E,E01029316,1136,842,294,191,28,75
2011,Taunton Deane 013A,E01029262,1744,1250,494,349,47,98
2011,Taunton Deane 013B,E01029269,1538,1152,386,259,51,76
2011,Taunton Deane 013C,E01029310,1292,803,489,307,99,83
2011,Taunton Deane 013D,E01029314,1832,1334,498,258,54,186
2011,Taunton Deane 013E,E01029315,993,647,346,250,34,62
2011,Taunton Deane 014A,E01029261,1542,1120,422,278,57,87
2011,Taunton Deane 014B,E01029270,1583,1131,452,306,49,97
2011,Taunton Deane 014C,E01029295,1228,937,291,197,41,53
2011,Taunton Deane 014D,E01029296,1021,719,302,199,34,69
2011,West Somerset 001B,E01029324,1120,814,306,170,34,102
2011,West Somerset 001C,E01029329,1140,800,340,171,75,94
2011,West Somerset 001D,E01029330,1423,828,595,414,47,134
2011,West Somerset 001F,E01032636,1341,882,459,305,34,120
2011,West Somerset 002A,E01029322,1562,1208,354,199,35,120
2011,West Somerset 002B,E01029331,966,480,486,395,19,72
2011,West Somerset 002C,E01029333,791,494,297,170,27,100
2011,West Somerset 002D,E01029336,1456,928,528,375,45,108
2011,West Somerset 003A,E01029326,869,534,335,218,29,88
2011,West Somerset 003B,E01029334,790,497,293,198,17,78
2011,West Somerset 003C,E01029339,1089,711,378,208,35,135
2011,West Somerset 003E,E01029341,950,570,380,215,30,135
2011,West Somerset 003G,E01032635,1538,976,562,313,61,188
2011,West Somerset 004A,E01029327,1524,1046,478,333,46,99
2011,West Somerset 004B,E01029335,844,559,285,197,26,62
2011,West Somerset 004C,E01029337,1584,1001,583,395,48,140
2011,West Somerset 004D,E01029342,791,475,316,249,14,53
2011,West Somerset 004E,E01029343,1077,672,405,255,30,120
2011,West Somerset 005A,E01029325,1380,846,534,386,36,112
2011,West Somerset 005B,E01029328,1324,867,457,319,24,114
2011,West Somerset 005C,E01029338,1359,930,429,279,42,108
2011,Isle of Anglesey 001A,W01000003,1828,1156,672,335,89,248
2011,Isle of Anglesey 001B,W01000004,939,512,427,274,48,105
2011,Isle of Anglesey 001C,W01000018,986,606,380,249,30,101
2011,Isle of Anglesey 001D,W01000028,1454,968,486,239,69,178
2011,Isle of Anglesey 001E,W01000031,1165,731,434,242,45,147
2011,Isle of Anglesey 002A,W01000010,1313,770,543,393,42,108
2011,Isle of Anglesey 002B,W01000020,990,659,331,229,41,61
2011,Isle of Anglesey 002C,W01000021,1692,1013,679,403,76,200
2011,Isle of Anglesey 002D,W01000032,776,440,336,228,27,81
2011,Isle of Anglesey 003A,W01000016,915,632,283,117,39,127
2011,Isle of Anglesey 003B,W01000017,1123,740,383,167,56,160
2011,Isle of Anglesey 003C,W01000029,1058,649,409,179,48,182
2011,Isle of Anglesey 003D,W01000030,1631,1059,572,256,62,254
2011,Isle of Anglesey 003E,W01000033,1084,649,435,191,59,185
2011,Isle of Anglesey 003F,W01000036,791,500,291,112,42,137
2011,Isle of Anglesey 003G,W01000037,849,559,290,158,29,103
2011,Isle of Anglesey 004A,W01000022,1202,730,472,275,54,143
2011,Isle of Anglesey 004B,W01000034,848,555,293,194,29,70
2011,Isle of Anglesey 004C,W01000039,772,468,304,207,24,73
2011,Isle of Anglesey 004D,W01000040,859,491,368,288,26,54
2011,Isle of Anglesey 004E,W01000043,864,543,321,189,35,97
2011,Isle of Anglesey 004F,W01000044,848,541,307,223,24,60
2011,Isle of Anglesey 005A,W01000005,1384,874,510,324,55,131
2011,Isle of Anglesey 005B,W01000013,1640,1127,513,337,75,101
2011,Isle of Anglesey 005C,W01000019,1060,606,454,336,38,80
2011,Isle of Anglesey 005D,W01000026,904,535,369,255,38,76
2011,Isle of Anglesey 005E,W01000035,1381,931,450,264,57,129
2011,Isle of Anglesey 006A,W01000006,1166,802,364,208,43,113
2011,Isle of Anglesey 006B,W01000012,1036,706,330,218,35,77
2011,Isle of Anglesey 006C,W01000014,1490,1073,417,207,71,139
2011,Isle of Anglesey 006D,W01000041,1060,709,351,133,50,168
2011,Isle of Anglesey 007A,W01000001,807,516,291,181,29,81
2011,Isle of Anglesey 007B,W01000002,931,600,331,193,48,90
2011,Isle of Anglesey 007C,W01000009,1378,901,477,258,47,172
2011,Isle of Anglesey 007D,W01000023,1046,693,353,181,38,134
2011,Isle of Anglesey 007E,W01000024,1068,806,262,79,43,140
2011,Isle of Anglesey 008A,W01000008,1093,764,329,207,53,69
2011,Isle of Anglesey 008B,W01000011,956,615,341,143,142,56
2011,Isle of Anglesey 008C,W01000015,1114,785,329,232,42,55
2011,Isle of Anglesey 008D,W01000042,1559,1117,442,208,95,139
2011,Isle of Anglesey 009A,W01000007,1263,831,432,247,67,118
2011,Isle of Anglesey 009B,W01000025,1494,1094,400,215,73,112
2011,Isle of Anglesey 009C,W01000027,1363,956,407,224,58,125
2011,Isle of Anglesey 009D,W01000038,1638,1011,627,352,75,200
2011,Gwynedd 001A,W01000062,1632,693,939,53,798,88
2011,Gwynedd 001B,W01000076,1089,497,592,107,413,72
2011,Gwynedd 001C,W01000077,1128,541,587,107,384,96
2011,Gwynedd 001D,W01000091,849,502,347,86,75,186
2011,Gwynedd 001E,W01000092,3908,1357,2551,77,2406,68
2011,Gwynedd 002A,W01000064,1313,856,457,165,158,134
2011,Gwynedd 002B,W01000072,1285,838,447,152,186,109
2011,Gwynedd 002C,W01000075,1145,673,472,108,238,126
2011,Gwynedd 002D,W01000090,959,629,330,119,49,162
2011,Gwynedd 002E,W01000102,853,604,249,122,66,61
2011,Gwynedd 003A,W01000050,1015,722,293,159,44,90
2011,Gwynedd 003B,W01000071,1738,1284,454,184,85,185
2011,Gwynedd 003C,W01000096,867,615,252,124,51,77
2011,Gwynedd 003D,W01000097,850,604,246,112,37,97
2011,Gwynedd 003E,W01000115,1616,1174,442,233,74,135
2011,Gwynedd 004A,W01000052,857,621,236,134,41,61
2011,Gwynedd 004B,W01000053,906,689,217,104,40,73
2011,Gwynedd 004C,W01000087,1339,987,352,193,47,112
2011,Gwynedd 004D,W01000119,1712,1206,506,244,120,142
2011,Gwynedd 005A,W01000063,1361,944,417,174,61,182
2011,Gwynedd 005B,W01000081,1501,1077,424,225,62,137
2011,Gwynedd 005C,W01000099,1320,985,335,178,73,84
2011,Gwynedd 005D,W01000103,902,631,271,141,63,67
2011,Gwynedd 006A,W01000059,1445,918,527,239,66,222
2011,Gwynedd 006B,W01000093,1596,1115,481,331,56,94
2011,Gwynedd 006C,W01000098,1569,989,580,151,76,353
2011,Gwynedd 006D,W01000110,1129,794,335,169,62,104
2011,Gwynedd 007A,W01000054,800,573,227,144,27,56
2011,Gwynedd 007B,W01000088,1393,1008,385,216,44,125
2011,Gwynedd 007C,W01000111,1118,795,323,156,37,130
2011,Gwynedd 007D,W01000118,1194,866,328,189,42,97
2011,Gwynedd 008A,W01000073,1245,875,370,221,55,94
2011,Gwynedd 008B,W01000086,1620,1071,549,284,71,194
2011,Gwynedd 008C,W01000104,1297,867,430,218,55,157
2011,Gwynedd 008D,W01000112,1375,843,532,251,67,214
2011,Gwynedd 009A,W01000056,1372,938,434,201,72,161
2011,Gwynedd 009B,W01000065,836,547,289,137,44,108
2011,Gwynedd 009C,W01000113,1308,872,436,216,48,172
2011,Gwynedd 009D,W01000114,1171,771,400,250,44,106
2011,Gwynedd 010A,W01000066,862,583,279,171,32,76
2011,Gwynedd 010B,W01000100,762,529,233,152,25,56
2011,Gwynedd 010C,W01000105,1193,874,319,163,36,120
2011,Gwynedd 010D,W01000106,1253,782,471,357,40,74
2011,Gwynedd 010E,W01000107,931,617,314,192,36,86
2011,Gwynedd 011A,W01000047,950,683,267,167,33,67
2011,Gwynedd 011B,W01000061,1214,759,455,301,52,102
2011,Gwynedd 011C,W01000078,1231,811,420,201,65,154
2011,Gwynedd 011D,W01000089,1460,1020,440,261,48,131
2011,Gwynedd 012A,W01000070,937,633,304,176,28,100
2011,Gwynedd 012B,W01000094,854,594,260,164,23,73
2011,Gwynedd 012C,W01000095,927,613,314,188,31,95
2011,Gwynedd 012D,W01000108,1564,1095,469,250,47,172
2011,Gwynedd 012E,W01000109,1326,888,438,234,46,158
2011,Gwynedd 013A,W01000069,1092,693,399,289,25,85
2011,Gwynedd 013B,W01000074,1515,896,619,376,110,133
2011,Gwynedd 013C,W01000079,762,484,278,184,20,74
2011,Gwynedd 013D,W01000101,1058,724,334,184,48,102
2011,Gwynedd 014C,W01000080,1192,751,441,293,48,100
2011,Gwynedd 014D,W01000084,840,544,296,184,33,79
2011,Gwynedd 014E,W01001932,2103,1408,695,390,102,203
2011,Gwynedd 015A,W01000051,1393,995,398,211,37,150
2011,Gwynedd 015B,W01000060,992,688,304,166,36,102
2011,Gwynedd 015C,W01000082,800,578,222,116,25,81
2011,Gwynedd 015D,W01000083,963,706,257,164,33,60
2011,Gwynedd 016A,W01000048,960,597,363,225,33,105
2011,Gwynedd 016B,W01000049,854,576,278,138,22,118
2011,Gwynedd 016C,W01000057,1072,709,363,239,53,71
2011,Gwynedd 016D,W01000067,902,621,281,174,25,82
2011,Gwynedd 016E,W01000068,978,646,332,173,42,117
2011,Gwynedd 017C,W01000085,1477,895,582,394,33,155
2011,Gwynedd 017D,W01000116,1115,618,497,379,28,90
2011,Gwynedd 017E,W01000117,1113,715,398,223,40,135
2011,Gwynedd 017F,W01001933,1655,1099,556,408,42,106
2011,Conwy 001A,W01000132,1087,742,345,179,41,125
2011,Conwy 001B,W01000146,1797,1330,467,213,46,208
2011,Conwy 001C,W01000147,1044,650,394,275,34,85
2011,Conwy 001D,W01000169,1409,900,509,249,52,208
2011,Conwy 001E,W01000186,1164,766,398,170,54,174
2011,Conwy 002A,W01000133,1234,723,511,377,40,94
2011,Conwy 002B,W01000168,1262,867,395,194,61,140
2011,Conwy 002C,W01000187,1054,661,393,99,73,221
2011,Conwy 002D,W01000188,1234,815,419,282,45,92
2011,Conwy 003A,W01000154,987,623,364,249,37,78
2011,Conwy 003B,W01000173,1078,796,282,160,75,47
2011,Conwy 003C,W01000174,1169,797,372,270,52,50
2011,Conwy 003D,W01000175,1079,607,472,385,23,64
2011,Conwy 004A,W01000155,973,607,366,246,39,81
2011,Conwy 004B,W01000156,1021,590,431,315,33,83
2011,Conwy 004C,W01000157,1022,649,373,167,51,155
2011,Conwy 004D,W01000158,1029,577,452,346,34,72
2011,Conwy 005A,W01000149,1041,531,510,297,41,172
2011,Conwy 005B,W01000150,1092,685,407,253,52,102
2011,Conwy 005C,W01000151,1113,701,412,176,50,186
2011,Conwy 005D,W01000152,1018,633,385,199,41,145
2011,Conwy 005E,W01000184,1759,983,776,471,66,239
2011,Conwy 006A,W01000135,1371,847,524,426,34,64
2011,Conwy 006B,W01000136,1291,858,433,266,39,128
2011,Conwy 006C,W01000165,1366,922,444,344,44,56
2011,Conwy 006D,W01000166,1351,956,395,197,50,148
2011,Conwy 007A,W01000139,1167,834,333,188,64,81
2011,Conwy 007B,W01000143,1144,785,359,147,66,146
2011,Conwy 007C,W01000144,1130,747,383,93,50,240
2011,Conwy 007D,W01000182,1294,746,548,277,51,220
2011,Conwy 008A,W01000138,1303,816,487,317,56,114
2011,Conwy 008B,W01000145,890,621,269,141,34,94
2011,Conwy 008C,W01000180,1218,830,388,199,67,122
2011,Conwy 008D,W01000181,1146,875,271,141,55,75
2011,Conwy 008E,W01000183,969,586,383,173,120,90
2011,Conwy 009A,W01000126,1261,892,369,204,61,104
2011,Conwy 009B,W01000127,948,576,372,167,39,166
2011,Conwy 009C,W01000128,1061,688,373,207,53,113
2011,Conwy 009D,W01000153,1159,741,418,278,48,92
2011,Conwy 009E,W01000163,916,540,376,109,66,201
2011,Conwy 009F,W01000164,1017,763,254,112,41,101
2011,Conwy 010B,W01000140,1048,665,383,196,52,135
2011,Conwy 010C,W01000141,997,493,504,401,20,83
2011,Conwy 010D,W01000142,1082,658,424,324,39,61
2011,Conwy 010E,W01000178,1274,822,452,197,58,197
2011,Conwy 010F,W01000179,1122,668,454,357,28,69
2011,Conwy 010G,W01001927,923,532,391,252,26,113
2011,Conwy 010H,W01001928,878,402,476,246,20,210
2011,Conwy 011C,W01000167,1360,896,464,238,54,172
2011,Conwy 011D,W01000176,1150,790,360,154,64,142
2011,Conwy 011E,W01000177,877,614,263,154,44,65
2011,Conwy 011F,W01001926,1641,1131,510,350,61,99
2011,Conwy 012A,W01000124,1467,977,490,328,51,111
2011,Conwy 012B,W01000129,791,515,276,151,36,89
2011,Conwy 012C,W01000130,1166,767,399,257,48,94
2011,Conwy 012D,W01000131,1051,709,342,181,53,108
2011,Conwy 013A,W01000123,1335,902,433,245,48,140
2011,Conwy 013B,W01000125,1101,743,358,239,41,78
2011,Conwy 013C,W01000170,1335,865,470,243,82,145
2011,Conwy 013D,W01000171,1163,757,406,205,75,126
2011,Conwy 013E,W01000172,956,683,273,109,39,125
2011,Conwy 014A,W01000122,1620,1167,453,254,67,132
2011,Conwy 014B,W01000159,1039,798,241,139,42,60
2011,Conwy 014C,W01000162,1419,1052,367,200,61,106
2011,Conwy 014D,W01000190,1023,789,234,136,34,64
2011,Conwy 015A,W01000121,929,667,262,163,24,75
2011,Conwy 015B,W01000134,1428,953,475,264,48,163
2011,Conwy 015C,W01000137,1125,827,298,199,29,70
2011,Conwy 015D,W01000148,863,608,255,105,48,102
2011,Conwy 015E,W01000185,922,611,311,183,38,90
2011,Conwy 015F,W01000189,1153,875,278,150,45,83
2011,Denbighshire 001A,W01000218,1102,720,382,218,51,113
2011,Denbighshire 001B,W01000219,1783,1140,643,332,70,241
2011,Denbighshire 001C,W01000220,1150,544,606,447,28,131
2011,Denbighshire 002A,W01000213,898,523,375,159,57,159
2011,Denbighshire 002B,W01000214,824,505,319,151,43,125
2011,Denbighshire 002C,W01000215,985,623,362,247,48,67
2011,Denbighshire 002D,W01000216,1015,673,342,143,77,122
2011,Denbighshire 003A,W01000212,1547,992,555,355,56,144
2011,Denbighshire 003B,W01000221,973,595,378,238,28,112
2011,Denbighshire 003C,W01000222,1196,675,521,367,35,119
2011,Denbighshire 004A,W01000226,1100,578,522,316,45,161
2011,Denbighshire 004B,W01000227,1089,659,430,294,43,93
2011,Denbighshire 004C,W01000228,809,509,300,138,31,131
2011,Denbighshire 004D,W01000239,1337,774,563,184,74,305
2011,Denbighshire 004E,W01000240,1034,569,465,119,46,300
2011,Denbighshire 004F,W01000241,901,542,359,101,47,211
2011,Denbighshire 006A,W01000236,1299,767,532,186,79,267
2011,Denbighshire 006B,W01000237,1145,607,538,129,124,285
2011,Denbighshire 006C,W01000238,1239,843,396,166,67,163
2011,Denbighshire 008A,W01000200,943,661,282,179,38,65
2011,Denbighshire 008B,W01000201,1080,751,329,167,43,119
2011,Denbighshire 008C,W01000217,1429,896,533,252,78,203
2011,Denbighshire 008D,W01000248,1240,861,379,237,65,77
2011,Denbighshire 009A,W01000191,1576,1099,477,230,93,154
2011,Denbighshire 009B,W01000223,971,647,324,203,47,74
2011,Denbighshire 009C,W01000224,1005,636,369,226,56,87
2011,Denbighshire 009D,W01000225,1132,747,385,233,39,113
2011,Denbighshire 010A,W01000245,1192,809,383,248,54,81
2011,Denbighshire 010B,W01000246,1227,803,424,218,58,148
2011,Denbighshire 010C,W01000247,1409,918,491,296,49,146
2011,Denbighshire 011A,W01000194,1637,1101,536,201,118,217
2011,Denbighshire 011B,W01000198,1024,616,408,140,54,214
2011,Denbighshire 011C,W01000199,1259,836,423,188,70,165
2011,Denbighshire 012A,W01000195,991,653,338,246,49,43
2011,Denbighshire 012B,W01000196,1118,882,236,112,55,69
2011,Denbighshire 012C,W01000197,1193,855,338,192,48,98
2011,Denbighshire 012D,W01000211,1372,997,375,243,44,88
2011,Denbighshire 013A,W01000203,1836,1329,507,343,62,102
2011,Denbighshire 013B,W01000204,1060,721,339,218,52,69
2011,Denbighshire 013C,W01000206,1567,1090,477,282,63,132
2011,Denbighshire 014A,W01000242,1340,935,405,203,64,138
2011,Denbighshire 014B,W01000243,1284,877,407,189,129,89
2011,Denbighshire 014C,W01000244,1202,875,327,221,47,59
2011,Denbighshire 015A,W01000193,996,688,308,156,56,96
2011,Denbighshire 015B,W01000202,1203,894,309,188,59,62
2011,Denbighshire 015C,W01000207,1677,1249,428,256,72,100
2011,Denbighshire 016A,W01000192,763,510,253,155,27,71
2011,Denbighshire 016B,W01000205,825,595,230,160,26,44
2011,Denbighshire 016C,W01000208,936,644,292,162,37,93
2011,Denbighshire 016D,W01000209,1065,717,348,188,48,112
2011,Denbighshire 016E,W01000210,994,620,374,245,39,90
2011,Denbighshire 017E,W01000229,1153,662,491,287,40,164
2011,Denbighshire 017F,W01000230,1433,911,522,325,57,140
2011,Denbighshire 017A,W01000231,1014,685,329,155,52,122
2011,Denbighshire 017B,W01000232,1163,796,367,219,39,109
2011,Denbighshire 017C,W01000233,950,647,303,165,46,92
2011,Denbighshire 017G,W01000234,997,631,366,131,69,166
2011,Denbighshire 017D,W01000235,994,727,267,138,48,81
2011,Flintshire 001A,W01000287,1338,791,547,328,68,151
2011,Flintshire 001B,W01000298,1127,663,464,272,37,155
2011,Flintshire 001C,W01000338,1399,946,453,281,67,105
2011,Flintshire 002A,W01000306,1762,1140,622,300,85,237
2011,Flintshire 002B,W01000320,1354,884,470,250,76,144
2011,Flintshire 002C,W01000340,1740,1225,515,332,47,136
2011,Flintshire 003A,W01000253,1434,997,437,223,69,145
2011,Flintshire 003B,W01000254,1591,1039,552,250,58,244
2011,Flintshire 003C,W01000296,1088,699,389,176,38,175
2011,Flintshire 003D,W01000297,898,682,216,77,29,110
2011,Flintshire 003E,W01000304,1370,821,549,230,51,268
2011,Flintshire 003F,W01000305,1330,900,430,245,48,137
2011,Flintshire 004A,W01000288,1561,986,575,238,53,284
2011,Flintshire 004B,W01000290,878,547,331,174,31,126
2011,Flintshire 004C,W01000292,1036,715,321,109,49,163
2011,Flintshire 004D,W01000293,1152,832,320,148,42,130
2011,Flintshire 005A,W01000289,1040,790,250,129,47,74
2011,Flintshire 005B,W01000291,1049,787,262,129,33,100
2011,Flintshire 005C,W01000294,1475,1117,358,221,52,85
2011,Flintshire 005D,W01000295,1165,812,353,209,46,98
2011,Flintshire 006A,W01000258,1635,1130,505,335,61,109
2011,Flintshire 006B,W01000270,997,733,264,154,39,71
2011,Flintshire 006C,W01000271,948,669,279,175,38,66
2011,Flintshire 006D,W01000272,1450,957,493,304,73,116
2011,Flintshire 006E,W01000301,1351,993,358,243,35,80
2011,Flintshire 007A,W01000273,1171,772,399,200,57,142
2011,Flintshire 007B,W01000274,1253,873,380,152,51,177
2011,Flintshire 007C,W01000275,965,730,235,128,37,70
2011,Flintshire 007D,W01000278,1071,705,366,121,50,195
2011,Flintshire 008A,W01000276,1028,854,174,50,46,78
2011,Flintshire 008B,W01000277,1032,832,200,95,35,70
2011,Flintshire 008C,W01000279,932,621,311,224,30,57
2011,Flintshire 008D,W01000281,941,671,270,178,27,65
2011,Flintshire 008E,W01000283,1659,1221,438,245,69,124
2011,Flintshire 009A,W01000332,1171,891,280,127,24,129
2011,Flintshire 009B,W01000333,1009,691,318,115,40,163
2011,Flintshire 009C,W01000334,1486,1057,429,202,53,174
2011,Flintshire 009D,W01000335,766,447,319,125,40,154
2011,Flintshire 009E,W01000336,955,621,334,82,63,189
2011,Flintshire 009F,W01000337,1582,1177,405,196,54,155
2011,Flintshire 010A,W01000252,1244,757,487,370,36,81
2011,Flintshire 010B,W01000280,1090,764,326,207,32,87
2011,Flintshire 010C,W01000282,1244,1055,189,65,64,60
2011,Flintshire 010D,W01000325,1163,804,359,254,39,66
2011,Flintshire 011A,W01000311,1330,969,361,219,43,99
2011,Flintshire 011B,W01000312,1278,848,430,242,49,139
2011,Flintshire 011C,W01000328,1619,1222,397,182,47,168
2011,Flintshire 012A,W01000264,1208,913,295,128,58,109
2011,Flintshire 012B,W01000265,1003,675,328,235,31,62
2011,Flintshire 012C,W01000323,1148,783,365,258,31,76
2011,Flintshire 012D,W01000324,1112,808,304,203,47,54
2011,Flintshire 013A,W01000251,1100,776,324,163,47,114
2011,Flintshire 013B,W01000268,1257,923,334,217,52,65
2011,Flintshire 013C,W01000284,1256,976,280,156,53,71
2011,Flintshire 013D,W01000285,1114,777,337,243,38,56
2011,Flintshire 013E,W01000286,1629,1319,310,167,58,85
2011,Flintshire 013F,W01000302,1324,859,465,320,43,102
2011,Flintshire 014A,W01000249,951,694,257,173,36,48
2011,Flintshire 014B,W01000250,1165,792,373,262,43,68
2011,Flintshire 014C,W01000261,1170,851,319,214,38,67
2011,Flintshire 014D,W01000321,1272,909,363,253,47,63
2011,Flintshire 014E,W01000322,1024,654,370,255,34,81
2011,Flintshire 015A,W01000255,1688,1247,441,260,56,125
2011,Flintshire 015B,W01000256,1145,881,264,120,49,95
2011,Flintshire 015C,W01000257,1659,1235,424,281,54,89
2011,Flintshire 015D,W01000329,976,701,275,110,34,131
2011,Flintshire 015E,W01000330,1521,1128,393,156,42,195
2011,Flintshire 015F,W01000331,1252,932,320,151,45,124
2011,Flintshire 016A,W01000313,1108,781,327,167,46,114
2011,Flintshire 016B,W01000314,776,497,279,151,35,93
2011,Flintshire 016C,W01000315,1371,913,458,291,53,114
2011,Flintshire 016D,W01000316,944,642,302,216,38,48
2011,Flintshire 016E,W01000317,1044,766,278,202,43,33
2011,Flintshire 016F,W01000318,778,513,265,96,48,121
2011,Flintshire 016G,W01000319,1113,745,368,188,46,134
2011,Flintshire 017A,W01000259,1155,801,354,202,29,123
2011,Flintshire 017B,W01000260,1381,1005,376,261,27,88
2011,Flintshire 017C,W01000262,1085,770,315,138,45,132
2011,Flintshire 017D,W01000263,1090,731,359,170,39,150
2011,Flintshire 017E,W01000266,994,712,282,185,25,72
2011,Flintshire 017F,W01000267,1174,823,351,251,27,73
2011,Flintshire 018A,W01000303,1255,916,339,224,45,70
2011,Flintshire 018B,W01000326,1255,896,359,259,36,64
2011,Flintshire 018C,W01000327,1677,1241,436,276,61,99
2011,Flintshire 019A,W01000299,1438,958,480,342,47,91
2011,Flintshire 019B,W01000300,1345,913,432,298,41,93
2011,Flintshire 019C,W01000309,1576,1112,464,243,67,154
2011,Flintshire 019D,W01000339,1199,822,377,230,54,93
2011,Flintshire 020A,W01000269,1159,795,364,221,34,109
2011,Flintshire 020B,W01000307,987,718,269,169,55,45
2011,Flintshire 020C,W01000308,898,638,260,145,46,69
2011,Flintshire 020D,W01000310,1392,979,413,278,59,76
2011,Wrexham 003A,W01000374,1017,649,368,200,36,132
2011,Wrexham 003B,W01000375,1444,1178,266,115,51,100
2011,Wrexham 003C,W01000376,1050,732,318,198,31,89
2011,Wrexham 003D,W01000391,1100,768,332,219,20,93
2011,Wrexham 003E,W01000392,1198,781,417,164,51,202
2011,Wrexham 004A,W01000377,1152,850,302,159,43,100
2011,Wrexham 004B,W01000378,937,585,352,119,55,178
2011,Wrexham 004C,W01000379,1193,756,437,178,45,214
2011,Wrexham 004D,W01000380,1078,765,313,124,41,148
2011,Wrexham 005A,W01000351,1622,1177,445,219,55,171
2011,Wrexham 005B,W01000373,1295,888,407,156,56,195
2011,Wrexham 005C,W01000400,1230,928,302,161,46,95
2011,Wrexham 005D,W01000401,1291,939,352,142,61,149
2011,Wrexham 006A,W01000347,1901,1531,370,174,65,131
2011,Wrexham 006B,W01000348,1008,686,322,125,35,162
2011,Wrexham 006C,W01000362,1119,749,370,154,45,171
2011,Wrexham 006D,W01000363,1071,754,317,183,24,110
2011,Wrexham 006E,W01000364,1240,919,321,195,39,87
2011,Wrexham 007A,W01000343,757,475,282,217,20,45
2011,Wrexham 007B,W01000344,991,612,379,287,26,66
2011,Wrexham 007C,W01000415,1096,744,352,235,33,84
2011,Wrexham 007D,W01000416,987,794,193,114,24,55
2011,Wrexham 008A,W01000368,1461,1011,450,346,35,69
2011,Wrexham 008B,W01000371,944,706,238,96,68,74
2011,Wrexham 008C,W01000372,1195,773,422,122,180,120
2011,Wrexham 008D,W01000387,930,626,304,223,31,50
2011,Wrexham 008E,W01000388,783,521,262,156,43,63
2011,Wrexham 008F,W01000422,1546,1012,534,311,79,144
2011,Wrexham 009A,W01000341,1129,776,353,157,63,133
2011,Wrexham 009B,W01000342,1092,690,402,174,60,168
2011,Wrexham 009C,W01000393,1401,936,465,259,64,142
2011,Wrexham 010A,W01000352,689,442,247,109,44,94
2011,Wrexham 010B,W01000353,954,617,337,90,55,192
2011,Wrexham 010C,W01000413,881,506,375,76,46,253
2011,Wrexham 010D,W01000414,853,565,288,66,41,181
2011,Wrexham 010E,W01000425,1579,899,680,164,76,440
2011,Wrexham 011A,W01000349,1407,1084,323,161,42,120
2011,Wrexham 011B,W01000350,1306,890,416,96,176,144
2011,Wrexham 011C,W01000365,1656,1138,518,301,106,111
2011,Wrexham 011D,W01000402,2134,1598,536,152,185,199
2011,Wrexham 012A,W01000381,840,561,279,152,32,95
2011,Wrexham 012B,W01000382,837,566,271,102,42,127
2011,Wrexham 012D,W01000423,1569,1183,386,106,68,212
2011,Wrexham 012E,W01000424,993,733,260,124,13,123
2011,Wrexham 012F,W01001929,1041,773,268,103,53,112
2011,Wrexham 012G,W01001931,1088,726,362,119,84,159
2011,Wrexham 013A,W01000398,999,656,343,183,40,120
2011,Wrexham 013B,W01000399,869,656,213,144,34,35
2011,Wrexham 013C,W01000406,1557,1021,536,212,66,258
2011,Wrexham 013D,W01000408,854,535,319,144,44,131
2011,Wrexham 014A,W01000366,1045,709,336,164,34,138
2011,Wrexham 014B,W01000367,961,738,223,113,49,61
2011,Wrexham 014C,W01000385,1288,922,366,246,35,85
2011,Wrexham 014D,W01000410,1176,823,353,183,42,128
2011,Wrexham 015A,W01000386,1111,739,372,141,46,185
2011,Wrexham 015B,W01000405,1560,1036,524,209,76,239
2011,Wrexham 015C,W01000411,1119,692,427,187,41,199
2011,Wrexham 015D,W01000412,1206,827,379,184,54,141
2011,Wrexham 016A,W01000394,986,756,230,121,37,72
2011,Wrexham 016B,W01000395,801,558,243,143,31,69
2011,Wrexham 016C,W01000407,1021,743,278,174,36,68
2011,Wrexham 016D,W01000419,1108,777,331,130,50,151
2011,Wrexham 016E,W01000420,1022,741,281,134,44,103
2011,Wrexham 017A,W01000354,1305,868,437,255,57,125
2011,Wrexham 017B,W01000355,1156,731,425,211,36,178
2011,Wrexham 017C,W01000356,1236,789,447,200,55,192
2011,Wrexham 017D,W01000389,1481,1026,455,261,60,134
2011,Wrexham 017E,W01000409,1329,766,563,169,71,323
2011,Wrexham 018A,W01000345,1199,817,382,267,44,71
2011,Wrexham 018B,W01000346,1182,843,339,196,58,85
2011,Wrexham 018C,W01000403,974,693,281,164,51,66
2011,Wrexham 018D,W01000404,1414,1030,384,210,55,119
2011,Wrexham 019C,W01000359,908,652,256,142,39,75
2011,Wrexham 019D,W01000360,860,559,301,137,43,121
2011,Wrexham 019E,W01000361,1465,1034,431,219,58,154
2011,Wrexham 019F,W01001930,1601,1107,494,273,72,149
2011,Wrexham 020F,W01000369,888,567,321,232,30,59
2011,Wrexham 020G,W01000370,1005,704,301,196,24,81
2011,Wrexham 020A,W01000383,1802,1437,365,187,66,112
2011,Wrexham 020B,W01000384,780,565,215,162,22,31
2011,Wrexham 020C,W01000390,1272,839,433,272,65,96
2011,Wrexham 020H,W01000396,915,640,275,178,43,54
2011,Wrexham 020I,W01000397,774,528,246,184,29,33
2011,Wrexham 020D,W01000417,1188,845,343,241,43,59
2011,Wrexham 020E,W01000418,1189,852,337,212,41,84
2011,Powys 001A,W01000461,1080,761,319,173,34,112
2011,Powys 001D,W01000470,1333,933,400,241,49,110
2011,Powys 001E,W01000475,1771,1290,481,308,68,105
2011,Powys 001F,W01001906,1456,1016,440,292,58,90
2011,Powys 001G,W01001907,1029,755,274,160,51,63
2011,Powys 002A,W01000444,1641,1207,434,289,42,103
2011,Powys 002B,W01000457,1575,1160,415,266,48,101
2011,Powys 002C,W01000458,1291,919,372,225,36,111
2011,Powys 003A,W01000498,1080,769,311,143,28,140
2011,Powys 003B,W01000499,906,619,287,123,34,130
2011,Powys 003C,W01000500,1142,819,323,164,53,106
2011,Powys 003D,W01000501,1577,1077,500,296,45,159
2011,Powys 004A,W01000442,1503,1093,410,254,46,110
2011,Powys 004B,W01000452,1429,938,491,300,63,128
2011,Powys 004C,W01000473,1579,1114,465,250,39,176
2011,Powys 005A,W01000428,988,742,246,165,31,50
2011,Powys 005B,W01000441,1008,733,275,183,28,64
2011,Powys 005C,W01000476,945,649,296,194,39,63
2011,Powys 005D,W01000497,1011,725,286,184,25,77
2011,Powys 006A,W01000433,1725,1188,537,334,60,143
2011,Powys 006B,W01000460,1312,943,369,187,66,116
2011,Powys 006C,W01000488,1635,1192,443,282,53,108
2011,Powys 007A,W01000434,1212,834,378,237,38,103
2011,Powys 007B,W01000439,1463,1073,390,266,52,72
2011,Powys 007C,W01000447,1465,1082,383,241,52,90
2011,Powys 008A,W01000480,1517,1115,402,157,52,193
2011,Powys 008B,W01000481,1671,1210,461,292,44,125
2011,Powys 008C,W01000482,1334,956,378,225,43,110
2011,Powys 009A,W01000478,1200,830,370,114,61,195
2011,Powys 009B,W01000479,1009,685,324,117,47,160
2011,Powys 009C,W01000483,1303,812,491,178,64,249
2011,Powys 010A,W01000429,1717,1202,515,327,58,130
2011,Powys 010B,W01000453,1053,778,275,191,33,51
2011,Powys 010C,W01000466,958,652,306,179,40,87
2011,Powys 010D,W01000467,1105,790,315,180,38,97
2011,Powys 011A,W01000427,1038,733,305,183,27,95
2011,Powys 011B,W01000448,1007,707,300,175,31,94
2011,Powys 011C,W01000449,1165,834,331,196,51,84
2011,Powys 011D,W01000464,934,662,272,193,28,51
2011,Powys 011E,W01000484,1186,789,397,250,59,88
2011,Powys 011F,W01000485,1124,693,431,324,36,71
2011,Powys 011G,W01000486,787,581,206,115,31,60
2011,Powys 012A,W01000438,904,504,400,263,28,109
2011,Powys 012B,W01000451,808,554,254,168,29,57
2011,Powys 012C,W01000472,835,558,277,212,20,45
2011,Powys 012D,W01000477,1116,746,370,264,38,68
2011,Powys 012E,W01000487,1419,967,452,271,37,144
2011,Powys 013A,W01000454,880,550,330,175,32,123
2011,Powys 013B,W01000455,1481,1006,475,255,56,164
2011,Powys 013C,W01000456,1391,851,540,334,45,161
2011,Powys 014A,W01000431,960,733,227,99,49,79
2011,Powys 014B,W01000432,842,611,231,148,41,42
2011,Powys 014C,W01000450,990,728,262,174,36,52
2011,Powys 014D,W01000459,873,640,233,146,34,53
2011,Powys 014E,W01000471,1398,979,419,255,41,123
2011,Powys 015A,W01000430,930,661,269,153,36,80
2011,Powys 015B,W01000443,1698,1227,471,328,47,96
2011,Powys 015C,W01000445,1153,837,316,198,32,86
2011,Powys 015D,W01000446,1136,820,316,193,31,92
2011,Powys 015E,W01000494,1234,915,319,187,39,93
2011,Powys 017A,W01000489,1254,824,430,176,138,116
2011,Powys 017D,W01000492,1175,853,322,202,37,83
2011,Powys 017E,W01000493,1057,757,300,172,45,83
2011,Powys 017F,W01001901,1331,916,415,255,49,111
2011,Powys 017G,W01001902,1003,683,320,117,51,152
2011,Powys 018E,W01000465,746,469,277,186,30,61
2011,Powys 018F,W01001903,1530,986,544,379,66,99
2011,Powys 018G,W01001904,1266,847,419,254,47,118
2011,Powys 018H,W01001905,1538,1106,432,272,68,92
2011,Powys 020A,W01000440,1014,747,267,180,39,48
2011,Powys 020B,W01000474,1297,966,331,203,37,91
2011,Powys 020C,W01000503,786,570,216,144,29,43
2011,Powys 020D,W01001897,1390,985,405,261,49,95
2011,Powys 021A,W01000426,1042,663,379,210,45,124
2011,Powys 021B,W01000496,1526,979,547,341,52,154
2011,Powys 021C,W01000502,1490,887,603,365,53,185
2011,Powys 021D,W01000504,847,490,357,136,48,173
2011,Powys 021E,W01000505,1023,659,364,192,34,138
2011,Powys 021F,W01001899,1442,912,530,262,70,198
2011,Ceredigion 001C,W01000523,1421,994,427,249,73,105
2011,Ceredigion 001D,W01000548,1304,884,420,248,63,109
2011,Ceredigion 001E,W01000549,1303,990,313,186,63,64
2011,Ceredigion 001F,W01001937,1551,1031,520,331,70,119
2011,Ceredigion 002A,W01000512,1812,838,974,111,809,54
2011,Ceredigion 002B,W01000513,2306,1110,1196,50,1042,104
2011,Ceredigion 002D,W01000517,1296,626,670,64,535,71
2011,Ceredigion 002F,W01001934,3532,1494,2038,195,1711,132
2011,Ceredigion 003A,W01000515,1040,691,349,124,70,155
2011,Ceredigion 003B,W01000516,1208,797,411,158,85,168
2011,Ceredigion 003C,W01000518,956,593,363,127,175,61
2011,Ceredigion 003E,W01001935,862,583,279,85,147,47
2011,Ceredigion 003F,W01001936,2008,858,1150,125,949,76
2011,Ceredigion 005A,W01000506,985,601,384,257,33,94
2011,Ceredigion 005B,W01000524,1454,990,464,283,57,124
2011,Ceredigion 005C,W01000538,1182,839,343,214,51,78
2011,Ceredigion 005D,W01000539,950,613,337,195,59,83
2011,Ceredigion 005E,W01000540,813,519,294,181,40,73
2011,Ceredigion 007A,W01000529,1161,782,379,196,50,133
2011,Ceredigion 007B,W01000532,1449,916,533,349,60,124
2011,Ceredigion 007C,W01000544,776,471,305,191,27,87
2011,Ceredigion 007D,W01000545,1534,965,569,368,62,139
2011,Ceredigion 008A,W01000527,1219,625,594,72,455,67
2011,Ceredigion 008B,W01000528,1013,689,324,149,57,118
2011,Ceredigion 008C,W01000535,1481,911,570,336,59,175
2011,Ceredigion 008D,W01000537,1113,722,391,240,47,104
2011,Ceredigion 008E,W01000541,1390,921,469,264,79,126
2011,Ceredigion 009A,W01000507,848,508,340,233,35,72
2011,Ceredigion 009B,W01000508,856,509,347,170,41,136
2011,Ceredigion 009C,W01000509,1224,707,517,310,57,150
2011,Ceredigion 009D,W01000510,835,499,336,170,31,135
2011,Ceredigion 009E,W01000511,866,552,314,83,50,181
2011,Ceredigion 009F,W01000546,822,484,338,204,29,105
2011,Ceredigion 009G,W01000547,857,554,303,184,21,98
2011,Ceredigion 010A,W01000519,1225,795,430,277,42,111
2011,Ceredigion 010B,W01000522,987,617,370,215,51,104
2011,Ceredigion 010C,W01000531,1309,814,495,289,59,147
2011,Ceredigion 010D,W01000533,1022,636,386,193,61,132
2011,Ceredigion 010E,W01000551,973,598,375,238,56,81
2011,Ceredigion 011A,W01000525,820,498,322,201,92,29
2011,Ceredigion 011B,W01000534,1111,789,322,193,39,90
2011,Ceredigion 011E,W01000536,1069,683,386,257,38,91
2011,Ceredigion 011F,W01000542,1644,1080,564,313,66,185
2011,Ceredigion 011C,W01000543,1493,1057,436,263,45,128
2011,Ceredigion 011G,W01000550,842,569,273,164,28,81
2011,Ceredigion 011D,W01000552,1483,1062,421,245,66,110
2011,Pembrokeshire 001A,W01000558,1479,996,483,278,51,154
2011,Pembrokeshire 001B,W01000559,1072,723,349,201,42,106
2011,Pembrokeshire 001C,W01000560,917,653,264,150,35,79
2011,Pembrokeshire 001D,W01000561,919,637,282,156,43,83
2011,Pembrokeshire 001E,W01000613,1609,1022,587,354,68,165
2011,Pembrokeshire 002A,W01000562,1263,855,408,241,51,116
2011,Pembrokeshire 002B,W01000565,1281,782,499,293,58,148
2011,Pembrokeshire 002C,W01000566,1095,693,402,220,37,145
2011,Pembrokeshire 002D,W01000567,1430,944,486,251,47,188
2011,Pembrokeshire 002E,W01000597,798,470,328,211,22,95
2011,Pembrokeshire 002F,W01000617,1065,742,323,166,38,119
2011,Pembrokeshire 003A,W01000579,1671,1094,577,341,66,170
2011,Pembrokeshire 003B,W01000581,1114,780,334,195,39,100
2011,Pembrokeshire 003C,W01000612,1339,887,452,229,57,166
2011,Pembrokeshire 003D,W01000618,1431,1033,398,232,42,124
2011,Pembrokeshire 004A,W01000582,1234,828,406,242,58,106
2011,Pembrokeshire 004B,W01000583,1027,714,313,175,46,92
2011,Pembrokeshire 004C,W01000611,1218,814,404,281,50,73
2011,Pembrokeshire 004D,W01000623,1418,1009,409,251,56,102
2011,Pembrokeshire 005A,W01000568,1767,1251,516,215,60,241
2011,Pembrokeshire 005B,W01000569,896,657,239,94,32,113
2011,Pembrokeshire 005C,W01000570,974,674,300,44,42,214
2011,Pembrokeshire 005D,W01000572,1315,908,407,221,59,127
2011,Pembrokeshire 006A,W01000571,1548,1022,526,301,59,166
2011,Pembrokeshire 006B,W01000573,1790,1333,457,273,41,143
2011,Pembrokeshire 006C,W01000586,1582,1066,516,231,65,220
2011,Pembrokeshire 007A,W01000577,1167,792,375,212,62,101
2011,Pembrokeshire 007B,W01000585,1040,761,279,164,46,69
2011,Pembrokeshire 007C,W01000595,1343,904,439,250,52,137
2011,Pembrokeshire 007D,W01000596,1097,756,341,197,46,98
2011,Pembrokeshire 008A,W01000555,1071,727,344,211,36,97
2011,Pembrokeshire 008B,W01000556,846,559,287,214,17,56
2011,Pembrokeshire 008C,W01000575,1755,1198,557,310,52,195
2011,Pembrokeshire 008D,W01000614,1049,702,347,223,40,84
2011,Pembrokeshire 008E,W01000622,1099,778,321,212,38,71
2011,Pembrokeshire 009A,W01000554,1353,894,459,286,41,132
2011,Pembrokeshire 009B,W01000580,1698,1140,558,357,71,130
2011,Pembrokeshire 009C,W01000598,1627,1046,581,347,37,197
2011,Pembrokeshire 009D,W01000599,1560,973,587,302,56,229
2011,Pembrokeshire 010A,W01000587,1475,960,515,298,44,173
2011,Pembrokeshire 010B,W01000588,1510,1017,493,213,60,220
2011,Pembrokeshire 010C,W01000593,1960,1263,697,373,64,260
2011,Pembrokeshire 011A,W01000553,935,564,371,246,35,90
2011,Pembrokeshire 011B,W01000563,883,571,312,156,35,121
2011,Pembrokeshire 011C,W01000564,848,558,290,171,33,86
2011,Pembrokeshire 011D,W01000576,1581,939,642,389,76,177
2011,Pembrokeshire 011E,W01000615,1076,630,446,326,41,79
2011,Pembrokeshire 011F,W01000616,790,501,289,193,27,69
2011,Pembrokeshire 012A,W01000589,786,560,226,112,29,85
2011,Pembrokeshire 012B,W01000590,784,466,318,199,30,89
2011,Pembrokeshire 012C,W01000591,875,585,290,150,39,101
2011,Pembrokeshire 012D,W01000592,900,597,303,108,46,149
2011,Pembrokeshire 012E,W01000594,1594,1000,594,231,67,296
2011,Pembrokeshire 013A,W01000600,1198,759,439,194,41,204
2011,Pembrokeshire 013B,W01000601,1056,574,482,173,42,267
2011,Pembrokeshire 013C,W01000602,923,593,330,167,35,128
2011,Pembrokeshire 013D,W01000603,1370,926,444,188,51,205
2011,Pembrokeshire 013E,W01000604,1098,715,383,185,46,152
2011,Pembrokeshire 013F,W01000605,1345,922,423,193,65,165
2011,Pembrokeshire 014A,W01000557,1107,801,306,175,36,95
2011,Pembrokeshire 014B,W01000578,1235,784,451,309,28,114
2011,Pembrokeshire 014C,W01000584,1506,912,594,341,67,186
2011,Pembrokeshire 014D,W01000609,1750,1022,728,524,44,160
2011,Pembrokeshire 015A,W01000574,1418,919,499,293,59,147
2011,Pembrokeshire 015B,W01000606,1119,649,470,157,48,265
2011,Pembrokeshire 015C,W01000607,1397,849,548,237,50,261
2011,Pembrokeshire 015D,W01000608,1037,661,376,193,37,146
2011,Pembrokeshire 016A,W01000610,1204,747,457,291,52,114
2011,Pembrokeshire 016B,W01000619,1491,990,501,304,61,136
2011,Pembrokeshire 016C,W01000620,755,518,237,125,31,81
2011,Pembrokeshire 016D,W01000621,1086,751,335,160,34,141
2011,Carmarthenshire 001A,W01000685,1163,783,380,190,37,153
2011,Carmarthenshire 001B,W01000686,933,639,294,181,28,85
2011,Carmarthenshire 001C,W01000701,1083,745,338,182,39,117
2011,Carmarthenshire 001D,W01000702,881,580,301,155,37,109
2011,Carmarthenshire 002A,W01000647,1133,747,386,230,51,105
2011,Carmarthenshire 002B,W01000650,1228,807,421,229,52,140
2011,Carmarthenshire 002C,W01000678,1006,578,428,222,74,132
2011,Carmarthenshire 002D,W01000679,910,609,301,154,59,88
2011,Carmarthenshire 003A,W01000646,1580,1019,561,287,74,200
2011,Carmarthenshire 003B,W01000688,1309,810,499,251,62,186
2011,Carmarthenshire 003C,W01000689,1209,768,441,296,45,100
2011,Carmarthenshire 003D,W01000728,1580,1068,512,306,71,135
2011,Carmarthenshire 004A,W01000676,1089,729,360,202,63,95
2011,Carmarthenshire 004B,W01000677,968,656,312,142,35,135
2011,Carmarthenshire 004C,W01000687,1433,983,450,262,50,138
2011,Carmarthenshire 004D,W01000709,1686,1090,596,371,69,156
2011,Carmarthenshire 005A,W01000624,1685,1188,497,319,60,118
2011,Carmarthenshire 005B,W01000682,988,688,300,183,32,85
2011,Carmarthenshire 005C,W01000683,839,575,264,154,25,85
2011,Carmarthenshire 005D,W01000684,1353,896,457,284,53,120
2011,Carmarthenshire 006A,W01000643,1151,829,322,135,58,129
2011,Carmarthenshire 006B,W01000644,1439,896,543,114,337,92
2011,Carmarthenshire 006C,W01000645,1162,791,371,155,94,122
2011,Carmarthenshire 006D,W01000648,1114,784,330,189,47,94
2011,Carmarthenshire 006E,W01000649,1150,778,372,253,40,79
2011,Carmarthenshire 007A,W01000637,996,666,330,129,61,140
2011,Carmarthenshire 007B,W01000638,820,537,283,89,41,153
2011,Carmarthenshire 007C,W01000639,985,673,312,128,68,116
2011,Carmarthenshire 007D,W01000640,864,609,255,174,30,51
2011,Carmarthenshire 008A,W01000641,1519,1034,485,223,77,185
2011,Carmarthenshire 008B,W01000642,1196,793,403,232,63,108
2011,Carmarthenshire 008C,W01000693,740,449,291,192,20,79
2011,Carmarthenshire 008D,W01000694,995,645,350,250,36,64
2011,Carmarthenshire 010A,W01000656,1530,935,595,270,66,259
2011,Carmarthenshire 010B,W01000657,798,468,330,171,49,110
2011,Carmarthenshire 010C,W01000658,917,559,358,178,45,135
2011,Carmarthenshire 010D,W01000718,1032,623,409,199,64,146
2011,Carmarthenshire 010E,W01000719,1087,675,412,210,60,142
2011,Carmarthenshire 011A,W01000680,1437,937,500,328,60,112
2011,Carmarthenshire 011B,W01000681,1404,857,547,268,54,225
2011,Carmarthenshire 011C,W01000724,1349,877,472,248,49,175
2011,Carmarthenshire 011D,W01000725,1568,937,631,392,61,178
2011,Carmarthenshire 012A,W01000675,1473,974,499,310,67,122
2011,Carmarthenshire 012B,W01000695,1140,718,422,199,46,177
2011,Carmarthenshire 012C,W01000696,1133,724,409,196,56,157
2011,Carmarthenshire 012D,W01000722,952,639,313,224,29,60
2011,Carmarthenshire 012E,W01000723,1022,654,368,222,39,107
2011,Carmarthenshire 013A,W01000625,841,503,338,144,46,148
2011,Carmarthenshire 013B,W01000626,1012,621,391,200,40,151
2011,Carmarthenshire 013C,W01000627,1524,1004,520,268,63,189
2011,Carmarthenshire 013D,W01000714,1044,649,395,173,58,164
2011,Carmarthenshire 013E,W01000715,959,600,359,212,58,89
2011,Carmarthenshire 015A,W01000697,1328,874,454,222,60,172
2011,Carmarthenshire 015B,W01000698,1343,899,444,223,41,180
2011,Carmarthenshire 015C,W01000699,1161,799,362,203,38,121
2011,Carmarthenshire 015D,W01000712,1113,761,352,192,33,127
2011,Carmarthenshire 015E,W01000713,1025,685,340,154,52,134
2011,Carmarthenshire 016A,W01000662,1616,1022,594,347,68,179
2011,Carmarthenshire 016B,W01000663,1673,1071,602,360,78,164
2011,Carmarthenshire 016C,W01000664,1324,872,452,225,57,170
2011,Carmarthenshire 016D,W01000716,999,673,326,193,37,96
2011,Carmarthenshire 016E,W01000717,1030,629,401,187,55,159
2011,Carmarthenshire 017A,W01000665,1365,969,396,251,54,91
2011,Carmarthenshire 017B,W01000666,1038,712,326,169,21,136
2011,Carmarthenshire 017C,W01000731,1820,1246,574,305,81,188
2011,Carmarthenshire 018A,W01000670,1163,675,488,214,51,223
2011,Carmarthenshire 018B,W01000671,1350,843,507,291,62,154
2011,Carmarthenshire 018C,W01000729,930,528,402,160,43,199
2011,Carmarthenshire 018D,W01000730,966,601,365,161,43,161
2011,Carmarthenshire 019A,W01000690,1261,819,442,267,33,142
2011,Carmarthenshire 019B,W01000691,1164,718,446,267,58,121
2011,Carmarthenshire 019C,W01000692,1139,773,366,189,61,116
2011,Carmarthenshire 019D,W01000726,1165,792,373,238,54,81
2011,Carmarthenshire 019E,W01000727,768,426,342,250,12,80
2011,Carmarthenshire 020A,W01000651,1164,815,349,164,55,130
2011,Carmarthenshire 020B,W01000652,1314,810,504,214,63,227
2011,Carmarthenshire 020C,W01000655,1423,867,556,215,70,271
2011,Carmarthenshire 021A,W01000632,1036,624,412,209,48,155
2011,Carmarthenshire 021B,W01000633,990,580,410,209,39,162
2011,Carmarthenshire 021C,W01000634,987,559,428,304,29,95
2011,Carmarthenshire 021D,W01000710,1601,1036,565,378,54,133
2011,Carmarthenshire 021E,W01000711,1441,825,616,300,63,253
2011,Carmarthenshire 022A,W01000703,1283,867,416,182,49,185
2011,Carmarthenshire 022B,W01000704,1153,723,430,261,42,127
2011,Carmarthenshire 022C,W01000705,1322,806,516,192,62,262
2011,Carmarthenshire 023A,W01000653,1046,661,385,213,49,123
2011,Carmarthenshire 023B,W01000654,1229,836,393,172,55,166
2011,Carmarthenshire 023C,W01000667,988,631,357,202,37,118
2011,Carmarthenshire 023F,W01001925,1686,1069,617,347,78,192
2011,Carmarthenshire 024A,W01000628,1162,790,372,219,40,113
2011,Carmarthenshire 024B,W01000629,1241,862,379,183,40,156
2011,Carmarthenshire 024C,W01000630,1186,800,386,142,53,191
2011,Carmarthenshire 024D,W01000631,1247,704,543,199,45,299
2011,Carmarthenshire 025A,W01000635,1666,1234,432,213,59,160
2011,Carmarthenshire 025B,W01000636,1341,870,471,187,62,222
2011,Carmarthenshire 025C,W01000706,1182,773,409,199,45,165
2011,Carmarthenshire 025D,W01000707,1007,582,425,141,50,234
2011,Carmarthenshire 025E,W01000708,972,560,412,152,41,219
2011,Carmarthenshire 026A,W01000659,1078,653,425,147,46,232
2011,Carmarthenshire 026B,W01000660,1135,659,476,213,44,219
2011,Carmarthenshire 026D,W01000732,1037,727,310,143,34,133
2011,Carmarthenshire 026E,W01000733,927,533,394,122,37,235
2011,Carmarthenshire 026F,W01000734,1033,641,392,111,60,221
2011,Carmarthenshire 026G,W01001923,979,666,313,110,40,163
2011,Carmarthenshire 026H,W01001924,935,563,372,129,37,206
2011,Carmarthenshire 027E,W01000672,1219,804,415,220,50,145
2011,Carmarthenshire 027F,W01000673,879,581,298,158,36,104
2011,Carmarthenshire 027A,W01000674,1570,1061,509,275,71,163
2011,Carmarthenshire 027G,W01000700,1506,976,530,341,64,125
2011,Carmarthenshire 027B,W01000720,1224,836,388,206,27,155
2011,Carmarthenshire 027C,W01000721,952,696,256,117,52,87
2011,Carmarthenshire 027D,W01000735,1639,1154,485,265,76,144
2011,Swansea 001A,W01000845,1458,1066,392,213,63,116
2011,Swansea 001B,W01000846,1249,871,378,171,49,158
2011,Swansea 001C,W01000847,906,599,307,168,38,101
2011,Swansea 001D,W01000848,836,517,319,144,31,144
2011,Swansea 002A,W01000750,1118,669,449,235,46,168
2011,Swansea 002B,W01000751,1066,678,388,265,33,90
2011,Swansea 002C,W01000752,1076,681,395,135,39,221
2011,Swansea 002D,W01000753,1015,686,329,135,55,139
2011,Swansea 002E,W01000754,1170,755,415,202,53,160
2011,Swansea 002F,W01000803,1381,936,445,256,44,145
2011,Swansea 003A,W01000806,1109,717,392,230,38,124
2011,Swansea 003B,W01000807,1161,855,306,166,41,99
2011,Swansea 003C,W01000808,1089,664,425,277,34,114
2011,Swansea 003D,W01000810,940,529,411,148,39,224
2011,Swansea 003E,W01000815,1236,847,389,269,35,85
2011,Swansea 003F,W01000816,1295,981,314,173,55,86
2011,Swansea 004A,W01000791,1123,881,242,117,52,73
2011,Swansea 004B,W01000792,1234,874,360,242,49,69
2011,Swansea 004C,W01000793,1389,1105,284,154,48,82
2011,Swansea 004D,W01000837,1207,848,359,220,40,99
2011,Swansea 004E,W01000838,892,533,359,145,35,179
2011,Swansea 005A,W01000773,1910,1377,533,224,61,248
2011,Swansea 005B,W01000774,1153,752,401,201,38,162
2011,Swansea 005C,W01000841,1092,705,387,196,51,140
2011,Swansea 005D,W01000842,1048,676,372,223,45,104
2011,Swansea 005E,W01000843,1025,708,317,166,41,110
2011,Swansea 005F,W01000844,890,537,353,113,39,201
2011,Swansea 006A,W01000795,1204,919,285,156,35,94
2011,Swansea 006B,W01000796,2007,1620,387,171,68,148
2011,Swansea 006C,W01000800,1130,812,318,203,41,74
2011,Swansea 006D,W01000801,1109,649,460,153,60,247
2011,Swansea 007A,W01000784,959,638,321,200,32,89
2011,Swansea 007B,W01000785,994,687,307,220,37,50
2011,Swansea 007C,W01000786,1044,714,330,232,33,65
2011,Swansea 007D,W01000802,1739,1142,597,285,69,243
2011,Swansea 007E,W01000877,1139,759,380,236,42,102
2011,Swansea 007F,W01000878,898,575,323,178,46,99
2011,Swansea 008A,W01000809,1158,851,307,142,28,137
2011,Swansea 008B,W01000811,1167,764,403,142,43,218
2011,Swansea 008C,W01000812,1068,675,393,136,35,222
2011,Swansea 008D,W01000813,1179,802,377,198,54,125
2011,Swansea 008E,W01000814,1102,697,405,117,51,237
2011,Swansea 009A,W01000817,1256,674,582,174,64,344
2011,Swansea 009B,W01000818,1105,650,455,206,42,207
2011,Swansea 009C,W01000819,1098,683,415,305,35,75
2011,Swansea 009D,W01000820,1047,704,343,196,35,112
2011,Swansea 009E,W01000821,1099,714,385,196,41,148
2011,Swansea 009F,W01000822,931,528,403,278,30,95
2011,Swansea 010A,W01000794,1637,1291,346,138,58,150
2011,Swansea 010B,W01000797,1125,741,384,219,37,128
2011,Swansea 010C,W01000798,1098,662,436,274,38,124
2011,Swansea 010D,W01000799,1341,897,444,112,57,275
2011,Swansea 011A,W01000830,1123,610,513,85,73,355
2011,Swansea 011B,W01000832,1165,700,465,142,50,273
2011,Swansea 011C,W01000833,1164,630,534,129,57,348
2011,Swansea 011D,W01000834,1039,581,458,155,72,231
2011,Swansea 011E,W01000836,1593,1048,545,94,65,386
2011,Swansea 012A,W01000759,1107,760,347,246,25,76
2011,Swansea 012B,W01000777,1322,879,443,308,49,86
2011,Swansea 012C,W01000778,1390,1038,352,183,51,118
2011,Swansea 012D,W01000779,1091,765,326,158,65,103
2011,Swansea 013A,W01000760,1239,878,361,160,55,146
2011,Swansea 013B,W01000761,1138,774,364,139,64,161
2011,Swansea 013C,W01000762,1123,712,411,124,64,223
2011,Swansea 013D,W01000831,1272,753,519,170,47,302
2011,Swansea 013E,W01000835,954,542,412,155,47,210
2011,Swansea 014A,W01000738,1266,725,541,179,52,310
2011,Swansea 014B,W01000739,1424,956,468,136,80,252
2011,Swansea 014C,W01000740,1197,787,410,233,32,145
2011,Swansea 014D,W01000741,1113,654,459,216,48,195
2011,Swansea 015A,W01000763,1094,790,304,121,46,137
2011,Swansea 015B,W01000764,1211,908,303,119,47,137
2011,Swansea 015C,W01000765,1226,848,378,168,53,157
2011,Swansea 015D,W01000766,1119,783,336,148,59,129
2011,Swansea 015E,W01000767,1087,664,423,185,43,195
2011,Swansea 016A,W01000742,1163,649,514,152,46,316
2011,Swansea 016B,W01000744,1193,789,404,123,72,209
2011,Swansea 016C,W01000787,1160,819,341,132,47,162
2011,Swansea 016D,W01000788,1096,747,349,112,44,193
2011,Swansea 016E,W01000789,1067,686,381,114,44,223
2011,Swansea 016F,W01000790,1270,774,496,155,65,276
2011,Swansea 017A,W01000755,1417,939,478,229,65,184
2011,Swansea 017B,W01000756,1168,714,454,149,49,256
2011,Swansea 017C,W01000757,1074,645,429,244,43,142
2011,Swansea 017D,W01000758,1395,939,456,230,72,154
2011,Swansea 018A,W01000772,1149,769,380,225,59,96
2011,Swansea 018B,W01000828,1248,821,427,284,52,91
2011,Swansea 018C,W01000829,1397,922,475,269,62,144
2011,Swansea 019A,W01000862,1099,590,509,81,70,358
2011,Swansea 019B,W01000863,1085,530,555,130,68,357
2011,Swansea 019C,W01000864,1117,596,521,113,69,339
2011,Swansea 019D,W01000865,953,590,363,152,52,159
2011,Swansea 019E,W01000866,827,444,383,109,44,230
2011,Swansea 019F,W01000867,941,519,422,112,59,251
2011,Swansea 020A,W01000768,1037,674,363,230,39,94
2011,Swansea 020B,W01000769,1035,646,389,283,52,54
2011,Swansea 020C,W01000770,1155,804,351,234,49,68
2011,Swansea 020D,W01000771,958,613,345,194,45,106
2011,Swansea 021A,W01000849,1328,807,521,151,77,293
2011,Swansea 021B,W01000850,1793,1125,668,249,160,259
2011,Swansea 021C,W01000851,1178,826,352,135,67,150
2011,Swansea 021D,W01000852,1105,713,392,164,68,160
2011,Swansea 022A,W01000853,1067,730,337,192,73,72
2011,Swansea 022B,W01000854,1033,724,309,146,50,113
2011,Swansea 022C,W01000855,1080,672,408,259,62,87
2011,Swansea 022D,W01000856,1201,693,508,195,74,239
2011,Swansea 022E,W01000857,1178,674,504,252,106,146
2011,Swansea 023B,W01000781,1149,766,383,270,60,53
2011,Swansea 023C,W01000782,751,495,256,160,32,64
2011,Swansea 023E,W01001956,2488,1271,1217,247,882,88
2011,Swansea 024A,W01000747,1637,854,783,90,541,152
2011,Swansea 024B,W01000868,1062,663,399,154,186,59
2011,Swansea 024C,W01000869,1288,750,538,125,252,161
2011,Swansea 024D,W01000870,1357,728,629,105,412,112
2011,Swansea 024E,W01000872,1019,708,311,172,91,48
2011,Swansea 024F,W01000874,1786,887,899,96,718,85
2011,Swansea 025B,W01000745,1970,1077,893,140,475,278
2011,Swansea 025C,W01000746,1487,859,628,140,351,137
2011,Swansea 025E,W01001938,1070,571,499,127,282,90
2011,Swansea 025F,W01001955,1355,662,693,168,214,311
2011,Swansea 025G,W01001957,870,349,521,91,143,287
2011,Swansea 025H,W01001958,1143,635,508,111,278,119
2011,Swansea 026A,W01000749,1378,745,633,194,269,170
2011,Swansea 026B,W01000871,1574,845,729,101,479,149
2011,Swansea 026C,W01000873,1633,792,841,72,661,108
2011,Swansea 026D,W01000875,1819,879,940,94,707,139
2011,Swansea 026E,W01000876,1842,809,1033,76,904,53
2011,Swansea 027A,W01000858,1280,888,392,171,144,77
2011,Swansea 027B,W01000859,994,553,441,294,61,86
2011,Swansea 027C,W01000860,1078,610,468,300,104,64
2011,Swansea 027D,W01000861,1513,661,852,132,683,37
2011,Swansea 028A,W01000736,1163,745,418,295,62,61
2011,Swansea 028B,W01000737,1038,686,352,244,51,57
2011,Swansea 028C,W01000804,986,545,441,305,47,89
2011,Swansea 028D,W01000805,833,576,257,180,39,38
2011,Swansea 029A,W01000879,1264,807,457,304,69,84
2011,Swansea 029B,W01000880,1097,655,442,300,54,88
2011,Swansea 029C,W01000881,939,507,432,206,44,182
2011,Swansea 029D,W01000882,1189,706,483,246,53,184
2011,Swansea 030A,W01000775,1320,908,412,273,51,88
2011,Swansea 030B,W01000776,1325,843,482,326,46,110
2011,Swansea 030C,W01000839,682,437,245,176,27,42
2011,Swansea 030D,W01000840,1166,704,462,350,41,71
2011,Swansea 031A,W01000823,1160,724,436,317,46,73
2011,Swansea 031B,W01000824,1103,665,438,296,47,95
2011,Swansea 031C,W01000825,1089,720,369,211,76,82
2011,Swansea 031D,W01000826,953,628,325,229,39,57
2011,Swansea 031E,W01000827,995,684,311,189,70,52
2011,Neath Port Talbot 002A,W01000918,1433,943,490,259,62,169
2011,Neath Port Talbot 002B,W01000944,885,501,384,178,32,174
2011,Neath Port Talbot 002C,W01000965,1566,949,617,292,64,261
2011,Neath Port Talbot 003A,W01000893,1487,903,584,273,64,247
2011,Neath Port Talbot 003B,W01000925,1080,637,443,174,53,216
2011,Neath Port Talbot 003C,W01000926,1382,882,500,312,36,152
2011,Neath Port Talbot 004A,W01000888,1742,1210,532,239,88,205
2011,Neath Port Talbot 004B,W01000946,1151,737,414,174,73,167
2011,Neath Port Talbot 004C,W01000947,1463,892,571,226,61,284
2011,Neath Port Talbot 004D,W01000948,1352,878,474,236,65,173
2011,Neath Port Talbot 004E,W01000955,933,588,345,208,46,91
2011,Neath Port Talbot 004F,W01000956,892,536,356,256,30,70
2011,Neath Port Talbot 004G,W01000971,1069,684,385,187,59,139
2011,Neath Port Talbot 005A,W01000887,1741,1141,600,250,74,276
2011,Neath Port Talbot 005B,W01000953,1279,773,506,231,45,230
2011,Neath Port Talbot 005C,W01000954,1048,676,372,209,31,132
2011,Neath Port Talbot 005D,W01000970,863,552,311,139,41,131
2011,Neath Port Talbot 006A,W01000902,796,440,356,237,41,78
2011,Neath Port Talbot 006B,W01000903,824,539,285,197,29,59
2011,Neath Port Talbot 006C,W01000904,1133,822,311,219,42,50
2011,Neath Port Talbot 006D,W01000905,1120,766,354,158,56,140
2011,Neath Port Talbot 006E,W01000908,1222,784,438,296,41,101
2011,Neath Port Talbot 007A,W01000906,798,467,331,212,35,84
2011,Neath Port Talbot 007B,W01000907,1235,730,505,225,69,211
2011,Neath Port Talbot 007C,W01000922,1239,777,462,190,54,218
2011,Neath Port Talbot 007D,W01000923,1120,730,390,239,37,114
2011,Neath Port Talbot 008A,W01000934,968,554,414,143,35,236
2011,Neath Port Talbot 008B,W01000935,1214,691,523,187,51,285
2011,Neath Port Talbot 008C,W01000938,975,582,393,245,45,103
2011,Neath Port Talbot 008D,W01000939,915,501,414,170,38,206
2011,Neath Port Talbot 008E,W01000940,931,524,407,157,46,204
2011,Neath Port Talbot 009A,W01000909,873,499,374,213,30,131
2011,Neath Port Talbot 009B,W01000910,1172,772,400,257,49,94
2011,Neath Port Talbot 009C,W01000911,984,689,295,172,41,82
2011,Neath Port Talbot 009D,W01000969,984,675,309,173,58,78
2011,Neath Port Talbot 010A,W01000912,853,566,287,141,36,110
2011,Neath Port Talbot 010B,W01000913,867,599,268,139,28,101
2011,Neath Port Talbot 010C,W01000914,1157,709,448,177,39,232
2011,Neath Port Talbot 010D,W01000915,898,604,294,156,45,93
2011,Neath Port Talbot 010E,W01000916,879,599,280,153,24,103
2011,Neath Port Talbot 010F,W01000917,1994,1434,560,279,85,196
2011,Neath Port Talbot 011A,W01000920,935,563,372,147,48,177
2011,Neath Port Talbot 011B,W01000921,1133,517,616,191,42,383
2011,Neath Port Talbot 011C,W01000924,804,442,362,122,30,210
2011,Neath Port Talbot 011D,W01000930,1017,519,498,178,54,266
2011,Neath Port Talbot 012A,W01000936,1108,700,408,128,55,225
2011,Neath Port Talbot 012B,W01000941,1108,659,449,139,68,242
2011,Neath Port Talbot 012C,W01000942,1329,787,542,159,73,310
2011,Neath Port Talbot 012D,W01000943,1123,772,351,215,39,97
2011,Neath Port Talbot 013A,W01000894,983,636,347,202,32,113
2011,Neath Port Talbot 013B,W01000895,1163,716,447,176,42,229
2011,Neath Port Talbot 013C,W01000896,1178,662,516,135,63,318
2011,Neath Port Talbot 013D,W01000897,963,581,382,174,51,157
2011,Neath Port Talbot 013E,W01000937,1537,969,568,177,54,337
2011,Neath Port Talbot 014A,W01000898,1100,681,419,214,47,158
2011,Neath Port Talbot 014B,W01000899,1270,818,452,273,60,119
2011,Neath Port Talbot 014C,W01000900,1277,743,534,220,56,258
2011,Neath Port Talbot 014D,W01000901,1250,764,486,232,52,202
2011,Neath Port Talbot 014E,W01000945,844,541,303,145,27,131
2011,Neath Port Talbot 015A,W01000889,1367,891,476,293,56,127
2011,Neath Port Talbot 015B,W01000890,1241,812,429,269,53,107
2011,Neath Port Talbot 015C,W01000891,1059,703,356,166,37,153
2011,Neath Port Talbot 015D,W01000892,1353,856,497,331,41,125
2011,Neath Port Talbot 016A,W01000883,1149,785,364,211,37,116
2011,Neath Port Talbot 016B,W01000958,1151,588,563,148,52,363
2011,Neath Port Talbot 016C,W01000961,1112,657,455,207,40,208
2011,Neath Port Talbot 016D,W01000962,1103,594,509,132,54,323
2011,Neath Port Talbot 016E,W01000963,1196,624,572,167,73,332
2011,Neath Port Talbot 016F,W01000964,1217,673,544,205,62,277
2011,Neath Port Talbot 017A,W01000884,926,575,351,124,36,191
2011,Neath Port Talbot 017B,W01000885,980,541,439,158,49,232
2011,Neath Port Talbot 017C,W01000886,1122,679,443,124,46,273
2011,Neath Port Talbot 017D,W01000957,1226,618,608,262,52,294
2011,Neath Port Talbot 017E,W01000959,1357,902,455,209,70,176
2011,Neath Port Talbot 017F,W01000960,1268,775,493,175,56,262
2011,Neath Port Talbot 018A,W01000949,1019,668,351,193,36,122
2011,Neath Port Talbot 018B,W01000950,1178,816,362,156,40,166
2011,Neath Port Talbot 018C,W01000951,1183,797,386,141,49,196
2011,Neath Port Talbot 018D,W01000952,863,613,250,105,35,110
2011,Neath Port Talbot 018E,W01000966,1081,646,435,240,41,154
2011,Neath Port Talbot 019A,W01000932,779,477,302,154,30,118
2011,Neath Port Talbot 019B,W01000933,1449,1083,366,202,57,107
2011,Neath Port Talbot 019C,W01000967,1102,657,445,176,46,223
2011,Neath Port Talbot 019D,W01000968,1444,930,514,252,52,210
2011,Neath Port Talbot 020A,W01000919,880,553,327,168,44,115
2011,Neath Port Talbot 020B,W01000927,1233,806,427,178,55,194
2011,Neath Port Talbot 020C,W01000928,1185,724,461,187,55,219
2011,Neath Port Talbot 020D,W01000929,953,541,412,175,51,186
2011,Neath Port Talbot 020E,W01000931,966,603,363,154,39,170
2011,Neath Port Talbot 020F,W01000973,1070,635,435,192,43,200
2011,Neath Port Talbot 020G,W01001900,1135,683,452,178,39,235
2011,Bridgend 001A,W01000991,819,367,452,124,39,289
2011,Bridgend 001B,W01000992,1098,585,513,171,41,301
2011,Bridgend 001C,W01000993,1091,609,482,167,39,276
2011,Bridgend 001D,W01000994,1030,618,412,157,51,204
2011,Bridgend 001E,W01000995,1080,650,430,233,38,159
2011,Bridgend 002A,W01001014,1214,723,491,225,63,203
2011,Bridgend 002B,W01001015,1089,633,456,175,66,215
2011,Bridgend 002C,W01001017,1077,736,341,185,46,110
2011,Bridgend 002D,W01001018,1048,639,409,163,40,206
2011,Bridgend 002E,W01001020,1096,696,400,153,35,212
2011,Bridgend 003A,W01000976,802,487,315,112,31,172
2011,Bridgend 003B,W01000977,1057,646,411,164,42,205
2011,Bridgend 003C,W01001024,870,534,336,142,33,161
2011,Bridgend 003D,W01001025,916,599,317,152,30,135
2011,Bridgend 003E,W01001033,1261,855,406,210,46,150
2011,Bridgend 003F,W01001034,1044,686,358,157,50,151
2011,Bridgend 004A,W01000975,1593,886,707,205,71,431
2011,Bridgend 004B,W01000978,1309,846,463,197,78,188
2011,Bridgend 004C,W01001009,946,604,342,158,34,150
2011,Bridgend 004D,W01001042,979,639,340,136,47,157
2011,Bridgend 004E,W01001043,875,548,327,147,30,150
2011,Bridgend 005A,W01001012,1164,817,347,169,63,115
2011,Bridgend 005B,W01001013,1083,635,448,228,44,176
2011,Bridgend 005C,W01001016,1252,677,575,370,36,169
2011,Bridgend 005D,W01001019,1107,652,455,192,49,214
2011,Bridgend 006A,W01000974,1572,1129,443,217,63,163
2011,Bridgend 006B,W01001057,1113,697,416,167,41,208
2011,Bridgend 006C,W01001058,1420,1032,388,205,59,124
2011,Bridgend 007A,W01000986,1011,766,245,115,37,93
2011,Bridgend 007B,W01000987,1651,1087,564,237,67,260
2011,Bridgend 007C,W01001055,895,498,397,157,33,207
2011,Bridgend 007D,W01001056,966,586,380,200,34,146
2011,Bridgend 008A,W01000996,1132,717,415,203,54,158
2011,Bridgend 008B,W01001048,1069,770,299,162,35,102
2011,Bridgend 008C,W01001049,952,542,410,159,44,207
2011,Bridgend 008D,W01001050,1159,771,388,159,49,180
2011,Bridgend 008E,W01001051,1305,848,457,200,58,199
2011,Bridgend 008F,W01001052,975,624,351,151,43,157
2011,Bridgend 009A,W01001004,803,473,330,161,40,129
2011,Bridgend 009B,W01001005,1248,887,361,205,40,116
2011,Bridgend 009C,W01001006,1801,1210,591,387,63,141
2011,Bridgend 009D,W01001007,1296,855,441,221,58,162
2011,Bridgend 009E,W01001039,1264,886,378,200,45,133
2011,Bridgend 009F,W01001040,1122,770,352,207,44,101
2011,Bridgend 010A,W01000999,1019,586,433,221,51,161
2011,Bridgend 010B,W01001000,1292,885,407,204,48,155
2011,Bridgend 010C,W01001001,1037,617,420,250,28,142
2011,Bridgend 010D,W01001002,1795,1153,642,197,77,368
2011,Bridgend 011A,W01000998,2281,965,1316,173,60,1083
2011,Bridgend 011B,W01001008,1604,1037,567,397,55,115
2011,Bridgend 011C,W01001038,1528,1014,514,248,69,197
2011,Bridgend 012A,W01000997,1135,710,425,269,43,113
2011,Bridgend 012B,W01001010,924,629,295,120,39,136
2011,Bridgend 012C,W01001011,1024,732,292,133,47,112
2011,Bridgend 012D,W01001026,1402,854,548,210,70,268
2011,Bridgend 013A,W01000989,1030,694,336,200,42,94
2011,Bridgend 013B,W01001037,1176,771,405,231,65,109
2011,Bridgend 013C,W01001041,1822,1230,592,351,77,164
2011,Bridgend 014A,W01001021,1217,798,419,203,41,175
2011,Bridgend 014B,W01001022,983,575,408,168,34,206
2011,Bridgend 014C,W01001023,1292,795,497,206,70,221
2011,Bridgend 014D,W01001028,1421,955,466,289,72,105
2011,Bridgend 014E,W01001035,1206,797,409,148,50,211
2011,Bridgend 015A,W01000979,1270,983,287,106,64,117
2011,Bridgend 015B,W01000983,1171,935,236,109,47,80
2011,Bridgend 015C,W01000985,1093,845,248,107,70,71
2011,Bridgend 015D,W01001003,988,584,404,297,31,76
2011,Bridgend 016A,W01000980,1094,787,307,121,46,140
2011,Bridgend 016B,W01000981,825,483,342,79,58,205
2011,Bridgend 016C,W01000982,1152,781,371,218,49,104
2011,Bridgend 016D,W01000984,1634,1269,365,168,43,154
2011,Bridgend 017B,W01000990,1093,699,394,179,39,176
2011,Bridgend 017C,W01001027,1079,685,394,246,33,115
2011,Bridgend 017D,W01001036,1162,814,348,204,61,83
2011,Bridgend 017E,W01001918,1085,929,156,62,43,51
2011,Bridgend 017F,W01001919,1020,847,173,68,43,62
2011,Bridgend 017G,W01001920,893,725,168,73,39,56
2011,Bridgend 017H,W01001921,1085,846,239,76,44,119
2011,Bridgend 018A,W01001031,1062,680,382,259,45,78
2011,Bridgend 018B,W01001032,1213,763,450,305,39,106
2011,Bridgend 018C,W01001046,1245,743,502,278,49,175
2011,Bridgend 018D,W01001047,1189,722,467,267,40,160
2011,Bridgend 018E,W01001053,736,410,326,246,23,57
2011,Bridgend 018F,W01001054,809,480,329,226,34,69
2011,Bridgend 019A,W01001029,1279,784,495,333,40,122
2011,Bridgend 019B,W01001030,1299,840,459,307,46,106
2011,Bridgend 019C,W01001044,1192,657,535,255,58,222
2011,Bridgend 019D,W01001045,1295,846,449,192,57,200
2011,The Vale of Glamorgan 001A,W01001105,1926,1339,587,360,86,141
2011,The Vale of Glamorgan 001B,W01001127,885,568,317,229,33,55
2011,The Vale of Glamorgan 001C,W01001128,1096,734,362,231,54,77
2011,The Vale of Glamorgan 002A,W01001082,1057,657,400,297,34,69
2011,The Vale of Glamorgan 002B,W01001083,1161,755,406,302,41,63
2011,The Vale of Glamorgan 002C,W01001084,1134,738,396,271,45,80
2011,The Vale of Glamorgan 002D,W01001085,1107,770,337,213,49,75
2011,The Vale of Glamorgan 003A,W01001113,1677,1113,564,345,79,140
2011,The Vale of Glamorgan 003B,W01001119,1270,934,336,196,63,77
2011,The Vale of Glamorgan 003C,W01001135,1072,747,325,193,51,81
2011,The Vale of Glamorgan 003D,W01001136,854,583,271,199,26,46
2011,The Vale of Glamorgan 004A,W01001075,864,619,245,135,44,66
2011,The Vale of Glamorgan 004B,W01001076,1089,827,262,118,37,107
2011,The Vale of Glamorgan 004C,W01001077,1049,666,383,247,44,92
2011,The Vale of Glamorgan 004D,W01001078,900,642,258,143,48,67
2011,The Vale of Glamorgan 004E,W01001104,1491,1049,442,281,58,103
2011,The Vale of Glamorgan 004F,W01001129,951,683,268,116,55,97
2011,The Vale of Glamorgan 005A,W01001116,1348,905,443,291,74,78
2011,The Vale of Glamorgan 005B,W01001123,1201,882,319,206,44,69
2011,The Vale of Glamorgan 005C,W01001124,1118,835,283,124,45,114
2011,The Vale of Glamorgan 005D,W01001125,1013,727,286,147,45,94
2011,The Vale of Glamorgan 005E,W01001126,1611,1246,365,192,59,114
2011,The Vale of Glamorgan 005F,W01001130,904,658,246,108,50,88
2011,The Vale of Glamorgan 006A,W01001086,1086,757,329,234,37,58
2011,The Vale of Glamorgan 006B,W01001087,1107,743,364,250,55,59
2011,The Vale of Glamorgan 006C,W01001088,1274,781,493,288,56,149
2011,The Vale of Glamorgan 006D,W01001089,1069,758,311,212,33,66
2011,The Vale of Glamorgan 006E,W01001090,1092,746,346,231,44,71
2011,The Vale of Glamorgan 007A,W01001081,1070,665,405,152,44,209
2011,The Vale of Glamorgan 007B,W01001092,1218,810,408,176,66,166
2011,The Vale of Glamorgan 007C,W01001094,962,628,334,113,58,163
2011,The Vale of Glamorgan 007D,W01001095,1040,616,424,124,64,236
2011,The Vale of Glamorgan 007E,W01001096,996,636,360,188,41,131
2011,The Vale of Glamorgan 007F,W01001097,1135,702,433,116,69,248
2011,The Vale of Glamorgan 008A,W01001114,1095,710,385,277,40,68
2011,The Vale of Glamorgan 008B,W01001115,1425,997,428,241,64,123
2011,The Vale of Glamorgan 008C,W01001131,1236,834,402,190,47,165
2011,The Vale of Glamorgan 008D,W01001132,1011,735,276,160,55,61
2011,The Vale of Glamorgan 008E,W01001133,1475,976,499,336,71,92
2011,The Vale of Glamorgan 008F,W01001134,870,621,249,170,25,54
2011,The Vale of Glamorgan 009A,W01001067,1004,614,390,185,30,175
2011,The Vale of Glamorgan 009B,W01001068,1321,995,326,116,57,153
2011,The Vale of Glamorgan 009C,W01001070,861,591,270,71,29,170
2011,The Vale of Glamorgan 009D,W01001071,1158,796,362,154,50,158
2011,The Vale of Glamorgan 009E,W01001072,2007,1580,427,218,84,125
2011,The Vale of Glamorgan 010A,W01001091,1279,868,411,277,42,92
2011,The Vale of Glamorgan 010B,W01001098,838,561,277,204,29,44
2011,The Vale of Glamorgan 010C,W01001100,1100,768,332,230,48,54
2011,The Vale of Glamorgan 010D,W01001103,945,686,259,169,36,54
2011,The Vale of Glamorgan 011A,W01001106,1096,745,351,224,56,71
2011,The Vale of Glamorgan 011B,W01001107,1113,698,415,297,37,81
2011,The Vale of Glamorgan 011C,W01001109,1060,667,393,247,48,98
2011,The Vale of Glamorgan 011D,W01001110,1250,647,603,169,375,59
2011,The Vale of Glamorgan 011E,W01001111,1078,702,376,177,55,144
2011,The Vale of Glamorgan 011F,W01001112,1059,823,236,127,50,59
2011,The Vale of Glamorgan 012A,W01001063,1271,924,347,140,40,167
2011,The Vale of Glamorgan 012B,W01001065,1111,777,334,138,56,140
2011,The Vale of Glamorgan 012C,W01001069,1063,724,339,114,32,193
2011,The Vale of Glamorgan 012E,W01001079,1146,785,361,134,47,180
2011,The Vale of Glamorgan 012F,W01001080,1150,808,342,136,49,157
2011,The Vale of Glamorgan 012G,W01001910,1236,913,323,76,49,198
2011,The Vale of Glamorgan 012H,W01001911,844,580,264,95,38,131
2011,The Vale of Glamorgan 013A,W01001062,965,725,240,107,47,86
2011,The Vale of Glamorgan 013B,W01001064,974,562,412,132,56,224
2011,The Vale of Glamorgan 013C,W01001093,1244,770,474,189,58,227
2011,The Vale of Glamorgan 013D,W01001099,932,614,318,144,43,131
2011,The Vale of Glamorgan 013E,W01001101,1078,780,298,116,43,139
2011,The Vale of Glamorgan 013F,W01001102,1080,827,253,122,34,97
2011,The Vale of Glamorgan 014A,W01001108,1256,908,348,169,47,132
2011,The Vale of Glamorgan 014B,W01001117,1049,694,355,216,43,96
2011,The Vale of Glamorgan 014C,W01001118,1743,1272,471,237,82,152
2011,The Vale of Glamorgan 014D,W01001120,1052,784,268,162,34,72
2011,The Vale of Glamorgan 014E,W01001121,1093,695,398,197,55,146
2011,The Vale of Glamorgan 014F,W01001122,2214,1815,399,103,79,217
2011,The Vale of Glamorgan 015A,W01001059,973,653,320,179,38,103
2011,The Vale of Glamorgan 015B,W01001060,1038,703,335,248,37,50
2011,The Vale of Glamorgan 015C,W01001061,1565,1126,439,178,69,192
2011,The Vale of Glamorgan 015D,W01001066,1125,772,353,154,61,138
2011,The Vale of Glamorgan 015E,W01001073,1506,1040,466,159,39,268
2011,Cardiff 001A,W01001777,1029,680,349,215,56,78
2011,Cardiff 001B,W01001778,1369,911,458,297,86,75
2011,Cardiff 001C,W01001794,1073,837,236,107,50,79
2011,Cardiff 001D,W01001799,811,527,284,181,49,54
2011,Cardiff 002A,W01001793,1073,876,197,74,53,70
2011,Cardiff 002B,W01001795,1157,937,220,110,42,68
2011,Cardiff 002C,W01001796,1131,872,259,151,37,71
2011,Cardiff 002D,W01001798,1092,789,303,177,43,83
2011,Cardiff 003A,W01001841,1507,1172,335,152,74,109
2011,Cardiff 003B,W01001842,1307,1111,196,69,50,77
2011,Cardiff 003C,W01001843,1599,1311,288,101,69,118
2011,Cardiff 003D,W01001844,1511,1215,296,130,63,103
2011,Cardiff 004A,W01001849,1083,766,317,205,57,55
2011,Cardiff 004B,W01001852,1264,908,356,255,41,60
2011,Cardiff 004C,W01001853,996,653,343,249,36,58
2011,Cardiff 004D,W01001854,997,643,354,286,20,48
2011,Cardiff 005A,W01001791,1097,777,320,168,45,107
2011,Cardiff 005B,W01001792,1194,802,392,147,50,195
2011,Cardiff 005C,W01001797,1023,764,259,148,42,69
2011,Cardiff 005D,W01001800,1036,699,337,142,49,146
2011,Cardiff 005F,W01001949,978,802,176,56,47,73
2011,Cardiff 005G,W01001953,1081,777,304,121,53,130
2011,Cardiff 006A,W01001820,873,640,233,128,42,63
2011,Cardiff 006C,W01001846,1215,956,259,102,67,90
2011,Cardiff 006D,W01001847,1136,729,407,317,32,58
2011,Cardiff 006E,W01001948,1187,993,194,71,58,65
2011,Cardiff 006F,W01001954,1076,714,362,201,64,97
2011,Cardiff 007A,W01001802,1137,789,348,147,49,152
2011,Cardiff 007B,W01001807,1027,640,387,82,54,251
2011,Cardiff 007C,W01001808,1060,652,408,92,49,267
2011,Cardiff 007D,W01001840,1356,1013,343,162,37,144
2011,Cardiff 008A,W01001730,1055,661,394,255,63,76
2011,Cardiff 008B,W01001731,986,689,297,159,69,69
2011,Cardiff 008C,W01001736,976,654,322,201,43,78
2011,Cardiff 008D,W01001815,1013,728,285,142,44,99
2011,Cardiff 009A,W01001811,967,567,400,103,50,247
2011,Cardiff 009B,W01001816,1831,1370,461,108,75,278
2011,Cardiff 009C,W01001817,1062,772,290,141,45,104
2011,Cardiff 009D,W01001818,1119,851,268,101,31,136
2011,Cardiff 010A,W01001888,1235,918,317,165,50,102
2011,Cardiff 010B,W01001893,1405,1021,384,169,64,151
2011,Cardiff 010C,W01001894,1128,815,313,191,37,85
2011,Cardiff 010D,W01001895,1157,687,470,176,59,235
2011,Cardiff 011A,W01001877,1315,1020,295,130,43,122
2011,Cardiff 011B,W01001878,1114,804,310,117,59,134
2011,Cardiff 011C,W01001882,1315,1038,277,95,63,119
2011,Cardiff 011D,W01001885,1405,1066,339,110,51,178
2011,Cardiff 012A,W01001773,1761,1320,441,165,113,163
2011,Cardiff 012B,W01001848,1004,750,254,164,31,59
2011,Cardiff 012C,W01001850,1325,932,393,259,57,77
2011,Cardiff 012D,W01001851,1019,696,323,220,40,63
2011,Cardiff 013A,W01001879,1279,857,422,107,66,249
2011,Cardiff 013B,W01001880,996,623,373,46,58,269
2011,Cardiff 013C,W01001881,1070,654,416,144,50,222
2011,Cardiff 013D,W01001884,882,521,361,46,55,260
2011,Cardiff 014A,W01001727,862,593,269,186,35,48
2011,Cardiff 014B,W01001728,1113,782,331,247,48,36
2011,Cardiff 014C,W01001729,1605,1267,338,168,66,104
2011,Cardiff 014D,W01001819,1723,1163,560,367,81,112
2011,Cardiff 015A,W01001803,1082,700,382,135,44,203
2011,Cardiff 015B,W01001804,1071,764,307,94,41,172
2011,Cardiff 015C,W01001805,1059,719,340,101,56,183
2011,Cardiff 015D,W01001806,1182,796,386,214,49,123
2011,Cardiff 016A,W01001866,1020,599,421,173,44,204
2011,Cardiff 016B,W01001867,950,575,375,92,42,241
2011,Cardiff 016C,W01001883,1132,686,446,162,46,238
2011,Cardiff 016D,W01001886,854,546,308,86,41,181
2011,Cardiff 017A,W01001809,1005,718,287,149,44,94
2011,Cardiff 017B,W01001810,1160,740,420,126,70,224
2011,Cardiff 017C,W01001812,933,633,300,147,49,104
2011,Cardiff 017D,W01001813,1094,678,416,150,40,226
2011,Cardiff 017E,W01001814,1079,805,274,146,44,84
2011,Cardiff 018A,W01001769,1147,874,273,178,43,52
2011,Cardiff 018B,W01001770,841,588,253,148,46,59
2011,Cardiff 018C,W01001771,1184,862,322,196,46,80
2011,Cardiff 018D,W01001774,991,743,248,159,37,52
2011,Cardiff 019A,W01001732,1104,764,340,192,73,75
2011,Cardiff 019B,W01001733,1679,926,753,162,503,88
2011,Cardiff 019C,W01001734,1050,715,335,169,85,81
2011,Cardiff 019D,W01001735,1105,753,352,188,82,82
2011,Cardiff 020A,W01001887,1124,829,295,166,67,62
2011,Cardiff 020B,W01001889,1092,752,340,191,38,111
2011,Cardiff 020C,W01001891,1152,809,343,190,40,113
2011,Cardiff 020D,W01001892,991,711,280,180,57,43
2011,Cardiff 020E,W01001896,1098,816,282,167,57,58
2011,Cardiff 021A,W01001772,995,690,305,197,45,63
2011,Cardiff 021B,W01001775,1210,900,310,156,47,107
2011,Cardiff 021C,W01001776,977,720,257,128,60,69
2011,Cardiff 021D,W01001890,1258,834,424,168,173,83
2011,Cardiff 022A,W01001863,1128,804,324,147,49,128
2011,Cardiff 022B,W01001864,1102,803,299,183,40,76
2011,Cardiff 022C,W01001865,989,733,256,132,45,79
2011,Cardiff 022D,W01001868,1040,649,391,141,61,189
2011,Cardiff 023A,W01001785,787,466,321,106,51,164
2011,Cardiff 023B,W01001786,1126,786,340,160,54,126
2011,Cardiff 023C,W01001787,1085,753,332,124,51,157
2011,Cardiff 023D,W01001788,1018,618,400,126,65,209
2011,Cardiff 023E,W01001789,1146,851,295,132,54,109
2011,Cardiff 023F,W01001790,850,550,300,142,37,121
2011,Cardiff 024A,W01001821,1422,680,742,134,536,72
2011,Cardiff 024B,W01001826,962,622,340,209,60,71
2011,Cardiff 024C,W01001827,1106,737,369,214,79,76
2011,Cardiff 024D,W01001828,1128,762,366,252,45,69
2011,Cardiff 025A,W01001755,1217,828,389,44,300,45
2011,Cardiff 025B,W01001756,3410,1292,2118,102,1839,177
2011,Cardiff 025C,W01001757,1155,819,336,55,195,86
2011,Cardiff 025D,W01001758,1812,1031,781,67,626,88
2011,Cardiff 026A,W01001779,1084,788,296,195,44,57
2011,Cardiff 026B,W01001780,1395,947,448,157,227,64
2011,Cardiff 026C,W01001781,1245,892,353,179,67,107
2011,Cardiff 026D,W01001782,1068,799,269,164,41,64
2011,Cardiff 026E,W01001783,956,711,245,119,56,70
2011,Cardiff 026F,W01001784,1031,753,278,160,55,63
2011,Cardiff 027A,W01001747,1246,946,300,165,50,85
2011,Cardiff 027B,W01001748,1083,730,353,145,49,159
2011,Cardiff 027C,W01001749,1064,741,323,124,30,169
2011,Cardiff 027D,W01001751,1189,772,417,124,49,244
2011,Cardiff 028A,W01001718,1516,867,649,23,551,75
2011,Cardiff 028B,W01001719,1823,907,916,57,807,52
2011,Cardiff 028C,W01001720,1781,883,898,43,808,47
2011,Cardiff 028D,W01001722,1452,731,721,31,638,52
2011,Cardiff 028E,W01001726,1531,841,690,40,582,68
2011,Cardiff 029A,W01001822,1242,892,350,179,58,113
2011,Cardiff 029B,W01001823,996,792,204,93,59,52
2011,Cardiff 029C,W01001824,1270,925,345,85,122,138
2011,Cardiff 029D,W01001825,1337,1007,330,107,56,167
2011,Cardiff 030A,W01001831,1359,940,419,63,261,95
2011,Cardiff 030B,W01001836,1299,872,427,52,254,121
2011,Cardiff 030C,W01001837,1355,757,598,48,443,107
2011,Cardiff 030D,W01001838,1512,1001,511,60,350,101
2011,Cardiff 030E,W01001839,1383,868,515,66,358,91
2011,Cardiff 031A,W01001750,1156,704,452,198,42,212
2011,Cardiff 031B,W01001752,1216,891,325,185,49,91
2011,Cardiff 031C,W01001753,1160,747,413,125,56,232
2011,Cardiff 031D,W01001754,1223,875,348,174,36,138
2011,Cardiff 032A,W01001721,2682,1000,1682,64,1543,75
2011,Cardiff 032C,W01001724,1917,774,1143,37,1061,45
2011,Cardiff 032D,W01001725,2129,840,1289,15,1222,52
2011,Cardiff 032E,W01001922,1921,673,1248,13,1184,51
2011,Cardiff 032F,W01001939,926,528,398,31,312,55
2011,Cardiff 032G,W01001941,1015,631,384,16,325,43
2011,Cardiff 033A,W01001829,1585,956,629,52,458,119
2011,Cardiff 033B,W01001830,1470,1052,418,36,200,182
2011,Cardiff 033C,W01001832,1714,910,804,34,693,77
2011,Cardiff 033D,W01001833,1285,938,347,106,102,139
2011,Cardiff 033E,W01001834,1365,944,421,78,230,113
2011,Cardiff 033F,W01001835,1370,818,552,144,226,182
2011,Cardiff 034A,W01001858,1368,1092,276,118,61,97
2011,Cardiff 034B,W01001859,1170,925,245,101,61,83
2011,Cardiff 034C,W01001860,1380,1108,272,106,67,99
2011,Cardiff 034D,W01001861,1344,1090,254,79,81,94
2011,Cardiff 035A,W01001714,1074,797,277,145,52,80
2011,Cardiff 035B,W01001715,1248,982,266,133,52,81
2011,Cardiff 035C,W01001716,930,714,216,110,41,65
2011,Cardiff 035D,W01001717,1247,909,338,139,59,140
2011,Cardiff 036A,W01001694,1497,1025,472,81,131,260
2011,Cardiff 036B,W01001695,2887,1423,1464,57,768,639
2011,Cardiff 036C,W01001696,1172,771,401,91,81,229
2011,Cardiff 036D,W01001697,1317,945,372,98,73,201
2011,Cardiff 036E,W01001698,1623,1117,506,83,177,246
2011,Cardiff 037A,W01001870,1024,766,258,87,39,132
2011,Cardiff 037B,W01001871,1079,638,441,92,51,298
2011,Cardiff 037C,W01001875,1949,1433,516,96,116,304
2011,Cardiff 037D,W01001876,1067,651,416,102,43,271
2011,Cardiff 038A,W01001869,1102,777,325,114,41,170
2011,Cardiff 038B,W01001872,1150,800,350,100,63,187
2011,Cardiff 038C,W01001873,1301,875,426,106,82,238
2011,Cardiff 038D,W01001874,1044,642,402,93,45,264
2011,Cardiff 039A,W01001737,1081,608,473,136,51,286
2011,Cardiff 039B,W01001738,870,514,356,72,41,243
2011,Cardiff 039C,W01001739,911,524,387,83,46,258
2011,Cardiff 039D,W01001740,1075,602,473,155,50,268
2011,Cardiff 039E,W01001741,1022,542,480,99,67,314
2011,Cardiff 040A,W01001709,1394,1040,354,101,66,187
2011,Cardiff 040B,W01001710,1224,901,323,133,46,144
2011,Cardiff 040C,W01001711,1125,760,365,147,34,184
2011,Cardiff 040D,W01001712,1154,922,232,86,37,109
2011,Cardiff 040E,W01001713,1333,1016,317,100,72,145
2011,Cardiff 041A,W01001704,1029,573,456,114,67,275
2011,Cardiff 041B,W01001706,922,600,322,146,44,132
2011,Cardiff 041C,W01001707,1379,866,513,149,64,300
2011,Cardiff 041D,W01001746,1061,635,426,136,46,244
2011,Cardiff 042A,W01001855,1292,817,475,95,88,292
2011,Cardiff 042B,W01001856,1459,859,600,67,166,367
2011,Cardiff 042C,W01001857,1326,774,552,151,85,316
2011,Cardiff 042D,W01001862,1333,876,457,88,142,227
2011,Cardiff 043A,W01001742,983,586,397,114,34,249
2011,Cardiff 043B,W01001743,1078,751,327,194,34,99
2011,Cardiff 043C,W01001744,1074,615,459,154,60,245
2011,Cardiff 043D,W01001745,971,727,244,133,31,80
2011,Cardiff 044A,W01001764,1475,905,570,91,252,227
2011,Cardiff 044B,W01001765,979,609,370,85,72,213
2011,Cardiff 044C,W01001766,1152,785,367,90,71,206
2011,Cardiff 044D,W01001767,1207,860,347,85,52,210
2011,Cardiff 044E,W01001768,1102,660,442,71,102,269
2011,Cardiff 045A,W01001702,1336,954,382,123,60,199
2011,Cardiff 045B,W01001703,907,546,361,102,34,225
2011,Cardiff 045C,W01001705,1240,833,407,133,44,230
2011,Cardiff 045D,W01001708,1114,659,455,133,38,284
2011,Cardiff 046A,W01001759,1200,901,299,104,57,138
2011,Cardiff 046B,W01001760,1218,860,358,118,65,175
2011,Cardiff 046C,W01001761,1249,769,480,120,79,281
2011,Cardiff 046D,W01001762,1254,808,446,86,63,297
2011,Cardiff 048A,W01001940,1040,907,133,43,45,45
2011,Cardiff 048B,W01001943,978,845,133,38,54,41
2011,Cardiff 048C,W01001944,931,809,122,15,63,44
2011,Cardiff 048D,W01001945,1239,1112,127,31,50,46
2011,Cardiff 048E,W01001947,1349,1186,163,43,46,74
2011,Cardiff 049A,W01001699,1568,932,636,148,125,363
2011,Cardiff 049B,W01001942,1052,729,323,96,61,166
2011,Cardiff 049C,W01001946,1063,729,334,95,45,194
2011,Cardiff 049D,W01001950,962,797,165,72,40,53
2011,Cardiff 049E,W01001951,907,752,155,28,50,77
2011,Cardiff 049F,W01001952,1027,772,255,35,100,120
2011,Rhondda Cynon Taf 001A,W01001186,1286,873,413,162,68,183
2011,Rhondda Cynon Taf 001B,W01001187,1034,642,392,170,55,167
2011,Rhondda Cynon Taf 001C,W01001188,783,433,350,166,33,151
2011,Rhondda Cynon Taf 001D,W01001221,1027,528,499,175,52,272
2011,Rhondda Cynon Taf 001E,W01001222,1135,564,571,165,73,333
2011,Rhondda Cynon Taf 001F,W01001233,1298,761,537,280,63,194
2011,Rhondda Cynon Taf 002A,W01001148,1198,770,428,187,78,163
2011,Rhondda Cynon Taf 002B,W01001152,1176,723,453,262,51,140
2011,Rhondda Cynon Taf 002C,W01001153,1069,646,423,183,54,186
2011,Rhondda Cynon Taf 002D,W01001155,1103,695,408,171,55,182
2011,Rhondda Cynon Taf 003A,W01001149,1039,660,379,169,76,134
2011,Rhondda Cynon Taf 003B,W01001150,1228,751,477,200,52,225
2011,Rhondda Cynon Taf 003C,W01001151,1214,732,482,342,48,92
2011,Rhondda Cynon Taf 003D,W01001154,1053,607,446,200,55,191
2011,Rhondda Cynon Taf 003E,W01001156,1175,895,280,131,71,78
2011,Rhondda Cynon Taf 004A,W01001147,1284,857,427,222,50,155
2011,Rhondda Cynon Taf 004B,W01001168,1035,599,436,218,46,172
2011,Rhondda Cynon Taf 004C,W01001169,1250,754,496,132,56,308
2011,Rhondda Cynon Taf 004D,W01001170,935,570,365,241,36,88
2011,Rhondda Cynon Taf 005A,W01001137,1765,1095,670,305,96,269
2011,Rhondda Cynon Taf 005B,W01001138,999,569,430,182,61,187
2011,Rhondda Cynon Taf 005C,W01001139,1081,724,357,153,45,159
2011,Rhondda Cynon Taf 005D,W01001140,1065,644,421,200,55,166
2011,Rhondda Cynon Taf 005E,W01001141,1150,673,477,193,65,219
2011,Rhondda Cynon Taf 005F,W01001142,1125,621,504,181,52,271
2011,Rhondda Cynon Taf 006A,W01001204,967,637,330,164,42,124
2011,Rhondda Cynon Taf 006B,W01001205,1162,716,446,215,48,183
2011,Rhondda Cynon Taf 006C,W01001206,1037,619,418,179,50,189
2011,Rhondda Cynon Taf 006D,W01001207,1024,542,482,136,97,249
2011,Rhondda Cynon Taf 006E,W01001208,1142,653,489,218,65,206
2011,Rhondda Cynon Taf 007A,W01001265,1105,669,436,183,71,182
2011,Rhondda Cynon Taf 007B,W01001266,931,489,442,159,54,229
2011,Rhondda Cynon Taf 007C,W01001267,1035,591,444,203,42,199
2011,Rhondda Cynon Taf 007D,W01001268,1020,603,417,181,46,190
2011,Rhondda Cynon Taf 008A,W01001209,977,487,490,137,48,305
2011,Rhondda Cynon Taf 008B,W01001210,1064,605,459,198,52,209
2011,Rhondda Cynon Taf 008C,W01001211,1153,688,465,183,55,227
2011,Rhondda Cynon Taf 008D,W01001212,989,599,390,135,54,201
2011,Rhondda Cynon Taf 009A,W01001175,1025,629,396,183,51,162
2011,Rhondda Cynon Taf 009B,W01001177,949,578,371,187,37,147
2011,Rhondda Cynon Taf 009C,W01001202,1305,667,638,266,59,313
2011,Rhondda Cynon Taf 009D,W01001203,998,469,529,184,57,288
2011,Rhondda Cynon Taf 010A,W01001269,1001,618,383,227,41,115
2011,Rhondda Cynon Taf 010B,W01001270,1045,623,422,212,55,155
2011,Rhondda Cynon Taf 010C,W01001271,1180,696,484,183,56,245
2011,Rhondda Cynon Taf 010D,W01001272,1098,661,437,193,55,189
2011,Rhondda Cynon Taf 010E,W01001273,1215,732,483,244,66,173
2011,Rhondda Cynon Taf 011A,W01001213,940,581,359,178,49,132
2011,Rhondda Cynon Taf 011B,W01001214,958,622,336,194,40,102
2011,Rhondda Cynon Taf 011C,W01001215,760,465,295,135,29,131
2011,Rhondda Cynon Taf 011D,W01001216,1133,716,417,171,62,184
2011,Rhondda Cynon Taf 012A,W01001143,1164,783,381,185,59,137
2011,Rhondda Cynon Taf 012B,W01001144,1143,623,520,148,61,311
2011,Rhondda Cynon Taf 012C,W01001145,1275,851,424,174,55,195
2011,Rhondda Cynon Taf 012D,W01001146,1051,733,318,159,39,120
2011,Rhondda Cynon Taf 013A,W01001176,1081,645,436,193,92,151
2011,Rhondda Cynon Taf 013B,W01001274,934,444,490,133,63,294
2011,Rhondda Cynon Taf 013C,W01001275,1271,794,477,193,56,228
2011,Rhondda Cynon Taf 013D,W01001276,1045,598,447,136,63,248
2011,Rhondda Cynon Taf 014A,W01001200,734,464,270,98,37,135
2011,Rhondda Cynon Taf 014B,W01001201,897,511,386,147,47,192
2011,Rhondda Cynon Taf 014C,W01001260,775,429,346,116,48,182
2011,Rhondda Cynon Taf 014D,W01001285,1057,622,435,212,44,179
2011,Rhondda Cynon Taf 014E,W01001286,1093,722,371,163,54,154
2011,Rhondda Cynon Taf 014F,W01001287,1110,658,452,197,72,183
2011,Rhondda Cynon Taf 014G,W01001288,1073,597,476,157,80,239
2011,Rhondda Cynon Taf 015A,W01001180,1064,616,448,117,54,277
2011,Rhondda Cynon Taf 015B,W01001181,1076,703,373,145,58,170
2011,Rhondda Cynon Taf 015C,W01001282,1429,911,518,212,67,239
2011,Rhondda Cynon Taf 015D,W01001283,1109,707,402,203,44,155
2011,Rhondda Cynon Taf 015E,W01001284,863,652,211,97,50,64
2011,Rhondda Cynon Taf 016A,W01001166,987,573,414,153,47,214
2011,Rhondda Cynon Taf 016B,W01001167,1042,649,393,179,35,179
2011,Rhondda Cynon Taf 016C,W01001247,1231,778,453,225,57,171
2011,Rhondda Cynon Taf 016D,W01001248,1494,943,551,225,122,204
2011,Rhondda Cynon Taf 017A,W01001171,944,616,328,159,44,125
2011,Rhondda Cynon Taf 017B,W01001229,1085,713,372,161,54,157
2011,Rhondda Cynon Taf 017C,W01001230,1096,736,360,178,44,138
2011,Rhondda Cynon Taf 017D,W01001231,1125,726,399,169,59,171
2011,Rhondda Cynon Taf 017E,W01001280,1192,667,525,172,94,259
2011,Rhondda Cynon Taf 017F,W01001281,1230,768,462,228,59,175
2011,Rhondda Cynon Taf 018A,W01001217,855,511,344,110,48,186
2011,Rhondda Cynon Taf 018B,W01001218,1139,781,358,151,59,148
2011,Rhondda Cynon Taf 018C,W01001219,964,521,443,163,60,220
2011,Rhondda Cynon Taf 018D,W01001220,1083,673,410,187,44,179
2011,Rhondda Cynon Taf 018E,W01001259,1182,733,449,194,50,205
2011,Rhondda Cynon Taf 018F,W01001261,963,580,383,148,94,141
2011,Rhondda Cynon Taf 019A,W01001164,1112,784,328,138,44,146
2011,Rhondda Cynon Taf 019B,W01001165,982,664,318,142,48,128
2011,Rhondda Cynon Taf 019C,W01001256,865,599,266,125,35,106
2011,Rhondda Cynon Taf 019D,W01001257,927,626,301,177,36,88
2011,Rhondda Cynon Taf 019E,W01001258,911,622,289,141,44,104
2011,Rhondda Cynon Taf 020A,W01001172,1078,670,408,175,71,162
2011,Rhondda Cynon Taf 020B,W01001173,1034,540,494,171,53,270
2011,Rhondda Cynon Taf 020C,W01001174,998,537,461,149,54,258
2011,Rhondda Cynon Taf 020D,W01001232,1065,629,436,167,65,204
2011,Rhondda Cynon Taf 021A,W01001182,1081,741,340,135,73,132
2011,Rhondda Cynon Taf 021B,W01001183,791,494,297,63,109,125
2011,Rhondda Cynon Taf 021C,W01001227,1004,686,318,196,45,77
2011,Rhondda Cynon Taf 021D,W01001228,1139,729,410,239,60,111
2011,Rhondda Cynon Taf 021E,W01001234,1114,782,332,152,42,138
2011,Rhondda Cynon Taf 021F,W01001235,1139,733,406,183,54,169
2011,Rhondda Cynon Taf 021G,W01001236,1050,741,309,188,33,88
2011,Rhondda Cynon Taf 022A,W01001185,1196,755,441,160,62,219
2011,Rhondda Cynon Taf 022B,W01001237,1049,622,427,168,59,200
2011,Rhondda Cynon Taf 022C,W01001238,1169,592,577,169,101,307
2011,Rhondda Cynon Taf 022D,W01001262,1110,646,464,83,281,100
2011,Rhondda Cynon Taf 022E,W01001263,1492,765,727,94,549,84
2011,Rhondda Cynon Taf 022F,W01001264,1914,871,1043,80,888,75
2011,Rhondda Cynon Taf 023A,W01001178,1261,791,470,193,62,215
2011,Rhondda Cynon Taf 023B,W01001179,1284,667,617,208,63,346
2011,Rhondda Cynon Taf 023C,W01001253,1079,668,411,185,50,176
2011,Rhondda Cynon Taf 023E,W01001255,1158,676,482,159,45,278
2011,Rhondda Cynon Taf 023F,W01001914,1260,984,276,106,81,89
2011,Rhondda Cynon Taf 023G,W01001917,1100,661,439,198,52,189
2011,Rhondda Cynon Taf 024A,W01001249,1044,634,410,195,36,179
2011,Rhondda Cynon Taf 024B,W01001250,1067,650,417,225,41,151
2011,Rhondda Cynon Taf 024C,W01001251,1095,584,511,159,54,298
2011,Rhondda Cynon Taf 024D,W01001252,1189,802,387,214,50,123
2011,Rhondda Cynon Taf 025A,W01001162,1219,766,453,178,53,222
2011,Rhondda Cynon Taf 025B,W01001244,1011,597,414,312,28,74
2011,Rhondda Cynon Taf 025C,W01001245,1014,645,369,266,35,68
2011,Rhondda Cynon Taf 025D,W01001246,1015,608,407,282,32,93
2011,Rhondda Cynon Taf 026A,W01001184,1428,948,480,266,57,157
2011,Rhondda Cynon Taf 026B,W01001239,995,583,412,156,48,208
2011,Rhondda Cynon Taf 026C,W01001240,1468,1103,365,213,53,99
2011,Rhondda Cynon Taf 026D,W01001241,1305,931,374,177,68,129
2011,Rhondda Cynon Taf 027B,W01001196,1209,892,317,170,67,80
2011,Rhondda Cynon Taf 027C,W01001197,937,628,309,204,39,66
2011,Rhondda Cynon Taf 027D,W01001198,1192,907,285,167,44,74
2011,Rhondda Cynon Taf 027E,W01001199,1290,937,353,204,38,111
2011,Rhondda Cynon Taf 027F,W01001915,1215,978,237,114,53,70
2011,Rhondda Cynon Taf 027G,W01001916,1103,910,193,92,38,63
2011,Rhondda Cynon Taf 028A,W01001157,1080,789,291,163,37,91
2011,Rhondda Cynon Taf 028B,W01001158,1158,795,363,169,38,156
2011,Rhondda Cynon Taf 028C,W01001159,972,775,197,75,53,69
2011,Rhondda Cynon Taf 028D,W01001277,933,674,259,167,24,68
2011,Rhondda Cynon Taf 028E,W01001278,780,507,273,101,32,140
2011,Rhondda Cynon Taf 028F,W01001279,840,449,391,181,38,172
2011,Rhondda Cynon Taf 029A,W01001160,1227,894,333,206,36,91
2011,Rhondda Cynon Taf 029B,W01001161,1643,1186,457,177,66,214
2011,Rhondda Cynon Taf 029C,W01001189,1200,811,389,178,46,165
2011,Rhondda Cynon Taf 029D,W01001190,1882,1407,475,229,81,165
2011,Rhondda Cynon Taf 030A,W01001193,927,650,277,202,32,43
2011,Rhondda Cynon Taf 030B,W01001194,1630,1237,393,259,63,71
2011,Rhondda Cynon Taf 030C,W01001195,1147,788,359,178,58,123
2011,Rhondda Cynon Taf 030D,W01001242,966,636,330,213,58,59
2011,Rhondda Cynon Taf 030E,W01001243,981,608,373,164,39,170
2011,Rhondda Cynon Taf 031A,W01001191,1869,1428,441,204,65,172
2011,Rhondda Cynon Taf 031B,W01001192,1024,633,391,154,39,198
2011,Rhondda Cynon Taf 031C,W01001223,1175,830,345,228,45,72
2011,Rhondda Cynon Taf 031D,W01001224,1487,1197,290,172,50,68
2011,Rhondda Cynon Taf 031E,W01001225,1177,827,350,246,41,63
2011,Rhondda Cynon Taf 031F,W01001226,1215,859,356,166,40,150
2011,Merthyr Tydfil 002A,W01001295,1139,683,456,188,48,220
2011,Merthyr Tydfil 002B,W01001296,1325,903,422,216,58,148
2011,Merthyr Tydfil 002C,W01001297,1420,1004,416,147,54,215
2011,Merthyr Tydfil 002D,W01001298,1314,833,481,192,63,226
2011,Merthyr Tydfil 002E,W01001310,1208,802,406,206,43,157
2011,Merthyr Tydfil 002F,W01001311,850,606,244,101,41,102
2011,Merthyr Tydfil 003A,W01001291,1351,970,381,141,77,163
2011,Merthyr Tydfil 003B,W01001294,1288,862,426,277,56,93
2011,Merthyr Tydfil 003C,W01001305,966,642,324,154,57,113
2011,Merthyr Tydfil 003D,W01001306,1179,829,350,174,56,120
2011,Merthyr Tydfil 003E,W01001324,1494,949,545,312,61,172
2011,Merthyr Tydfil 004A,W01001292,1228,715,513,124,58,331
2011,Merthyr Tydfil 004B,W01001293,1222,743,479,208,66,205
2011,Merthyr Tydfil 004C,W01001307,1089,628,461,218,47,196
2011,Merthyr Tydfil 004D,W01001315,1274,798,476,195,62,219
2011,Merthyr Tydfil 005A,W01001314,1573,1077,496,272,53,171
2011,Merthyr Tydfil 005B,W01001316,2164,1608,556,271,97,188
2011,Merthyr Tydfil 005C,W01001317,1227,738,489,262,50,177
2011,Merthyr Tydfil 005D,W01001318,1118,736,382,201,57,124
2011,Merthyr Tydfil 006A,W01001289,1069,658,411,200,34,177
2011,Merthyr Tydfil 006B,W01001302,851,540,311,136,34,141
2011,Merthyr Tydfil 006C,W01001303,882,499,383,98,47,238
2011,Merthyr Tydfil 006D,W01001304,1108,730,378,200,35,143
2011,Merthyr Tydfil 006E,W01001312,1061,607,454,209,60,185
2011,Merthyr Tydfil 006F,W01001313,1173,773,400,167,62,171
2011,Merthyr Tydfil 007A,W01001290,1414,866,548,219,88,241
2011,Merthyr Tydfil 007B,W01001319,1262,913,349,178,71,100
2011,Merthyr Tydfil 007C,W01001320,1151,775,376,154,64,158
2011,Merthyr Tydfil 007D,W01001321,1123,702,421,164,67,190
2011,Merthyr Tydfil 007E,W01001322,1211,797,414,184,41,189
2011,Merthyr Tydfil 008A,W01001299,1145,666,479,127,54,298
2011,Merthyr Tydfil 008B,W01001300,1238,690,548,173,76,299
2011,Merthyr Tydfil 008C,W01001301,1320,754,566,187,77,302
2011,Merthyr Tydfil 008D,W01001308,901,515,386,81,60,245
2011,Merthyr Tydfil 008E,W01001309,911,529,382,146,59,177
2011,Merthyr Tydfil 008F,W01001898,1128,693,435,208,45,182
2011,Caerphilly 001A,W01001374,1088,657,431,162,65,204
2011,Caerphilly 001B,W01001375,1131,681,450,160,60,230
2011,Caerphilly 001C,W01001376,1071,585,486,169,45,272
2011,Caerphilly 001D,W01001406,1483,901,582,259,76,247
2011,Caerphilly 001E,W01001428,929,440,489,148,44,297
2011,Caerphilly 001F,W01001429,869,542,327,153,32,142
2011,Caerphilly 002A,W01001360,995,650,345,169,45,131
2011,Caerphilly 002B,W01001361,926,487,439,145,51,243
2011,Caerphilly 002C,W01001384,1215,811,404,173,42,189
2011,Caerphilly 002D,W01001385,1119,679,440,197,57,186
2011,Caerphilly 002E,W01001386,1217,635,582,204,60,318
2011,Caerphilly 003A,W01001325,1112,658,454,166,52,236
2011,Caerphilly 003B,W01001326,1534,941,593,204,68,321
2011,Caerphilly 003C,W01001362,1518,917,601,300,53,248
2011,Caerphilly 004A,W01001336,1092,645,447,202,52,193
2011,Caerphilly 004B,W01001337,1167,748,419,166,82,171
2011,Caerphilly 004C,W01001338,1292,845,447,171,61,215
2011,Caerphilly 004D,W01001339,1003,517,486,145,42,299
2011,Caerphilly 005A,W01001334,1064,622,442,150,66,226
2011,Caerphilly 005B,W01001335,977,672,305,136,39,130
2011,Caerphilly 005C,W01001347,1046,643,403,219,57,127
2011,Caerphilly 005D,W01001351,1174,801,373,258,46,69
2011,Caerphilly 006A,W01001356,926,621,305,174,51,80
2011,Caerphilly 006B,W01001357,1238,842,396,227,49,120
2011,Caerphilly 006C,W01001358,1110,664,446,209,42,195
2011,Caerphilly 006D,W01001359,1159,818,341,154,49,138
2011,Caerphilly 006E,W01001390,1323,955,368,183,67,118
2011,Caerphilly 006F,W01001391,1198,804,394,202,47,145
2011,Caerphilly 007A,W01001352,1373,828,545,206,77,262
2011,Caerphilly 007B,W01001353,1201,650,551,283,45,223
2011,Caerphilly 007C,W01001387,920,562,358,144,45,169
2011,Caerphilly 007D,W01001388,1331,842,489,185,66,238
2011,Caerphilly 007E,W01001389,825,538,287,150,40,97
2011,Caerphilly 008A,W01001414,1193,712,481,178,69,234
2011,Caerphilly 008B,W01001415,1315,863,452,169,73,210
2011,Caerphilly 008C,W01001416,1112,689,423,226,59,138
2011,Caerphilly 008D,W01001417,1150,836,314,166,65,83
2011,Caerphilly 008E,W01001418,1088,648,440,195,48,197
2011,Caerphilly 009A,W01001348,1255,778,477,182,73,222
2011,Caerphilly 009B,W01001349,1409,1074,335,143,77,115
2011,Caerphilly 009C,W01001350,1317,864,453,251,50,152
2011,Caerphilly 009D,W01001392,1332,911,421,258,43,120
2011,Caerphilly 010A,W01001380,1324,910,414,226,45,143
2011,Caerphilly 010B,W01001381,1103,621,482,175,59,248
2011,Caerphilly 010C,W01001382,1188,745,443,249,49,145
2011,Caerphilly 010D,W01001383,1057,683,374,181,47,146
2011,Caerphilly 011A,W01001401,1416,904,512,249,62,201
2011,Caerphilly 011B,W01001402,1173,763,410,135,41,234
2011,Caerphilly 011C,W01001403,1174,815,359,161,53,145
2011,Caerphilly 011D,W01001404,1107,708,399,292,31,76
2011,Caerphilly 011E,W01001405,1300,821,479,210,62,207
2011,Caerphilly 012A,W01001363,1106,746,360,111,67,182
2011,Caerphilly 012B,W01001364,1321,755,566,127,91,348
2011,Caerphilly 012C,W01001365,1531,1000,531,194,83,254
2011,Caerphilly 012D,W01001369,1676,1090,586,312,67,207
2011,Caerphilly 013A,W01001377,1176,758,418,248,55,115
2011,Caerphilly 013B,W01001378,1123,653,470,223,49,198
2011,Caerphilly 013C,W01001379,1100,730,370,214,41,115
2011,Caerphilly 013D,W01001432,1621,1125,496,246,64,186
2011,Caerphilly 013E,W01001433,1007,671,336,195,38,103
2011,Caerphilly 013F,W01001434,1037,769,268,144,57,67
2011,Caerphilly 014A,W01001327,1663,1238,425,200,65,160
2011,Caerphilly 014B,W01001328,1129,750,379,175,42,162
2011,Caerphilly 014C,W01001329,1119,720,399,187,49,163
2011,Caerphilly 014D,W01001354,1220,861,359,169,46,144
2011,Caerphilly 015A,W01001355,1175,694,481,244,44,193
2011,Caerphilly 015B,W01001430,1723,1177,546,233,73,240
2011,Caerphilly 015C,W01001431,1193,789,404,203,59,142
2011,Caerphilly 016A,W01001407,1129,825,304,171,43,90
2011,Caerphilly 016B,W01001408,1053,666,387,155,49,183
2011,Caerphilly 016C,W01001409,1238,864,374,223,46,105
2011,Caerphilly 016D,W01001410,1419,935,484,242,53,189
2011,Caerphilly 017A,W01001411,1269,818,451,244,51,156
2011,Caerphilly 017B,W01001412,1291,904,387,211,40,136
2011,Caerphilly 017C,W01001413,1346,887,459,218,67,174
2011,Caerphilly 018A,W01001330,1056,696,360,184,43,133
2011,Caerphilly 018B,W01001331,1308,888,420,147,62,211
2011,Caerphilly 018C,W01001332,1392,861,531,189,73,269
2011,Caerphilly 018D,W01001333,1159,734,425,140,55,230
2011,Caerphilly 019A,W01001366,1298,914,384,218,43,123
2011,Caerphilly 019B,W01001367,1135,764,371,177,56,138
2011,Caerphilly 019C,W01001368,1135,751,384,139,53,192
2011,Caerphilly 019D,W01001393,971,572,399,175,42,182
2011,Caerphilly 019E,W01001397,1312,931,381,180,57,144
2011,Caerphilly 019F,W01001400,997,601,396,98,54,244
2011,Caerphilly 020A,W01001340,1361,965,396,242,52,102
2011,Caerphilly 020B,W01001341,1312,782,530,203,62,265
2011,Caerphilly 020C,W01001344,1265,811,454,249,63,142
2011,Caerphilly 020D,W01001346,1081,705,376,212,44,120
2011,Caerphilly 021A,W01001342,859,606,253,132,41,80
2011,Caerphilly 021B,W01001343,880,587,293,161,39,93
2011,Caerphilly 021C,W01001345,1027,583,444,134,58,252
2011,Caerphilly 021D,W01001419,1178,823,355,177,44,134
2011,Caerphilly 022A,W01001371,1084,693,391,150,34,207
2011,Caerphilly 022B,W01001372,1436,989,447,230,47,170
2011,Caerphilly 022C,W01001373,1266,884,382,187,54,141
2011,Caerphilly 022D,W01001420,998,692,306,168,44,94
2011,Caerphilly 022E,W01001421,1087,515,572,146,55,371
2011,Caerphilly 022F,W01001422,1111,541,570,270,46,254
2011,Caerphilly 023A,W01001370,1247,797,450,251,56,143
2011,Caerphilly 023B,W01001394,1047,810,237,140,42,55
2011,Caerphilly 023C,W01001395,1045,602,443,232,46,165
2011,Caerphilly 023D,W01001396,1148,662,486,138,65,283
2011,Caerphilly 023E,W01001399,965,661,304,162,41,101
2011,Caerphilly 024A,W01001398,1812,1490,322,119,70,133
2011,Caerphilly 024B,W01001423,1074,693,381,274,23,84
2011,Caerphilly 024C,W01001424,1060,690,370,203,49,118
2011,Caerphilly 024D,W01001425,1180,837,343,194,56,93
2011,Caerphilly 024E,W01001426,1030,715,315,212,29,74
2011,Caerphilly 024F,W01001427,1330,1116,214,91,53,70
2011,Blaenau Gwent 001A,W01001440,1013,654,359,187,42,130
2011,Blaenau Gwent 001B,W01001441,892,530,362,115,44,203
2011,Blaenau Gwent 001C,W01001442,928,612,316,176,45,95
2011,Blaenau Gwent 001D,W01001470,1114,696,418,255,48,115
2011,Blaenau Gwent 001E,W01001471,1277,741,536,207,51,278
2011,Blaenau Gwent 002A,W01001446,910,623,287,146,47,94
2011,Blaenau Gwent 002B,W01001447,1115,706,409,123,56,230
2011,Blaenau Gwent 002C,W01001448,924,632,292,160,27,105
2011,Blaenau Gwent 002D,W01001449,1068,695,373,175,26,172
2011,Blaenau Gwent 003A,W01001472,1080,704,376,198,52,126
2011,Blaenau Gwent 003B,W01001473,998,501,497,170,38,289
2011,Blaenau Gwent 003C,W01001474,1193,677,516,248,53,215
2011,Blaenau Gwent 003D,W01001475,918,568,350,156,41,153
2011,Blaenau Gwent 003E,W01001480,1098,564,534,214,63,257
2011,Blaenau Gwent 004A,W01001438,1052,638,414,227,55,132
2011,Blaenau Gwent 004B,W01001439,1307,883,424,249,56,119
2011,Blaenau Gwent 004C,W01001456,995,580,415,195,43,177
2011,Blaenau Gwent 004D,W01001457,1287,757,530,188,65,277
2011,Blaenau Gwent 004E,W01001458,1160,765,395,195,77,123
2011,Blaenau Gwent 005A,W01001443,1052,577,475,190,46,239
2011,Blaenau Gwent 005B,W01001444,1438,909,529,222,64,243
2011,Blaenau Gwent 005C,W01001445,1103,711,392,189,52,151
2011,Blaenau Gwent 005D,W01001467,1388,856,532,205,59,268
2011,Blaenau Gwent 005E,W01001468,1043,638,405,170,29,206
2011,Blaenau Gwent 005F,W01001469,950,555,395,126,48,221
2011,Blaenau Gwent 006A,W01001462,1103,715,388,182,45,161
2011,Blaenau Gwent 006B,W01001463,1426,961,465,264,51,150
2011,Blaenau Gwent 006C,W01001478,1125,753,372,198,29,145
2011,Blaenau Gwent 006D,W01001479,1088,551,537,181,55,301
2011,Blaenau Gwent 006E,W01001481,1166,707,459,195,45,219
2011,Blaenau Gwent 007A,W01001450,983,573,410,189,52,169
2011,Blaenau Gwent 007B,W01001451,1040,639,401,185,37,179
2011,Blaenau Gwent 007C,W01001452,1203,873,330,154,55,121
2011,Blaenau Gwent 007D,W01001459,801,505,296,103,41,152
2011,Blaenau Gwent 007E,W01001460,1306,922,384,196,35,153
2011,Blaenau Gwent 007F,W01001461,1071,697,374,165,47,162
2011,Blaenau Gwent 008A,W01001435,1102,737,365,148,48,169
2011,Blaenau Gwent 008B,W01001436,1031,602,429,173,45,211
2011,Blaenau Gwent 008C,W01001437,1159,756,403,195,47,161
2011,Blaenau Gwent 008D,W01001453,1128,636,492,201,47,244
2011,Blaenau Gwent 008E,W01001454,1061,669,392,149,55,188
2011,Blaenau Gwent 008F,W01001455,1244,775,469,226,42,201
2011,Blaenau Gwent 009A,W01001464,1119,666,453,157,48,248
2011,Blaenau Gwent 009B,W01001465,1184,675,509,239,52,218
2011,Blaenau Gwent 009C,W01001466,1308,791,517,210,61,246
2011,Blaenau Gwent 009D,W01001476,785,481,304,121,33,150
2011,Blaenau Gwent 009E,W01001477,1073,689,384,192,48,144
2011,Torfaen 001A,W01001487,1129,712,417,205,53,159
2011,Torfaen 001B,W01001488,1126,666,460,167,50,243
2011,Torfaen 001C,W01001489,1159,736,423,196,33,194
2011,Torfaen 001D,W01001490,947,646,301,170,31,100
2011,Torfaen 002A,W01001482,893,536,357,139,41,177
2011,Torfaen 002B,W01001483,946,550,396,155,48,193
2011,Torfaen 002C,W01001484,1286,848,438,233,57,148
2011,Torfaen 002D,W01001485,849,485,364,162,27,175
2011,Torfaen 002E,W01001486,1123,749,374,153,42,179
2011,Torfaen 003A,W01001525,1100,620,480,203,61,216
2011,Torfaen 003B,W01001529,1547,990,557,250,45,262
2011,Torfaen 003C,W01001530,1307,731,576,159,60,357
2011,Torfaen 003D,W01001531,1264,812,452,185,40,227
2011,Torfaen 004A,W01001491,1309,848,461,223,45,193
2011,Torfaen 004B,W01001496,1075,664,411,192,43,176
2011,Torfaen 004C,W01001523,1137,770,367,154,46,167
2011,Torfaen 004D,W01001524,1364,882,482,265,51,166
2011,Torfaen 004E,W01001540,976,725,251,133,34,84
2011,Torfaen 004F,W01001541,855,558,297,149,37,111
2011,Torfaen 005A,W01001510,1081,736,345,195,45,105
2011,Torfaen 005B,W01001511,1147,735,412,246,46,120
2011,Torfaen 005C,W01001512,1053,677,376,308,24,44
2011,Torfaen 005D,W01001513,1157,746,411,293,53,65
2011,Torfaen 006A,W01001514,886,602,284,195,25,64
2011,Torfaen 006B,W01001515,1078,790,288,141,46,101
2011,Torfaen 006C,W01001516,1081,711,370,179,40,151
2011,Torfaen 006D,W01001517,1440,1114,326,190,36,100
2011,Torfaen 006E,W01001518,809,517,292,212,23,57
2011,Torfaen 007A,W01001519,1004,644,360,99,37,224
2011,Torfaen 007B,W01001520,1304,910,394,201,50,143
2011,Torfaen 007C,W01001521,1059,746,313,143,47,123
2011,Torfaen 007D,W01001522,1170,776,394,171,49,174
2011,Torfaen 007E,W01001537,945,674,271,172,30,69
2011,Torfaen 008A,W01001493,1411,948,463,252,54,157
2011,Torfaen 008B,W01001494,1050,687,363,249,42,72
2011,Torfaen 008C,W01001495,1214,789,425,279,49,97
2011,Torfaen 008D,W01001507,1392,938,454,299,53,102
2011,Torfaen 009A,W01001501,977,678,299,89,42,168
2011,Torfaen 009B,W01001503,944,634,310,107,40,163
2011,Torfaen 009C,W01001536,838,530,308,79,54,175
2011,Torfaen 009D,W01001538,926,577,349,130,46,173
2011,Torfaen 009E,W01001539,1023,717,306,136,38,132
2011,Torfaen 010A,W01001506,1032,667,365,158,35,172
2011,Torfaen 010B,W01001526,968,579,389,173,31,185
2011,Torfaen 010C,W01001527,876,555,321,168,18,135
2011,Torfaen 010D,W01001528,804,504,300,173,30,97
2011,Torfaen 010E,W01001532,1202,761,441,162,58,221
2011,Torfaen 011A,W01001497,1053,676,377,195,51,131
2011,Torfaen 011B,W01001498,849,481,368,190,46,132
2011,Torfaen 011C,W01001499,951,723,228,93,47,88
2011,Torfaen 011D,W01001500,1027,800,227,117,40,70
2011,Torfaen 011E,W01001502,995,725,270,145,48,77
2011,Torfaen 012A,W01001492,1752,1236,516,280,83,153
2011,Torfaen 012B,W01001533,1237,966,271,151,43,77
2011,Torfaen 012C,W01001534,1106,751,355,185,47,123
2011,Torfaen 012D,W01001535,1040,734,306,183,37,86
2011,Torfaen 013A,W01001504,1424,917,507,237,67,203
2011,Torfaen 013B,W01001505,1494,1057,437,232,67,138
2011,Torfaen 013C,W01001508,833,530,303,186,45,72
2011,Torfaen 013D,W01001509,1083,754,329,229,56,44
2011,Monmouthshire 001A,W01001545,969,591,378,260,43,75
2011,Monmouthshire 001B,W01001548,1580,1123,457,261,68,128
2011,Monmouthshire 001C,W01001557,1355,935,420,196,58,166
2011,Monmouthshire 001D,W01001571,951,654,297,192,33,72
2011,Monmouthshire 001E,W01001579,1035,721,314,212,26,76
2011,Monmouthshire 002A,W01001546,1093,688,405,136,69,200
2011,Monmouthshire 002C,W01001558,1076,657,419,211,60,148
2011,Monmouthshire 002E,W01001580,1264,819,445,249,52,144
2011,Monmouthshire 002F,W01001909,1917,1212,705,341,75,289
2011,Monmouthshire 003A,W01001561,1033,633,400,291,32,77
2011,Monmouthshire 003B,W01001562,1085,754,331,160,44,127
2011,Monmouthshire 003C,W01001563,719,480,239,147,29,63
2011,Monmouthshire 003D,W01001564,1623,1040,583,343,72,168
2011,Monmouthshire 003E,W01001569,1048,678,370,242,29,99
2011,Monmouthshire 004A,W01001552,1116,742,374,267,47,60
2011,Monmouthshire 004B,W01001553,1963,1361,602,278,91,233
2011,Monmouthshire 004C,W01001554,1080,666,414,150,168,96
2011,Monmouthshire 004D,W01001576,799,575,224,100,38,86
2011,Monmouthshire 004E,W01001577,828,524,304,149,37,118
2011,Monmouthshire 004F,W01001599,1491,1010,481,295,43,143
2011,Monmouthshire 005A,W01001566,984,636,348,175,32,141
2011,Monmouthshire 005B,W01001567,755,503,252,156,32,64
2011,Monmouthshire 005C,W01001568,1298,925,373,226,49,98
2011,Monmouthshire 005D,W01001575,940,669,271,177,35,59
2011,Monmouthshire 005E,W01001581,1391,979,412,289,47,76
2011,Monmouthshire 006A,W01001555,866,596,270,177,47,46
2011,Monmouthshire 006B,W01001556,871,577,294,161,30,103
2011,Monmouthshire 006C,W01001560,1018,712,306,198,53,55
2011,Monmouthshire 006D,W01001565,1387,956,431,219,71,141
2011,Monmouthshire 006E,W01001596,969,490,479,177,25,277
2011,Monmouthshire 006F,W01001597,1099,800,299,182,55,62
2011,Monmouthshire 007A,W01001549,1117,766,351,212,46,93
2011,Monmouthshire 007B,W01001583,1199,810,389,255,48,86
2011,Monmouthshire 007C,W01001585,899,621,278,178,36,64
2011,Monmouthshire 007D,W01001586,1726,1279,447,244,64,139
2011,Monmouthshire 007E,W01001594,1016,719,297,165,42,90
2011,Monmouthshire 007F,W01001595,985,662,323,212,44,67
2011,Monmouthshire 008A,W01001559,946,642,304,195,32,77
2011,Monmouthshire 008B,W01001584,1376,1008,368,172,67,129
2011,Monmouthshire 008C,W01001587,1361,1005,356,177,38,141
2011,Monmouthshire 008D,W01001592,1176,826,350,127,54,169
2011,Monmouthshire 008E,W01001593,1291,972,319,139,48,132
2011,Monmouthshire 009A,W01001542,1316,932,384,236,64,84
2011,Monmouthshire 009B,W01001543,1084,774,310,199,47,64
2011,Monmouthshire 009C,W01001578,1622,1127,495,297,66,132
2011,Monmouthshire 009D,W01001590,1655,1092,563,386,80,97
2011,Monmouthshire 010C,W01001551,793,539,254,125,30,99
2011,Monmouthshire 010D,W01001588,1272,837,435,289,52,94
2011,Monmouthshire 010E,W01001589,1132,755,377,191,40,146
2011,Monmouthshire 010F,W01001598,1195,793,402,174,52,176
2011,Monmouthshire 010G,W01001908,1552,1021,531,289,54,188
2011,Monmouthshire 011A,W01001572,1101,768,333,199,46,88
2011,Monmouthshire 011B,W01001573,1134,872,262,158,36,68
2011,Monmouthshire 011C,W01001574,1128,852,276,144,51,81
2011,Monmouthshire 011D,W01001582,1290,996,294,138,57,99
2011,Monmouthshire 011E,W01001591,1138,898,240,122,54,64
2011,Newport 001A,W01001623,1054,764,290,160,56,74
2011,Newport 001B,W01001624,901,698,203,122,36,45
2011,Newport 001C,W01001625,963,670,293,186,56,51
2011,Newport 001D,W01001626,1060,648,412,242,57,113
2011,Newport 001E,W01001627,1196,829,367,247,57,63
2011,Newport 001F,W01001628,755,471,284,145,52,87
2011,Newport 002A,W01001651,1115,771,344,237,39,68
2011,Newport 002B,W01001652,1213,735,478,170,50,258
2011,Newport 002C,W01001653,1058,707,351,255,27,69
2011,Newport 002D,W01001654,1165,862,303,184,44,75
2011,Newport 002E,W01001655,1210,834,376,264,35,77
2011,Newport 003A,W01001617,933,531,402,178,37,187
2011,Newport 003B,W01001618,834,483,351,151,40,160
2011,Newport 003C,W01001619,1035,631,404,157,34,213
2011,Newport 003D,W01001620,845,506,339,136,54,149
2011,Newport 003E,W01001621,1040,593,447,193,47,207
2011,Newport 003F,W01001622,953,647,306,153,36,117
2011,Newport 004A,W01001639,1377,1046,331,192,47,92
2011,Newport 004B,W01001640,848,532,316,223,33,60
2011,Newport 004C,W01001641,1040,656,384,225,45,114
2011,Newport 004D,W01001649,1091,725,366,221,39,106
2011,Newport 004E,W01001650,1104,772,332,140,43,149
2011,Newport 005A,W01001614,1014,595,419,191,37,191
2011,Newport 005B,W01001615,1030,724,306,148,51,107
2011,Newport 005C,W01001616,1057,744,313,177,41,95
2011,Newport 005D,W01001678,1210,822,388,167,54,167
2011,Newport 006A,W01001601,1066,703,363,97,76,190
2011,Newport 006B,W01001681,969,658,311,115,42,154
2011,Newport 006C,W01001682,925,644,281,155,32,94
2011,Newport 006D,W01001683,806,604,202,97,34,71
2011,Newport 006E,W01001684,1096,832,264,105,48,111
2011,Newport 007A,W01001675,1132,782,350,144,91,115
2011,Newport 007B,W01001676,1217,864,353,104,80,169
2011,Newport 007C,W01001677,1063,739,324,218,36,70
2011,Newport 007D,W01001679,837,595,242,140,34,68
2011,Newport 007E,W01001680,915,663,252,94,72,86
2011,Newport 008A,W01001606,923,635,288,177,33,78
2011,Newport 008B,W01001608,1109,758,351,204,47,100
2011,Newport 008C,W01001663,1036,639,397,209,55,133
2011,Newport 008D,W01001665,1131,720,411,239,45,127
2011,Newport 009A,W01001669,1045,733,312,207,56,49
2011,Newport 009B,W01001670,1649,1231,418,241,81,96
2011,Newport 009C,W01001672,1183,833,350,197,40,113
2011,Newport 009D,W01001673,1094,724,370,282,41,47
2011,Newport 009E,W01001674,1033,690,343,160,52,131
2011,Newport 010A,W01001664,957,593,364,160,37,167
2011,Newport 010B,W01001666,956,580,376,147,40,189
2011,Newport 010C,W01001667,906,510,396,133,39,224
2011,Newport 010D,W01001668,772,490,282,112,23,147
2011,Newport 011A,W01001611,937,655,282,99,57,126
2011,Newport 011B,W01001612,1165,791,374,160,57,157
2011,Newport 011C,W01001613,1120,809,311,131,61,119
2011,Newport 011D,W01001691,1073,708,365,118,70,177
2011,Newport 011E,W01001692,1500,985,515,129,117,269
2011,Newport 012A,W01001600,1092,752,340,249,23,68
2011,Newport 012B,W01001602,1085,732,353,250,41,62
2011,Newport 012C,W01001603,1026,757,269,113,35,121
2011,Newport 012D,W01001604,996,674,322,209,41,72
2011,Newport 013A,W01001642,1242,863,379,148,30,201
2011,Newport 013B,W01001643,1002,695,307,70,52,185
2011,Newport 013C,W01001644,1982,1556,426,127,87,212
2011,Newport 013D,W01001690,1627,1161,466,123,76,267
2011,Newport 013E,W01001693,1374,858,516,100,93,323
2011,Newport 014A,W01001605,1019,685,334,111,57,166
2011,Newport 014B,W01001685,1285,933,352,119,85,148
2011,Newport 014C,W01001686,998,739,259,125,47,87
2011,Newport 014D,W01001687,1406,967,439,113,119,207
2011,Newport 015A,W01001607,945,549,396,66,52,278
2011,Newport 015B,W01001609,978,611,367,68,52,247
2011,Newport 015C,W01001610,941,627,314,141,55,118
2011,Newport 015D,W01001645,961,667,294,113,55,126
2011,Newport 015E,W01001646,1620,790,830,183,412,235
2011,Newport 015F,W01001647,1109,738,371,242,39,90
2011,Newport 015G,W01001648,1074,758,316,164,33,119
2011,Newport 016A,W01001635,991,692,299,189,41,69
2011,Newport 016B,W01001637,1161,774,387,209,78,100
2011,Newport 016C,W01001638,868,609,259,188,34,37
2011,Newport 016D,W01001671,1273,859,414,234,47,133
2011,Newport 017A,W01001629,966,632,334,201,41,92
2011,Newport 017B,W01001630,1001,581,420,221,47,152
2011,Newport 017C,W01001631,1040,772,268,165,28,75
2011,Newport 017D,W01001632,964,664,300,131,44,125
2011,Newport 018A,W01001659,1210,677,533,131,70,332
2011,Newport 018B,W01001660,1107,762,345,94,56,195
2011,Newport 018C,W01001661,2000,1152,848,82,452,314
2011,Newport 018D,W01001662,937,481,456,120,50,286
2011,Newport 019A,W01001633,1032,666,366,127,45,194
2011,Newport 019B,W01001634,1082,743,339,157,45,137
2011,Newport 019C,W01001688,1937,1459,478,135,78,265
2011,Newport 019D,W01001689,1103,591,512,188,63,261
2011,Newport 020A,W01001636,1341,1088,253,125,58,70
2011,Newport 020C,W01001657,1099,827,272,154,58,60
2011,Newport 020D,W01001658,1317,960,357,185,64,108
2011,Newport 020E,W01001912,1132,791,341,236,27,78
2011,Newport 020F,W01001913,1102,955,147,45,38,64
